Affrica	África
Iapan	Japón
Sūðamerica	América del Sur
Norþweg	Noruega
Englaland	Inglaterra
Scotland	Escocia
Wēalas	Gales
Norðerne Īrland	Irlanda del Norte
Īrland Cynewīse	Irlanda
Ungerland	Hungría
Spēonland	España
Geānedu Rīcu American	Estados Unidos
Belgice	Bélgica
Letseburg	Luxemburgo
Eorðe	Tierra
Līf	Vida
George Washington	George Washington
Finnland	Finlandia
Swēoland	Suecia
Denemearc	Dinamarca
Polaland	Polonia
Liþþuania	Lituania
Italia	Italia
Swissland	Suiza
Ēastrīce	Austria
Grēcland	Grecia
Turcland	Turquía
Bēor	Cerveza
Portugal	Portugal
Europe	Europa
Asia	Asia
Norðamerica	América del Norte
Antarctica	Antártida
Wikipǣdia	Wikipedia
Niðerland	Países Bajos
Nīweoforwīcburg	Nueva York
Hwæsingatūn, D.C.	Washington D. C.
Berlin	Berlín
Los Angeles	Los Ángeles
Spearctelle	Computadora
Genf	Ginebra
Betweoxnett	Internet
Barack Obama	Barack Obama
Uruguay	Uruguay
Lunden	Londres
Æppel	Manzana
Paris	París
Abraham Lincoln	Abraham Lincoln
Android	Android
Google	Google
Mexico	México
Atlantisc Gārsecg	Océano Atlántico
Sericus Gārsecg	Océano Pacífico
California	California
Mōnandæg	Lunes
Æfterra Gēola	Enero
Solmōnaþ	Febrero
Hrēþmōnaþ	Marzo
Tīw (tungol)	Marte (planeta)
Cenia	Kenia
Sigelhearwenaland	Etiopía
Ēastermōnaþ	Abril
Þrimilcemōnaþ	Mayo
Sēremōnaþ	Junio
Mǣdmōnaþ	Julio
Wēodmōnaþ	Agosto
Hāligmōnaþ	Septiembre
Winterfylleþ	Octubre
Blōtmōnaþ	Noviembre
Gēolmōnaþ	Diciembre
Tīwesdæg	Martes
Wēdnesdæg	Miércoles
Þunresdæg	Jueves
Frīgedæg	Viernes
Sæternesdæg	Sábado
Sunnandæg	Domingo
Lēo	Panthera leo
Francland	Francia
Esperanto	Esperanto
Geāned Cynerīce	Reino Unido
Catte	Felis silvestris catus
Cīnan Folclicu Cynewīse	República Popular China
Frencisc sprǣc	Idioma francés
Fisc	Pisces
Brasil	Brasil
Russland	Rusia
Eoferwicscīr	Yorkshire
Sǣ	Mar
Euxinus	Mar Negro
Toronto	Toronto
Alabama	Alabama
São Paulo	São Paulo
São Paulo (rīce)	Estado de São Paulo
Quebec	Quebec
Piza	Pizza
Þēodscland	Alemania
Hwītrussland	Bielorrusia
Þēodsc sprǣc	Idioma alemán
Īsland	Islandia
God	Dios
Estland	Estonia
Sætern (tungol)	Saturno (planeta)
Ceocōlāte	Chocolate
2 (getæl)	Dos
Þrīe	Tres
Fēower	Cuatro
Fīf	Cinco
George W. Bush	George W. Bush
Lettland	Letonia
Ucrægna	Ucrania
Cecland	República Checa
Slofacia	Eslovaquia
Slofenia	Eslovenia
Vilnius	Vilna
Moldofa	Moldavia
Rumǣnia	Rumania
Pulgaraland	Bulgaria
Rōm	Roma
Macedonia Cynewīse	República de Macedonia
Albania	Albania
Grēneland	Groenlandia
Croatia	Croacia
Bosnia and Herzegofina	Bosnia y Herzegovina
Godhopa	Nuuk
Azerbaijan	Azerbaiyán
Andorra	Andorra
Cipros	Chipre
Georgia (land)	Georgia
Casahstan	Kazajistán
Melita	Malta
Monaco	Mónaco
Sweartbeorg	Montenegro
Faticanburg	Ciudad del Vaticano
San Marino	San Marino
Brysel	Bruselas
Cūba	Cuba
Barbados	Barbados
Cǣgbord (spearctellend)	Teclado (informática)
Indonesia	Indonesia
Wolfgang Amadeus Mozart	Wolfgang Amadeus Mozart
Ludwig van Beethoven	Ludwig van Beethoven
Sūðaffrica	Sudáfrica
Algeria	Argelia
Usbecastan	Uzbekistán
Warsaw	Varsovia
Wīn (drinc)	Vino
Wæter	Agua
Holt	Madera
Feorrsīen	Televisión
Īslendisc sprǣc	Idioma islandés
Cile	Chile
Iesus	Jesús de Nazaret
Elvis Presley	Elvis Presley
Wōden (tungol)	Mercurio (planeta)
Stǣr	Historia
Apple Inc.	Apple
Frig (tungol)	Venus (planeta)
Sprǣc	Lenguaje
Lufu	Amor
Þunor (tungol)	Júpiter (planeta)
Uranus	Urano (planeta)
Neptune (planēta)	Neptuno (planeta)
Tungolcræft	Astronomía
Witancræft	Ciencia
Pluto	Plutón (planeta enano)
Montreal	Montreal
Lēohtenstān	Liechtenstein
Plega	Deporte
Grantanbrycg	Cambridge
Adolf Hitler	Adolf Hitler
Fyrst Woruldgūþ	Primera Guerra Mundial
Ōðru Woruldgūþ	Segunda Guerra Mundial
Wikibēc	Wikilibros
Augusto Pinochet	Augusto Pinochet
Geanca Cupala	Yanka Kupala
Ubuntu	Ubuntu
Stettin	Szczecin
Rīmcræft	Matemáticas
U2	U2
Lǣden	Latín
Bahrain	Baréin
Armenia	Armenia
Serbia	Serbia
Mōna	Luna
Constantinopolis	Estambul
Australia	Australia
Bob Marley	Bob Marley
Argentina	Argentina
Peru	Perú
Norþcorēa	Corea del Norte
Cambodia	Camboya
Kuiperes gyrtel	Cinturón de Kuiper
Curān	Corán
Alladōm	Islam
Lech Wałęsa	Lech Wałęsa
Europisce Gesamnung	Unión Europea
Woruldwīd Webb	World Wide Web
Wīf	Mujer
Wætertyge	Acueducto
Don Quijote	Don Quijote de la Mancha
Megelan	Milán
Burg	Ciudad
Napoleon I Francena Cāsere	Napoleón Bonaparte
Uesuuius	Monte Vesubio
Sunne	Sol
Lēohtgēar	Año luz
Sunnlicu Endebyrdnes	Sistema Solar
Ostsǣ	Mar Báltico
Wisle	Vístula
Wætertimber	Hidrógeno
Wikimedia Commons	Wikimedia Commons
Dæg	Día
Ēasttimor	Timor Oriental
Niht	Noche
Gēar	Año
Hundgēar	Siglo
Rīn	Rin
Oslo	Oslo
Katowice	Katowice
1 Ceres	Ceres (planeta enano)
Ii	Iona
Dubai	Dubái
Folga	Volga
Æðmlyft	Oxígeno
Dweligende tungol	Planeta
Venetia	Venecia
Naruto	Naruto
Moscow	Moscú
Italisc sprǣc	Idioma italiano
Cead	Chad
Nīwe Sǣland	Nueva Zelanda
Indea	India
Īsen	Hierro
Willelm Scacaspere	William Shakespeare
Lēad	Plomo
Mongolland	Mongolia
Ficgīege	Fiyi
Feneswela	Venezuela
Blēobord	Ajedrez
Maine	Maine
Hors	Equus ferus caballus
Amsterdam	Ámsterdam
Wǣpen	Arma
Dēor	Animalia
Paraguay	Paraguay
Ecuador	Ecuador
Colombia	Colombia
Strēawberge	Fragaria
Buddendōm	Budismo
Bolifia	Bolivia
Coper	Cobre
Plante	Plantae
Nīwu Hāmtūnscīr	Nuevo Hampshire
Iamaica	Jamaica
Massachusetts	Massachusetts
Connecticut	Connecticut
Henn	Gallus gallus domesticus
Hawaii	Hawái
Cēsarēa	Jersey
Swīn	Sus scrofa domestica
Īshæf	Océano Ártico
Persealand	Irán
Irac	Irak
Alaska	Alaska
Israhēl	Israel
Utrecht	Utrecht
Gemen	Yemen
Clēofanwyrm	Virus
Polisc sprǣc	Idioma polaco
Hascemisc Cynerīce þæs Iordanes	Jordania
Florida	Florida
Arizona	Arizona
Cuwait	Kuwait
Libanus	Líbano
Oregon	Oregón
Utah	Utah
Hriðer	Bos primigenius taurus
Malægsia	Malasia
Burma	Birmania
Oman	Omán
Pacistan	Pakistán
Qatar	Catar
Tennis	Tenis
Saudisc Arabea	Arabia Saudita
Tāprabane	Sri Lanka
Iosep Stalin	Iósif Stalin
Syria	Siria
Plato	Platón
Tacgicastan	Tayikistán
Aristoteles	Aristóteles
Thailand	Tailandia
Ūtƿeorp	Radiocomunicación
Turcmenistan	Turkmenistán
Geānedu Arabisc Bregorīcu	Emiratos Árabes Unidos
Fietnam	Vietnam
Sūþcorēa	Corea del Sur
Afghanistan	Afganistán
J. R. R. Tolkien	J. R. R. Tolkien
Gold	Oro
Bængladesc	Bangladés
Bleach (manga)	Bleach
Socrates	Sócrates
Angola	Angola
Tansania	Tanzania
Philippines	Filipinas
Middel Affricanisc Cynewīse	República Centroafricana
Sūþende þǣre eaxe	Polo Sur
Norþende þære eaxe	Polo Norte
Isaac Newton	Isaac Newton
Albert Einstein	Albert Einstein
Geolu	Amarillo
Tunisia	Túnez
Simbabwe	Zimbabue
Beicing	Pekín
Sūþsudan	Sudán del Sur
Botswana	Botsuana
Burkina Faso	Burkina Faso
Folcrīcelicu Cynewīse þæs Congwes	República Democrática del Congo
Bægwaraland	Baviera
Baden-Wyrttemberg	Baden-Wurtemberg
Æriþrea	Eritrea
Nīwe Delhi	Nueva Delhi
Iohannes Paulus II Pāpa	Juan Pablo II
Gabon	Gabón
Mohandas Karamchand Gandhi	Mahatma Gandhi
Gambia	Gambia
Guinea	Guinea
Elpendbānrima	Costa de Marfil
Camerun	Camerún
Grēnenæs Īega	Cabo Verde
Lesotho	Lesoto
Liberia	Liberia
Libia	Libia
Madagascar	Madagascar
Mauritania	Mauritania
Morocco	Marruecos
Mosambice	Mozambique
Namibia	Namibia
Nigeria	Nigeria
Charles Darwin	Charles Darwin
Uganda	Uganda
Rwanda	Ruanda
Sōmalia	Somalia
Gaius Iulius Caesar	Julio César
Sudan	Sudán
Swasiland	Suazilandia
Hamburg	Hamburgo
Heorte	Corazón
Brægen	Cerebro
Prag	Praga
Bleoh	Azul
Seolfor	Plata
Tin	Estaño
Reddit	Reddit
Elsass	Alsacia
Bihar	Bihar
Michigan	Míchigan
Puerto Rico	Puerto Rico
Niðerseaxland	Baja Sajonia
Hetwaraland	Hesse
Illinois	Illinois
Norþdakota	Dakota del Norte
Brandenburg	Brandeburgo
Langbeardnaland	Lombardía
Sūþdakota	Dakota del Sur
Montǣna	Montana
Wyoming	Wyoming
Ierusalem	Jerusalén
Idaho	Idaho
Hwæsingatūn	Washington (estado)
Nevada	Nevada
Danais	Río Don
Indisc Gārsecg	Océano Índico
Caribisc Sǣ	Mar Caribe
Colorado	Colorado
Tuscania	Toscana
Alpis	Alpes
Gænt	Gante
Chicago	Chicago
The Beatles	The Beatles
Winter	Invierno
Ēawielm	Primavera
Efenniht	Equinoccio
Spēonisc sprǣc	Idioma español
Caligardamana	Calcuta
West Bengal	Bengala Occidental
Ātorcoppe	Araneae
Virginia	Virginia
Westvirginia	Virginia Occidental
Nīwe Eoforwīc	Nueva York (estado)
Rhode Īeg	Rhode Island
Ceorfdēor	Insecta
Marianland	Maryland
Delaware	Delaware
Fladimir Lenin	Lenin
Ohio	Ohio
Pennsylvānia	Pensilvania
Uetersen	Uetersen
Augustus	César Augusto
Microsoft Windows	Microsoft Windows
Nīwe Cēsarēa	Nueva Jersey
Calpis	Gibraltar
Finnisc sprǣc	Idioma finés
Indiǣna	Indiana
Selffērende wægn	Automóvil
Roger Federer	Roger Federer
Georgia (America)	Georgia (Estados Unidos)
Marcus Aurelius	Marco Aurelio
Texas	Texas
Puilla	Apulia
Norþcarolīna	Carolina del Norte
Sūþcarolīna	Carolina del Sur
Sicilia	Sicilia
Sardinia	Cerdeña
Ligore	Río Loira
Sigen	Río Sena
Buenos Aires	Buenos Aires
Mexicoburg	México, D. F.
Pīnæppel	Ananas comosus
Mississippi	Misisipi
Mississippi ēa	Río Misisipi
Mizoram	Mizorán
Tennessee	Tennessee
Abu Dhabi	Abu Dabi
Nīwe Mexico	Nuevo México
Athēnas	Atenas
Minnesota	Minnesota
Wisconsin	Wisconsin
Iowa	Iowa
Nebraska	Nebraska
Kansas	Kansas
Hafana	La Habana
Pīpwēod	Tabaco
Missouri	Misuri
Louisiāna	Luisiana
Nagaland	Nagaland
Kentucky	Kentucky
Arkansas	Arkansas
Ælf ēa	Río Elba
Oklahoma	Oklahoma
Donua	Danubio
Hæfel	Río Havel
Norþsǣ	Mar del Norte
Flēogeball	Voleibol
Uigenna	Viena
Cēapmannahæfen	Copenhague
Stoccholm	Estocolmo
Helsinki	Helsinki
Difelin	Dublín
Rēcwīc	Reikiavik
Riga	Riga
Menuþias	Zanzíbar
Dantsic	Gdansk
Frankfurt	Fráncfort del Meno
Death Note	Death Note
Biblioþēce	Biblia
Ho Chi Minh Burg	Ciudad Ho Chi Minh
Sōþ Iesus Cirice	Verdadera Iglesia de Jesús
Nīwenglisc sprǣc	Idioma inglés
Andorra la Vella	Andorra la Vieja
Đồng Hới	Đồng Hới
Concepcion	Concepción (Chile)
Cænugeard	Kiev
Ontario	Ontario
Ottawa	Ottawa
Alberta	Alberta
Nīwe Scotland	Nueva Escocia
Końskowola	Końskowola
Geocon Landscipe	Yukón
Florentia	Florencia
Ǣt	Alimento
Snaca	Serpentes
Halifax	Halifax
Quebecceaster	Quebec (ciudad)
3. Æfterran Gēolan	3 de enero
4. Æfterran Gēolan	4 de enero
Región del Biobío (Cile)	Región del Bío-Bío
5. Æfterran Gēolan	5 de enero
Arica	Arica
6. Æfterran Gēolan	6 de enero
7. Æfterran Gēolan	7 de enero
8. Æfterran Gēolan	8 de enero
9. Æfterran Gēolan	9 de enero
10. Æfterran Gēolan	10 de enero
11. Æfterran Gēolan	11 de enero
12. Æfterran Gēolan	12 de enero
13. Æfterran Gēolan	13 de enero
Beormingahām	Birmingham
14. Æfterran Gēolan	14 de enero
15. Æfterran Gēolan	15 de enero
16. Æfterran Gēolan	16 de enero
17. Æfterran Gēolan	17 de enero
18. Æfterran Gēolan	18 de enero
Rōmānisc Rīce	Imperio romano
Microsoft	Microsoft
30. Æfterran Gēolan	30 de enero
Kurów	Kurów
11. Solmōnðes	11 de febrero
11. Gēolmōnþes	11 de diciembre
12. Gēolmōnðes	12 de diciembre
17. Gēolmōnðes	17 de diciembre
Wæþ	Río Forth
Þrittiggēara Orlege	Guerra de los Treinta Años
Benedictus XVI Pāpa	Benedicto XVI
6. Ēastermōnðes	6 de abril
4. Ēastermōnþes	4 de abril
Helmut Kohl	Helmut Kohl
17. Ēastermōnðes	17 de abril
12. Þrimilcemōnþes	12 de mayo
13. Þrimilcemōnþes	13 de mayo
20. Þrimilcemōnðes	20 de mayo
31 Þrimilcemōnaþ	31 de mayo
6. Mǣdmōnðes	6 de julio
1. Mǣdmōnðes	1 de julio
18. Mǣdmōnðes	18 de julio
Gyldfōtþōðer	Fútbol
26. Gēolmōnðes	26 de diciembre
Eallbærnet	Holocausto
IPad	IPad
Madrid	Madrid
Elton John	Elton John
Undersǣbāt	Submarino
26. Wēodmōnðes	26 de agosto
24. Wēodmōnðes	24 de agosto
2. Hāligmōnþes	2 de septiembre
Kassel	Kassel
25. Hāligmōnðes	25 de septiembre
Santiago (Cile)	Santiago de Chile
1. Winterfylleðes	1 de octubre
14. Winterfylleðes	14 de octubre
8. Winterfylleðes	8 de octubre
7. Winterfylleðes	7 de octubre
Oldenburg (Oldenburg)	Oldemburgo
26. Winterfylleðes	26 de octubre
4. Blōtmōnðes	4 de noviembre
1. Blōtmōnðes	1 de noviembre
Wolfsburg	Wolfsburgo
Carl Micela Francena Cyning	Carlomagno
Canberra	Canberra
Sydney	Sídney
Grēne	Verde
Rēad	Rojo
Perþ (Australia)	Perth
Fȳr	Fuego
Westerne Australia	Australia Occidental
Nīwe Sūþwealas	Nueva Gales del Sur
Norþerne Landscipe	Territorio del Norte
Australisc Hēafodbyrig Landscipe	Territorio de la Capital Australiana
Fīfeldor	Eider (río)
Nīl	Nilo
Heortfordscīr	Hertfordshire
Comēta	Cometa
Angol	Angol
Antofagasta	Antofagasta
Ancyra	Ankara
Flocc:Bysen	Categoría:Wikipedia:Plantillas
Castro (Cile)	Castro (Chile)
Frencisc Guiana	Guayana Francesa
Chillán (Cile)	Chillán
Amāzanēa	Río Amazonas
Tybingen	Tubinga
Coyhaique	Coyhaique
Flocc:Bysen Land	Categoría:Wikipedia:Plantillas de países
Flocc:Bysen tīd	Categoría:Wikipedia:Plantillas de hora, fechas y calendarios
Willelmeshæfen	Wilhelmshaven
Copiapó (Cile)	Copiapó
Manama	Manama
Delmenhorst	Delmenhorst
Brandenburg (burg)	Ciudad de Brandeburgo
Wikipǣdia:Sandbox	Wikipedia:Zona de pruebas
Wikipǣdia:Inlǣdung	Ayuda:Introducción
Cantabria	Cantabria
Hūs	Casa
Rīmagiefung	Álgebra
Mennisc bodiglār	Anatomía humana
Osasco	Osasco
Fujairah	Fuyaira
Glasgow	Glasgow
Donghoi Lyfthæfene	Aeropuerto de Đồng Hới
Rodor	Espacio exterior
Sweartweald	Selva Negra
Curitiba	Curitiba
Weald	Bosque
Flocc:Cliferfētedēor	Categoría:Artiodactyla
Talca	Talca
Flothere	Armada
Andalién	Río Andalién
Bysen:Lang-lt	Plantilla:Lang-lt
Cwidbōc	Proverbios
Rancagua	Rancagua
Confucius	Confucio
Corbin Bleu	Corbin Bleu
Flocc:Rīmcræft	Categoría:Matemáticas
Faroisca Īega	Islas Feroe
Wendelsǣ	Mar Mediterráneo
Flocc:Nīwes Sǣlandes īga	Categoría:Archipiélagos e islas de Nueva Zelanda
Cōcnearuness	Estrecho de Cook
Crīstendōm	Cristianismo
Windows 8	Windows 8
Gandis	Ganges
Worulddǣl	Continente
Fugol	Aves
Hēafodstōl	Capital (política)
Monzón	Monzón (Huesca)
Portuglisc sprǣc	Idioma portugués
Mōnaþ	Mes
Almazán	Almazán
Huang Siānfan	Huang Xianfan
Kescwisc sprǣccynn	Lenguas quechuas
Bill Gates	Bill Gates
Iapanisc sprǣc	Idioma japonés
Wīsdōmbōc	Enciclopedia
Hēafodtramet	Wikipedia:Portada
Golf	Golf
Hrōcburhfōtþōðer	Rugby
Olympisc Gamen	Juegos olímpicos
Eurasia	Eurasia
Andes	Cordillera de los Andes
Durban	Durban
Caspia	Mar Caspio
Uictoriamere	Lago Victoria
Estmere	Laguna del Vístula
Babilōn	Babilonia (ciudad)
Ēalendisca Īega	Åland
Cægman Īegland	Islas Caimán
Novak Đoković	Novak Djokovic
Fortunatus iegland	Canarias
Ūðwitegung	Filosofía
Flocc:Candidates for speedy deletion	Categoría:Wikipedia:Borrar (definitivo)
Tē	Té
Hebe Camargo	Hebe Camargo
Gemǣnre ǣhte rǣd	Comunismo
Wealdlīste rǣd	Anarquismo
Ǣhtwealdes endebyrdness	Capitalismo
Frēodōmes þōht	Liberalismo
Gilmrǣd	Fascismo
Cofentreo	Coventry
Lodi	Lodi (Italia)
Ōðre Penisc Gūþ	Segunda Guerra Púnica
Cartaina	Cartago
Bryttisc Museum	Museo Británico
Sund	Natación
1451	1451
Ellaspontus	Dardanelos
Strǣtburg	Estrasburgo
Gytārre	Guitarra
Croatisc sprǣc	Idioma croata
Cesena	Cesena
Hāmburgere	Hamburguesa
Fédération Internationale de Volleyball	Federación Internacional de Voleibol
20e gēarhundred	Siglo XX
Stefan Raab	Stefan Raab
Catalan sprǣc	Idioma catalán
11e gēarhundred	Siglo XI
Gelēaflēasnes	Ateísmo
Cynn scī huang	Qin Shi Huang
Elisabeþ I Engla Cwēn	Isabel I de Inglaterra
Cynewīse	República
Þēodlices gemǣnscipes rǣd	Nazismo
Nazi Þēodscland	Alemania nazi
Christopher Columbus	Cristóbal Colón
Iacobus Cōc	James Cook
Ēare	Oído
Nasu	Nariz
Ēage	Ojo
Scēap	Ovis orientalis aries
Sǣhund	Selachimorpha
Sycedēor	Mammalia
Ǣmette	Formicidae
Bēo	Anthophila
Niðerlendisc sprǣc	Idioma neerlandés
Ǣȝƿyrt	Solanum melongena
Draca	Dragón
Mōdor	Madre
Snāw	Nieve
Wæterþōðer	Waterpolo
1865	1865
Napoleon III Francena Casere	Napoleón III Bonaparte
Russisc sprǣc	Idioma ruso
Hloþwig XIV Francena Cyning	Luis XIV de Francia
Hām	Hogar
Vladimir Putin	Vladímir Putin
Loðwic-Philippus Francena Cyning	Luis Felipe I de Francia
Þēodacynewīse	Mancomunidad de Naciones
Hlāf	Pan
Taurica	Crimea
Līfclēofa	Célula
Blōd	Sangre
Īwungplega	Videojuego
Rumǣnisc sprǣc	Idioma rumano
Regn	Lluvia
Medumweder	Clima
Woruldlicu wearmung	Calentamiento global
Eorþbeofung	Terremoto
Museum on Dēoraby	Derby Museum and Art Gallery
Winston Churchill	Winston Churchill
Nelson Mandela	Nelson Mandela
10. gēarhundred	Siglo X
Fȳrbeorg	Volcán
Wolcen	Nube
Īwungplegtōl	Videoconsola
Wind	Viento
Lyfthelm	Atmósfera
Pintel	Pene humano
Sprǣccræft	Lingüística
Flocc:Pulgaraland	Categoría:Bulgaria
Flocc:Francland	Categoría:Francia
Flocc:Glīƿdrēam	Categoría:Música
Flocc:Bōccræft	Categoría:Literatura
Fox	Vulpes vulpes
Valladolid	Valladolid
Alexander Mæcedonia Cyning	Alejandro Magno
Hēaphandþōðer	Balonmano
Hugo Chávez	Hugo Chávez
Þēowdōm	Esclavitud
Caffig	Café
Meolc	Leche
Beorg	Montaña
Oferswefn	Hipnosis
Andrew Johnson	Andrew Johnson
Miami	Miami
Americanisce Ingefeoht	Guerra de Secesión
Rio de Janeiro	Río de Janeiro
Bryttisce Rīce	Imperio británico
Albanisc sprǣc	Idioma albanés
Ucrægnisc sprǣc	Idioma ucraniano
Crabba (steorra)	Cáncer (constelación)
Swēonisc sprǣc	Idioma sueco
Denisc sprǣc	Idioma danés
Norðisc sprǣc	Idioma noruego
Noam Chomsky	Noam Chomsky
Bæmisc sprǣc	Idioma checo
Karl Marx	Karl Marx
Lettisc sprǣc	Idioma letón
Liþþuanisc sprǣc	Idioma lituano
Hinduismus	Hinduismo
Wīflicu brēost	Mama
Mot	Átomo
Crēacisc sprǣc	Idioma griego
Weorcendebyrdness	Sistema operativo
Īrisc sprǣc	Idioma irlandés
Ambihtlic Cīnisc sprǣc/ᚱᚢᚾ	Chino mandarín
C. S. Lewis	C. S. Lewis
Baku	Bakú
Hebrēisc sprǣc	Idioma hebreo
Azeri sprǣc	Idioma azerí
Wilisc sprǣc	Idioma galés
Scyttisce sprǣc	Gaélico escocés
John Locke	John Locke
Friedrich Nietzsche	Friedrich Nietzsche
Lifere	Hígado
Drēag (Fūdū)	Zombi
Gārsecg	Océano
Gautama Budda	Buda Gautama
Premier League	Premier League
Mahomet	Mahoma
Ācweorna	Sciuridae
Rēmisc Cirice	Iglesia católica
Bengalisc sprǣc	Idioma bengalí
Tunge	Lengua (anatomía)
Folcland Īegland	Islas Malvinas
Manīeg	Isla de Man
Wiht (īeg)	Isla de Wight
Heortford	Hertford
Elisabeþ II	Isabel II del Reino Unido
ß	ß
John F. Kennedy	John F. Kennedy
Ronald Reagan	Ronald Reagan
Æ	Æ
Fernando Alonso	Fernando Alonso
Flocc:Feneswela	Categoría:Venezuela
Þunreshæfen	Tórshavn
11. Hāligmōnþes 2001. torngemōt	Atentados del 11 de septiembre de 2001
Culfre	Columbidae
Trēow	Árbol
Cīese	Queso
Wīnberge	Uva
Hunig	Miel
Eorþperu	Solanum tuberosum
Searuþræl	Robot
Searucræft	Tecnología
Feorrspreca	Teléfono
Lugo	Lugo
Hēahdēmere þāra Geāndena Rīca American	Presidente de la Corte Suprema de los Estados Unidos
Windows 7	Windows 7
Windows Vista	Windows Vista
World Trade Center	World Trade Center
Nelson Rockefeller	Nelson Rockefeller
David Rockefeller	David Rockefeller
One World Trade Center	One World Trade Center
Fidel Castro	Fidel Castro
Rockefeller Center	Rockefeller Center
Flocc:Brasil	Categoría:Brasil
Flocc:Rumǣnia	Categoría:Rumania
Hēafodgesceaft	Elemento químico
Gemot	Molécula
Cræftlicu endebyrdung	Clasificación biológica
Lyft	Gas
Lyftcræft	Aeronave
Clāðas	Ropa
Swēg	Sonido
Paper	Papel
Rīm	Número
Bere	Hordeum vulgare
Nirvana	Nirvana (banda)
Weder	Tiempo atmosférico
Land þǣre worulde	Anexo:Países
Bera	Ursidae
John Adams	John Adams
Thomas Jefferson	Thomas Jefferson
James Madison	James Madison
James Monroe	James Monroe
John Quincy Adams	John Quincy Adams
Andrew Jackson	Andrew Jackson
Martin Van Buren	Martin Van Buren
William Henry Harrison	William Henry Harrison
John Tyler	John Tyler
James K. Polk	James K. Polk
Zachary Taylor	Zachary Taylor
Ǣtweg	Digestión
Kylie Minogue	Kylie Minogue
Āc	Quercus
Pīntrēow	Pinus
Āte	Avena sativa
Hwǣte	Triticum
Corn	Cereal
Unmeaht	Discapacidad
Gerīmbōc	Calendario
Ādl	Enfermedad
Gregorisc gerīmbōc	Calendario gregoriano
Soria	Soria
Manisc sprǣc	Idioma manés
Bysen:Stedefindend scite Breten	Plantilla:Mapa de localización de Reino Unido
Millard Fillmore	Millard Fillmore
Franklin Pierce	Franklin Pierce
James Buchanan	James Buchanan
Pireni	Pirineos
Hālig Rōmānisc Rīce	Sacro Imperio Romano Germánico
Mongolrīce	Imperio mongol
Oþomanisce Rīce	Imperio otomano
Cirice Ednīwung	Reforma protestante
Wīcingas	Vikingo
Sweord	Espada
Fȳrwǣpen	Arma de fuego
Iberia	Península ibérica
Fȳrspringend	Explosivo
Campwægn	Tanque (desambiguación)
Antwerpen	Amberes
Brycg (burh)	Brujas
Blæcberige	Mora (fruta)
Fenberge	Arándano rojo
Retoromanisc sprǣc	Romanche
Īsrēam	Helado
Ceace	Pastel
Īsbrīw	Sorbete
Dinegisc sprǣc	Idioma navajo
Meolcbrīw	Yogur
Montserrat	Montserrat
Bysen:Location map Greenland	Plantilla:Mapa de localización de Groenlandia
Wikicynn	Wikispecies
Arabisc sprǣc	Idioma árabe
Ian Magen	Jan Mayen
Corsica	Córcega
Affricanisc sprǣc	Afrikáans
Forma Þegn þæs Geānedan Cynerīces	Primer ministro del Reino Unido
Santiago de Compostela	Santiago de Compostela
Fiscoþ	Pesca
Iquique	Iquique
La Serena (Cile)	La Serena (Chile)
Las Condes	Las Condes
Lebu	Lebu
Lo Barnechea	Lo Barnechea
Niðerscyttisc sprǣc	Escocés (lengua germánica)
Linux (cyrnel)	Núcleo Linux
Darwin (æhtendebyrd)	Darwin (sistema operativo)
Emmen	Emmen
Sofiet Gesamnung	Unión Soviética
Se Hlāford þāra Hringa	El Señor de los Anillos
Hrūse	Corteza terrestre
Sīensearu	Cámara fotográfica
Gaðes	Cádiz
Llión	León (España)
Fōt	Pie
Queen	Queen
Freddie Mercury	Freddie Mercury
Normandig	Normandía
Metallica	Metallica
Wikipǣdia:Fulgōd gewritu	Wikipedia:Artículos destacados
Bysen:Link FA	Plantilla:Destacado
Lēoht (dæg)	Luz diurna
Wikipǣdia:Se Þorpes Wella	Wikipedia:Café
Vermont	Vermont
Jacksonville, Florida	Jacksonville (Florida)
Los Ángeles (Cile)	Los Ángeles (Chile)
Eþna	Etna
Æg	Huevo (biología)
Strȳta	Struthio camelus
Corēa	Corea
Wesend	Bison
Mameceaster	Mánchester
Turcas and Caicos Īegland	Islas Turcas y Caicos
Blēocræft	Bordado
Wulf	Canis lupus
Major League Soccer	Major League Soccer
Þōðer	Pelota
Club de Gimnasia y Esgrima La Plata	Club de Gimnasia y Esgrima La Plata
Nīwu Gecȳþnes	Nuevo Testamento
Middelseaxe	Middlesex
San Pedro de la Paz	San Pedro de la Paz
Scræf (fugol)	Phalacrocorax
Dūfedoppa	Pelecanus
Nha Trang	Nha Trang
Podolsk	Podolsk
Pāpa	Papa
Rafael Correa	Rafael Correa
5	5
Louvre	Museo del Louvre
Sæfern	Río Severn (Reino Unido)
Temes	Río Támesis
Tirana	Tirana
Motorhead	Motörhead
Afen	Río Avon (Brístol)
6	6
Josh Duhamel	Josh Duhamel
Stīðen Āc	Stevenage
Crīstesmæsse	Navidad
Bises	Año bisiesto
Steve Jobs	Steve Jobs
Indo-Europisc sprǣchīred	Lenguas indoeuropeas
Breinigerberg	Breinigerberg
Muammar al-Gaddafi	Muamar el Gadafi
Tiger	Panthera tigris
Moru	Verdura de raíz
Samsunghēap	Samsung
Ēaster	Pascua
Germanisca sprǣca	Lenguas germánicas
Windows Mobile	Windows Mobile
GNU Frēo Gewrita Amearcunge Lēaf	Licencia de documentación libre de GNU
John Kerry	John Kerry
Taiwan (īeg)	Isla de Taiwán
Searusprecend	Teléfono inteligente
Trōia	Troya
Nīwe Eoforwīc (scīrung)	Nueva York (desambiguación)
Ceafer	Coleoptera
Scōh	Zapato
Baðanceaster	Bath
Īrland	Irlanda (isla)
Bradanford	Bradford
Ceasterscīr	Cheshire
Lonceasterscīr	Lancashire
Norþhymbraland	Northumberland
Dūnholmscīr	Condado de Durham
Lincolnscīr	Lincolnshire
Snotingahāmscīr	Nottinghamshire
Dēorabyscīr	Derbyshire
Scrobbesbyrigscīr	Shropshire
Stæffordscīr	Staffordshire
Lægreceastrescīr	Leicestershire
Roteland	Rutland
Norþfolc	Norfolk
Sūþfolc	Suffolk
Grantabrycgscīr	Cambridgeshire
Norþhāmtūnescīr	Northamptonshire
Westmidlandscīr	Midlands Occidentales
Herefordscīr	Herefordshire
Wigreceastrescīr	Worcestershire
Wæringscīr	Warwickshire
Beadanfordscīr	Bedfordshire
Cornweal	Cornualles
Bricgstōw	Brístol
Defenascīr	Devon
Sumorsǣte	Somerset
Dorsǣte	Dorset
Gleawcesterscīr	Gloucestershire
Oxnafordscīr	Oxfordshire
Wiltūnscīr	Wiltshire
Hāmtūnescīr	Hampshire
Bearrucscīr	Berkshire
Buccingahāmscīr	Buckinghamshire
Ēastseaxe	Essex
Sūþrīge	Surrey
Cent	Kent
Lundenceaster	City de Londres
Huntandūnscīr	Huntingdonshire
Sūþseaxe	Sussex
Seofon	Siete
Taylor Lautner	Taylor Lautner
Cumbraland	Cumberland
Jeremy Renner	Jeremy Renner
Īs	Hielo
Fæder ūre	Padre nuestro
Musée d'Orsay	Museo de Orsay
Hwerhwette	Cucumis sativus
Edinburg	Edimburgo
Hwīt	Blanco (color)
Sweart	Negro (color)
Chris Pine	Chris Pine
Lordi	Lordi
6 (getæl)	Seis
Ambihtlicu sprǣc	Idioma oficial
Heortæppel	Solanum lycopersicum
Phong Nha-Ke Bang	Parque nacional Phong Nha-Kẻ Bàng
Entrena	Entrena
Selena	Selena Quintanilla Pérez
NASA	NASA
Merida (Feneswela)	Mérida (Venezuela)
Atlanta	Atlanta
Benito Mussolini	Benito Mussolini
Bermuda	Bermudas
Hēafod	Cabeza
Weolingtūn (Nīwe Sǣland)	Wellington (Nueva Zelanda)
Bryten	Gran Bretaña
Alfred Nobel	Alfred Nobel
Camb (tō hǣre)	Peine
Mennisc līc	Cuerpo humano
Lila Downs	Lila Downs
Andrew Garfield	Andrew Garfield
Dottatiger	Acinonyx jubatus
Rosanna Davison	Rosanna Davison
Albany on Nīwum Eoforwīce	Albany
Ūle	Strigiformes
Anguilla	Anguila (dependencia)
Guernsey	Guernsey
Scearpbeorgas	Svalbard
Hrycgdēor	Vertebrata
Nowy Dwór Królewski	Nowy Dwór Królewski
Faroisc sprǣc	Idioma feroés
Catt	Felidae
Lytel Spēonland	La Española
Harrisburg	Harrisburg
Hamor	Martillo
Picilemo	Pichilemu
Bryttiscan Fæmne Īegland	Islas Vírgenes Británicas
Flēoge	Diptera
Norða	Ártico
Hund	Canidae
Fresisc sprǣc	Lenguas frisonas
Antoni Gaudí	Antoni Gaudí
Cliferfētedēor	Artiodactyla
Steorrfisc	Asteroidea
Eurasisc bleohcrāwe	Garrulus glandarius
Hrōc	Corvus frugilegus
Ēotaland	Península de Jutlandia
Niþeru Þēodsc sprǣc	Bajo alemán
Mölnlycke	Mölnlycke
Coning	Oryctolagus cuniculus
Cuscan Rīce	Imperio kushán
Tromsīeg	Tromsø
Eormengyld Niccolò Cusano	Universidad Nicolás de Cusa
Montpelier on Uermonte	Montpelier (Vermont)
Geac	Bos mutus
Palistiniscre Frēogunge Þēodnes	Organización para la Liberación de Palestina
Westgermanisca sprǣca	Lenguas germánicas occidentales
Taylor Swift	Taylor Swift
Cōcīega	Islas Cook
Brocc	Meles meles
Sealterisc sprǣc	Frisón del Saterland
Middelasia	Asia Central
Langaland	Langeland
Jackson (Mississippi)	Jackson (Misisipi)
Concord (Nīwu Hāmtūnscīr)	Concord (Nuevo Hampshire)
Annapolis	Annapolis
Eald Corēa	Gojoseon
Hreaðemūs	Chiroptera
Ēastrīce-Ungerland	Imperio austrohúngaro
Tarnobrzeg	Tarnobrzeg
Wesle	Mustela
Scīr	Condado
Sandwīc (ǣt)	Sándwich
Spearwa	Passeridae
Eormanrīc	Hermanarico
Francisco Franco	Francisco Franco
Tarja Halonen	Tarja Halonen
Willis Tower	Sears Tower
Cantwaraburg	Canterbury
Cīna	China (región)
Universidad Mayor	Universidad Mayor
Tracter	Embudo
Englisc lagu	Derecho anglosajón
Seolh	Pinnipedia
Ecser	Ecser
Silesisc gereord	Idioma silesio
Zhengzhou	Zhengzhou
Foresittend	Presidente
Frencisc Polynesia	Polinesia Francesa
Roðem	Ruan
Crīstesmæsse Īeg	Isla de Navidad
Bleohfugol	Psittaciformes
Cambihtere	Cacatuidae
Arabea	Arabia
Fȳstlāc	Boxeo
Seax	Cuchillo
Top Gear	Top Gear
Tasmansǣ	Mar de Tasmania
Ceroke sprǣc	Idioma cheroqui
Campwīg be Tannebeorge	Batalla de Grünwald
Īsbera	Ursus maritimus
Hand	Mano
Tu Fu	Du Fu
Nīwe Scotta Ēaland	Nueva Caledonia
Cecoslofacia	Checoslovaquia
Lēaf	Hoja
Nepal Bhasa	Nepal bhasa
Valparaíso (on Cilan)	Valparaíso
Fugolīeg, Sūþgeorgia	Isla Pájaro (Georgias del Sur)
Annenkovīeg	Isla Annenkov
Nathalia Dill	Nathalia Dill
Oaxaca	Oaxaca
Tahitisc sprǣc	Idioma tahitiano
Flemisc sprǣc	Dialecto flamenco
Yasser Arafat	Yasir Arafat
Oxnaford	Oxford
Międzyrzec Podlaski	Międzyrzec Podlaski
Tasmania	Tasmania
Creto	Creta
Saint-Dié-des-Vosges	Saint-Dié-des-Vosges
Eormengyld Oxnafordes	Universidad de Oxford
Þyrla	Helicóptero
Sancte Elene Īeg	Isla Santa Elena
Nicor	Hippopotamus amphibius
Egisca Sǣ	Mar Egeo
Ichiro Mizuki	Ichirō Mizuki
Anastacia	Anastacia
Eufrāte	Éufrates
James A. Garfield	James A. Garfield
Cirice	Iglesia
Persisc Sǣ	Golfo Pérsico
Sand	Arena
Cyningestūn (Iamaica)	Kingston
Lafor	Panthera pardus
Age of Empires	Age of Empires (serie)
Tequixquiac	Tequixquiac
Ulysses S. Grant	Ulysses S. Grant
Oklahoma City	Oklahoma City
Meotedisca Mere	Mar de Azov
William McKinley	William McKinley
Cawel	Brassica oleracea var. capitata
Foresittend þāra Geāndena Rīca	Anexo:Presidentes de los Estados Unidos
Sūþgeorgia and þā Sūþsandwic Īegland	Islas Georgias del Sur y Sandwich del Sur (territorio británico de ultramar)
Webbsīde	Sitio web
Ealdfresisc sprǣc	Frisón antiguo
Catalão	Catalão
Grover Cleveland	Grover Cleveland
Ealdhēahþēodisc	Alto alemán antiguo
Ealdseaxisc sprǣc	Sajón antiguo
Satan	Satanás
Wordstǣrcræft	Etimología
Beorglēo	Puma concolor
Arabas	Pueblo árabe
Proponditis	Mar de Mármara
Ēagduru	Ventana
Chester A. Arthur	Chester A. Arthur
Riffeng	Montes Urales
Rīcu þāra Geāndena Rīca American	Estado de los Estados Unidos
Pitcearnīega	Islas Pitcairn
Benjamin Harrison	Benjamin Harrison
Rutherford B. Hayes	Rutherford B. Hayes
Wīnlendisc panðer	Panthera onca
Sūþaustralia	Australia Meridional
Gotisc sprǣc	Idioma gótico
Boise	Boise
Bāt	Barco
Awaisc sprǣc	Idioma guaraní
Gærsbēam	Bambuseae
Interlingua	Interlingua
Bosporos	Bósforo
Smyrna	Esmirna
Lemburg	Leópolis
Cwēneland	Queensland
Siligo	Siligo
Puerto Montt	Puerto Montt
Iane Austen	Jane Austen
Tægcwondo	Taekwondo
Middel Englisc sprǣc	Inglés medio
Māorisc sprǣc	Idioma maorí
Hannibal	Aníbal
Hōrdōm	Prostitución
Twinemniendlic nama	Nomenclatura binomial
Victoria (Australia)	Victoria (Australia)
Geugoslafia	Yugoslavia
Ætla	Atila
Scrælingas	Indígenas de América
Arancón	Arancón
Willelm Heretoga of Grantanbrycge	Guillermo de Cambridge
Toshiro Mifune	Toshirō Mifune
Tallahassee	Tallahassee
Sundorrīcehād	Independencia
Bismarck (Norþdakota)	Bismarck (Dakota del Norte)
Aucland	Auckland
Iohannes Paulus I Pāpa	Juan Pablo I
John Michael Talbot	John Michael Talbot
Acrotiri and Ðecelia	Acrotiri y Dhekelia
Arara	Arara (Paraíba)
Cnēo	Articulación de la rodilla
Willelm I Engla Cyning	Guillermo I de Inglaterra
Campora Sancte Iohannes	Campora San Giovanni
Sīde	Seda
Sint-Truiden	Sint-Truiden
Lēoðlic scātung	Patinaje artístico sobre hielo
Stefn (līfcræft)	Filo
Heanrig VIII Engla Cyning	Enrique VIII de Inglaterra
Columbia (Sūþcarolīna)	Columbia (Carolina del Sur)
Xena: Warrior Princess	Xena: la princesa guerrera
1880. gēar oþ 1889. gēar	Años 1880
Helena (Montana)	Helena (Montana)
Wælhwelp	Perro de caza
Eormengyld Biobiwes	Universidad del Bío-Bío
Sufa	Suva
Muntgumniscīr	Montgomeryshire
Eorþmistel	Ocimum basilicum
Lēohtfȳsend	Láser
Prēossland	Prusia
Cheyenne (Wyoming)	Cheyenne (Wyoming)
Norðerne healftrendel	Hemisferio norte
Loidis	Leeds
Fūcgī Beorg	Monte Fuji
Mūs	Mus (animal)
Geolurēad	Naranja (color)
Æcs	Hacha
Seofonbyrig	Transilvania
Tōl	Herramienta
Alī	Ali Ibn Abi Talib
Hrān	Rangifer tarandus
Stānhencg	Stonehenge
Ágreda	Ágreda
Amazonas	Amazonas (Brasil)
Ajaccio	Ajaccio
Rodorcræft	Nave espacial
Lisa Gerrard	Lisa Gerrard
Thirty Seconds to Mars	30 Seconds to Mars
Paulínia	Paulínia
Pierre	Pierre
Crabba	Brachyura
God Nerie þā Cwēne	God Save the Queen
Meteūtsiht	Diarrea
Anna Maria Jopek	Anna Maria Jopek
Horshwæl	Odobenus rosmarus
Fōrhēafod	Frente (anatomía)
Haile Selassie	Haile Selassie
Caðum	Caen
Sonygegyld	Sony
Mynet	Moneda
Sūðerne Healftrendel	Hemisferio sur
Cnihtas þæm Temple	Caballeros templarios
Americanisc fōtball	Fútbol americano
Tōþsticca	Mondadientes
Folcmorðor	Genocidio
Hociȝ	Hockey sobre hielo
Swīnmūþa	Świnoujście
Īrisc Sǣ	Mar de Irlanda
Tracia	Tracia
Mongolas	Mongol (etnia)
Mǣs	Río Mosa
Talcahuano	Talcahuano
Tahitīeg	Tahití
Ontynung	Apocalipsis
Abel Tasman	Abel Tasman
Gotan	Pueblo godo
Nettfrumfindend	Localizador de recursos uniforme
Ænglisc sprǣc	Idioma anglosajón
Englisc folc	Pueblo inglés
Eoforwic	York
Iron Maiden	Iron Maiden
Asterix	Astérix el Galo
Grǣg	Gris
Wearm geard	Zona intertropical
Hwælhuntoþ	Caza de ballenas
Sǣcū	Trichechus
Gregorius Pāpa I	Gregorio Magno
Cȳta (lyftcræft)	Cometa (juego)
Þunor	Thor
Castel Goffredo	Castel Goffredo
Roðos	Rodas
Sanct	Santo
Wikipǣdia:FAQ	Ayuda:Preguntas frecuentes
Galatasaray	Galatasaray S.K
Cycene	Cocina (habitación)
Wæterdraca	Crocodylidae
Hlæstwægn	Camión
Carl Wēala Þēoden	Carlos de Gales
Villeneuve-d'Ascq	Villeneuve-d'Ascq
Crāwe	Corvus
Sūþtun on Defnum	Plymouth
Bryttisca Indisca Garsecg Landscipe	Territorio Británico del Océano Índico
Dēoraby	Derby
Francan	Pueblo franco
Fealcen	Falco
Nightwish	Nightwish
Mattheus se Godspellere	Mateo el Evangelista
Mac OS	Mac OS
Leyden	Leiden
Fiðerlēasere	Apteryx
Montehermoso	Montehermoso
Louis the Pious	Ludovico Pío
Cwēnsǣ	Mar Blanco
Jim Morrison	Jim Morrison
GNOME	GNOME
Hāt	Calor
Spere	Lanza
Ēadig getæl	Número feliz
Charleston (Westvirginia)	Charleston (Virginia Occidental)
Mynster	Monasterio
Oxnaford Englisc Wordbōc	Oxford English Dictionary
Īsearn	Alcedines
Carl XVI Gustaf Swēona Cyning	Carlos XVI Gustavo de Suecia
Świętochłowice	Świętochłowice
Zac Efron	Zac Efron
Monte Carlo	Montecarlo
Elba	Isla de Elba
The Doors	The Doors
Fylfōt	Esvástica
Clerke Clūdas	Rocas Clerke
Hara	Lepus
Rīcisc edisc	Parque nacional
Boga	Arco (arma)
Byrdling	Testudinidae
Bryttisc landbūnes	Territorio británico de ultramar
Brūn	Marrón
Hjaltland	Islas Shetland
Byrddæg	Cumpleaños
Æx-in-Profentse	Aix-en-Provence
Gaza	Gaza
Īsbeorg	Iceberg
Ephese	Éfeso
Englisc wera rīcisc fōtballtēam	Selección de fútbol de Inglaterra
Pratibha Patil	Pratibha Patil
Minte	Mentha
Spilcarte	Baraja
Bysen:Commonscat	Plantilla:Commonscat
Hālig Land	Tierra Santa
Folcland Gewinn	Guerra de las Malvinas
Bēowulf	Beowulf
Marīahæfen	Mariehamn
Hrǣw	Cadáver
IOS	IOS
Lee Harvey Oswald	Lee Harvey Oswald
Frumtæl	Número primo
Þ	Þ
Orlando	Orlando (Florida)
Saint Petersburg	San Petersburgo (Florida)
Hereðaland	Hordaland
Sogn and þa Flēotas	Sogn og Fjordane
Meore and Romsdæl	Møre og Romsdal
Troms	Troms
Dǣlere	Divisibilidad
Australisc fōtþōðer	Fútbol australiano
Secglēac	Allium schoenoprasum
Stānweall sacunga	Disturbios de Stonewall
Providencia (Cile)	Providencia (Chile)
Punta Arenas	Punta Arenas
Aaron	Aarón
Wu-Tang Clan	Wu-Tang Clan
Osgar I Swēona Cyning	Óscar I de Suecia
Hwēolrinnung	Ciclismo
Aquilegia	Aquilea (Italia)
Hyll	Cerro
Flocc:Cyningas	Categoría:Reyes
Beorneslēah	Barnsley
Soria (scīr)	Provincia de Soria
San Carlos (on Cilan)	San Carlos (comuna)
El Royo	El Royo
Harold V Norrena Cyning	Harald V de Noruega
Þēodlic Dæg	Día nacional
John Key	John Key
Ēadweard I Engla Cyning	Eduardo I de Inglaterra
Sūþerne Thila	Islas Tule del Sur
Candelmæssanīega	Archipiélago Candelaria
Ræt	Muroidea
Vladimír Franz	Vladimír Franz
Ariel Sharon	Ariel Sharón
1050e	Años 1050
Æneid	Eneida
Autaugaville, Alabama	Autaugaville
Forma Frencisce Rīce	Primer Imperio francés
Brādford	Bredevoort
Se Holbytla	El hobbit
Eocene	Eoceno
Hwilpe	Numenius americanus
Strǣt	Calle
Superman	Superman
Heorotbrēr	Rhamnus
Wikipǣdia:Fulgōdra gewrita teohhunga	Wikipedia:Candidatos a artículos destacados
Wikipǣdia:Gōd gewrit genamunga	Wikipedia:Selección de artículos buenos
Rætswīn	Cavia porcellus
Iconium	Konya
Emma Goldman	Emma Goldman
Iacobus I Grēatre Bryten Cyning	Jacobo I de Inglaterra y VI de Escocia
Crīstcirice	Christchurch
Coronel Fabriciano	Coronel Fabriciano
Babsk	Babsk
Englisca Ingewinn	Revolución inglesa
Bengal	Bengala
Morgenmete	Desayuno
1060e	Años 1060
Pippen III Francena Cyning	Pipino el Breve
Carl I (Grēatre Bryten Cyning)	Carlos I de Inglaterra
Ȝealdor/ᚷᛖᚪᛚᛞᚩᚱ	Magia
Cucler	Cuchara
Geþofted Rīcu American	Estados Confederados de América
Elpendbān	Marfil
Villarrobledo	Villarrobledo
Temuco	Temuco
Hloðwic I Francena Cyning	Clodoveo I
William Wallace	William Wallace
Bundesliga	Bundesliga (Alemania)
Fȳrland	Archipiélago de Tierra del Fuego
Frēols þǣre Sunnan (on Meridan)	Feria del Sol (Mérida)
Maria I Engla Cwēn	María I de Inglaterra
Angelcirice	Iglesia de Inglaterra
Lencten (tīd)	Cuaresma
Fuþorc	Alfabeto rúnico
Lēactric	Lactuca sativa
Beadu Hǣstingum	Batalla de Hastings
Ēadweard VI Engla Cyning	Eduardo VI de Inglaterra
Jacques-Yves Cousteau	Jacques-Yves Cousteau
Horatio Nelson	Horatio Nelson
Galilēa	Galilea
Gaderscypefāna	Bandera del Reino Unido
Foldlic clūt	Litosfera
Þunor (weder)	Trueno
Þūma	Dedo pulgar
Ælfrēd Micela	Alfredo el Grande
Hāmlǣrung	Educación en el hogar
Teutoburg Weald Beadu	Batalla del bosque de Teutoburgo
Bysen:Cite book	Plantilla:Cita libro
O Canada	O Canada
Biobío	Río Biobío
Orcanege	Orcadas
Profentse	Provenza
Predore	Predore
Seaxe	Pueblo sajón
Willelm II Engla Cyning	Guillermo II de Inglaterra
Limburgisc	Idioma limburgués
Eallerīca Gotena Cyning	Alarico I
Tygelwīg	Juego de la soga
Boētius	Boecio
Hunigbēo	Apis (género)
Abbod	Abad
Mæcedonia	Macedonia (región)
Sameramis	Semíramis
Pīp	Pipa
Aerosol	Aerosol
Gangnihessou	Gangnihessou
Ilfingburg	Elbląg
Mierce	Reino de Mercia
Þēodrīc Ēastgotena Cyning	Teodorico el Grande
Westseaxena Rīce	Reino de Wessex
Hēahland	Tierras Altas de Escocia
Norþhymbra Rīce	Reino de Northumbria
Wulfila	Ulfilas
Bram Stoker's Dracula	Drácula, de Bram Stoker
Angeow	Ducado de Anjou
2011 FIFA Frēona Woruldceampscipe	Copa Mundial Femenina de Fútbol de 2011
Alexander VI Pāpa	Alejandro VI
Æppellēaf	Viola odorata
Mexiciscu rīce	Organización territorial de México
Edward Braddock	Edward Braddock
Cethāmīga	Islas Chatham
Norþīg	Isla Norte
Anne Cwēn	Ana de Gran Bretaña
Sūþīeg	Isla Sur
Husvik	Husvik
Sunnstede	Solsticio
Wynton Rufer	Wynton Rufer
Kara	Kara (banda)
Ceadmere	Lago Chad
Getalu Rōmāniscra Cāsera	Anexo:Emperadores romanos
Heantun	Wolverhampton
Wascas	Vasco
Minerva	Minerva
Fȳræg	Bomba (explosivo)
Ashley Tisdale	Ashley Tisdale
Þrondham	Trøndelag
Nīwe Woruld	Nuevo Mundo
Æsc	Fraxinus
Galwæg	Galway
Ēadweard Andettere	Eduardo el Confesor
Hramsa	Allium ursinum
Scīdfarung	Esquí
World of Warcraft	World of Warcraft
Byrig þāra Geāndena Rīca	Anexo:Ciudades de Estados Unidos por población
Nemniendlic cāsus	Caso nominativo
Folcawanderung	Invasiones bárbaras
Slayer	Slayer
Maria Scotta Cwēn	María I de Escocia
Indisc rīce	Estados y territorios de la India
Scield	Escudo
Henry V Englalandes	Enrique V de Inglaterra
Sciþþia	Pueblos escitas
Universidade Federal de Minas Gerais	Universidad Federal de Minas Gerais
Sceanca	Pata
Pulgare	Búlgaros
Lyftscip	Dirigible
Cnut se Micela	Canuto II de Dinamarca
Saturnus	Saturno (mitología)
Exanceaster	Exeter
Sanctes Laurentes Ēa	Río San Lorenzo
Mundlēow	Lavabo
Sūþhjaltland	Islas Shetland del Sur
Cartespil	Juego de naipes
Iscimbag	Ishimbái
Basu Heorte	Corazón Púrpura
Marianburg	Malbork
Tenczynek	Tenczynek
Rudno	Rudno (Krzeszowice)
Rudawa	Rudawa
Rosseg	Mainland (Orcadas)
Monica Iozzi	Monica Iozzi
Nīwsǣlandworulddǣl	Zealandia
Carl Fǣtta Francena Cyning	Carlos III el Gordo
Þēodisc Āþbēorscipe	Confederación Germánica
Wikipǣdia:How to edit a page	Ayuda:Cómo se edita una página
Cantwarabyrig eorþbeofung 2011.	Terremoto de Christchurch de febrero de 2011
Eorðæppelstycce	Papas fritas
Rīnland	Renania
Eormengyld Tybingenes	Universidad de Tubinga
Blōdmearh	Morcilla
Midsumor	Midsommar en Suecia
Anlaf V Norrena Cyning	Olaf V de Noruega
Ēadweard Westseaxna Eorl	Eduardo de Wessex
Hacun VII Norrena Cyning	Haakon VII de Noruega
Ecgbryht	Egberto
Earnulf Carendran	Arnulfo de Carintia
Bēda	Beda
Laplandes Gūþ	Guerra de Laponia
Willelm-Alexander Niðerlanda Cyning	Guillermo Alejandro de los Países Bajos
Bredspearctellend	Tableta (computadora)
Mathusal	Matusalén
Universidade Estadual de Feira de Santana	Universidad Estatal de Feira de Santana
Bægware	Bávaros
Europisc wild gingifer	Asarum europaeum
Bēowyrt	Acorus calamus
Pontcysyllte Wætertyge	Acueducto de Pontcysyllte
Universidade Federal da Bahia	Universidad Federal de Bahía
Centro Federal de Educação Tecnológica de Minas Gerais	Centro Federal de Educación Tecnológica de Minas Gerais
Nēohwæl	Monodon monoceros
Ajman	Ajmán (emirato)
Harold Godwinson	Haroldo II de Inglaterra
Ȳþrīdung	Surf
Brū	Pestaña
Port:Stǣr	Bandera de Tayikistán
Kiæresburh	Cherburgo-Octeville
Bresl	Pretzel
CONCACAF	Concacaf
Mentha arvensis	Mentha arvensis
Searoburg	Salisbury
Lunden Ēage	London Eye
Valdivia	Valdivia
Pachuca de Soto	Pachuca de Soto
Crāwlēac	Allium vineale
Balsminte	Mentha aquatica
Dweorgedosle	Mentha pulegium
Landbūnes	Territorio dependiente
Rēadingas	Reading
Mængo	Mangifera
Grēate Bryten Cynerīce	Reino de Gran Bretaña
Brōcminte	Mentha longifolia
Iane Grey Hlæfdige	Juana Grey
Charmed	Charmed
Grammatisc cyn	Género gramatical
Nica Ūphebbung	Disturbios de Niká
Sihþ	Visión
Brycgāðexe	Sphenodon
Hetware	Chatti
Americanisc wera rīcisc fōtballtēam	Selección de fútbol de los Estados Unidos
Maywood, Illinois	Maywood (Illinois)
Þrēo Coreaniscu Cynerīcu	Tres Reinos de Corea
Feðer (blæces)	Pluma (escritura)
Pening	Pfennig
Bryttisca Antarctisca Landscipe	Territorio Antártico Británico
Starcraft	StarCraft
Seofon dēadlica synna	Pecados capitales
Zavodovski-īeg	Isla Zavodovski
Finger	Dedo medio
Midwearme geardas	Clima templado
Angleseg	Anglesey
Niðerseaxisc sprǣc	Bajo sajón
Māse	Paridae
Caselle Landi	Caselle Landi
Penwiðsteort	Land's End
Ratchet & Clank	Ratchet & Clank (videojuego)
Æðelstān Engla Cyning	Athelstan
Ras al-Khaimah	Ras al-Jaima (emirato)
Elene Constantinoples	Helena de Constantinopla
Nintendo DS	Nintendo DS
Ēse	Æsir
Nīwe Francland	Nueva Francia
Englalandes Fana	Bandera de Inglaterra
Cyclades	Cícladas
Trafalgar Sǣfeoht	Batalla de Trafalgar
Iosephine Francena Caserin	Josefina de Beauharnais
Sōlate	Helianthus annuus
Cynelica Sciphere	Royal Navy
Inbærnes	Olíbano
Difelinscīr	Condado de Dublín
Æppelcyrnel (wǣpen)	Granada de mano
Helm	Casco
Umm Al Quwain	Umm al-Qaywayn
Nīwes Sǣlandes þēodlīc fōtþōðerhēap	Selección de fútbol de Nueva Zelanda
Ingang:Stǣr	Portal:Historia
Nonne Etone	Nuneaton
The Oval	The Oval (Belfast)
2010 FIFA Woruldceampscipe	Copa Mundial de Fútbol de 2010
Sunu	Hijo
Caltojar	Caltojar
Grīpfealcen	Falco rusticolus
Snāwbordfarung	Snowboarding
Ōsgeard	Asgard
Glīdflēogung	Parapente
Mageoscīr	Condado de Mayo
Berlanga de Duero	Berlanga de Duero
Blizzard Entertainment	Blizzard Entertainment
Gerinnung	Coagulación
Dofras	Dover (Kent)
Cannae Beadu	Batalla de Cannas
Herenuma	Prisionero de guerra
Dȳfung	Buceo
Daguerreotype	Daguerrotipo
Dūnholm	Durham
Þrēotīene Landbūnessa	Trece Colonias
Brenda Song	Brenda Song
Lincoln	Lincoln (Lincolnshire)
Syllīega	Islas Sorlingas
Smallville (TV endebyrdnes)	Smallville (serie de televisión)
Helen Clark	Helen Clark
Būr	Habitación
Wēala Þēoden	Príncipe de Gales
Scōnīeg	Escania
Milanes Bann	Edicto de Milán
Francforta	Perrito caliente
Gelocen boge	Ballesta
Catalan Byht	Catalan Bay
Wichlawscīr	Condado de Wicklow
Striuelin	Stirling
Æðelred Unrǣd	Etelredo II el Indeciso
Twentig Þūsend Lēowena Under þǣm Sǣ	Veinte mil leguas de viaje submarino
Baius	Bayeux
Ballōn (lyftcræft)	Globo aerostático
Colneceaster	Colchester
Meodu	Hidromiel
Met (Grammaticcræft)	Modo gramatical
Sǣelpend	Mirounga
Grytviken	Grytviken
Fox News	Fox News Channel
Brīw	Gacha
Ēadweard se Ieldra	Eduardo el Viejo
Iþacige	Ítaca
Baius tæpped	Tapiz de Bayeux
San Fabián de Alico	San Fabián (Chile)
Montréal Canadiens	Canadiens de Montréal
Underburg	Suburbio
Sharjah	Sharjah (emirato)
Antrimscīr	Condado de Antrim (Irlanda del Norte)
Vigdís Finnbogadóttir	Vigdís Finnbogadóttir
Final Fantasy	Final Fantasy
Norrena Cyning	Anexo:Monarcas de Noruega
Westmynster	Westminster (Londres)
Ēadmund Æðeling	Edmundo I de Inglaterra
Rachel McAdams	Rachel McAdams
Fermanagh	Condado de Fermanagh
Dūnscīr	Condado de Down
E Pluribus Unum	E Pluribus Unum
Foresittend Franclandes	Presidente de la República Francesa
New Jersey Devils	New Jersey Devils
Philadelphia Flyers	Philadelphia Flyers
Yun Chi-ho	Yun Chi-ho
Sancte Elene Īeg, Upstigeīeg and Tristan da Cunha	Santa Elena, Ascensión y Tristán de Acuña
Tirowen	Condado de Tyrone
Jack Ruby	Jack Ruby
Ardmachusscīr	Condado de Armagh
Scene	Río Shannon
Wīnland	Vinland
Venom (trūðhlōð)	Venom (banda)
Luel	Carlisle
Ēadgar Engla Cyning	Edgar el Pacífico
Kea	Nestor notabilis
Itumbiara	Itumbiara
A Night at the Opera	A Night at the Opera
Queen (album)	Queen (álbum)
Þunres Hamor	Mjolnir
Oben am jungen Rhein	Oben am jungen Rhein
Guinness	Guinness
Scræfclūdas (Sūþgeorgia)	Islas Aurora
Łobez	Łobez
Liðere	Honda (arma)
Thomas Cranmer	Thomas Cranmer
Tawpomere	Lago Taupo
Universidad de Concepción	Universidad de Concepción
Hameldūn (Nīwe Sǣland)	Hamilton (Nueva Zelanda)
Stǣr þǣre Worulde	Historia universal
Rēad wulf	Canis rufus
Normandisca Forcyme	Conquista normanda de Inglaterra
Vitacura	Vitacura
Yungay	Yungay (Chile)
Fif Scīr	Fife
Carolina Hurricanes	Carolina Hurricanes
Nebrond	Nemrod
Tampa Bay Lightning	Tampa Bay Lightning
Scrobbesburh	Shrewsbury
Fæger hǣr	Rubio
Napier (Nīwe Sǣland)	Napier (Nueva Zelanda)
Myrra	Mirra
Harold III Norrena Cyning	Harald III de Noruega
Fisc and styccu	Fish and chips
Brooke Fraser	Brooke Fraser
Middeltūn þǣra de Cahaignes	Milton Keynes
Florida Panthers	Florida Panthers
Washington Capitals	Washington Capitals
Īrisc fōtþōðer	Fútbol gaélico
Nīwes Sǣlandes Þēodlic Stēormǣlhēap	Partido Nacional de Nueva Zelanda
West Loðene	West Lothian
Lonceaster	Lancaster (Lancashire)
Sūþalpis	Alpes del Sur
Midloðene	Midlothian
Neamere	Lago Neagh
Maðante	Mantes-la-Jolie
Ēast Loðene	East Lothian
Fermat tæl	Número de Fermat
Clackmannanscīr	Clackmannanshire
Liccidfeld	Lichfield
Sūþorcanege	Islas Orcadas del Sur
Rænkīnes hātȝemet	Rankine
Se Fēolagascipe þæs Hringes	La Comunidad del Anillo
Cod	Gadidae
Gold (bleoh)	Oro (color)
Holstānburg	Sisimiut
Micel Ficgīeg	Viti Levu
Wrenna	Troglodytidae
Ciricewæl	Kirkwall
1984 (bōc)	1984 (novela)
Folcaþing	Folketing
Underset gamen	Expansión (videojuegos)
Elig	Ely
Getalu burga in Þēodsclande	Anexo:Ciudades de Alemania
Innuendo	Innuendo (álbum)
Concepcion Hēafodcirice	Catedral de la Santísima Concepción
The Game	The Game (álbum)
Bancorena burg	Bangor
Gēol	Jul
Washington Redskins	Washington Redskins
Swīma	Vértigo
Ægelesburg	Aylesbury
Tristania	Tristania
Wuldor	Ull
Ēsatrēowþ	Ásatrú
Lāmwic	Lerwick
Westgeatland	Vestrogotia
Rosenrot	Rosenrot
Wīcinga Ieldu	Época vikinga
Victory (scip)	HMS Victory
Sihhem	Nablus
Beatrix Potter	Beatrix Potter
Ēadgar Æðeling	Edgar Atheling
Grēat Rōmisc Fȳr	Gran incendio de Roma
Mann	Persona
Tollund wer	Hombre de Tollund
Hēapplega	Deporte de equipo
Levanger	Levanger
Violetta Villas	Violetta Villas
Ynce	Pulgada
Gearwung (plega)	Ejercicio físico
Diablo (gamen)	Diablo (videojuego)
Anggun	Anggun
Verizon Center	Verizon Center
Wīfa rihta forðung	Derechos de la mujer
Apaxco	Apaxco
Cham	Cam
Zune	Zune
Nettþōðer	Netball
Lox	Lynx
In	In
Diablo	Diablo (desambiguación)
Wiltūn	Wilton
Roanoke	Roanoke
Cnut	Knut
Eormengyld Ciles	Universidad de Chile
Offa Miercna Cyning	Offa de Mercia
Engel	Ángel
Sasha Cohen	Sasha Cohen
Rachael Taylor	Rachael Taylor
Æðelflǣd	Ethelfleda de Wessex
Pat Benatar	Pat Benatar
Michelle Kwan	Michelle Kwan
Wæstm	Producto agrícola
Beate Eriksen	Beate Eriksen
Berhte Cent Cwēn	Berta de Kent
D.C. United	D.C. United
Eowland	Öland
Starcraft II	StarCraft II
Allan Kardec	Allan Kardec
Deadache	Deadache
Diablo III	Diablo III
Sceadu (gyden)	Skaði
Diablo II	Diablo II
Atlanta Thrashers	Atlanta Thrashers
Hwītlēachring	Aros de cebolla
The God Delusion	El espejismo de Dios
Canadisc fōtþōðer	Fútbol canadiense
Hæstingas (missenlīc gewritu)	Hastings (desambiguación)
Ealra Hālgena Ǣfen	Halloween
Ēostre	Ostara
Sūþtun	Sutton
Weorcdæg	Jornada de trabajo
Leðerhosu	Lederhosen
Bān	Hueso
7 World Trade Center	World Trade Center 7
Vampire Knight	Vampire Knight
Ælfrīc Abbod of Egoneshame	Aelfrico
Ælle Sūþseaxna cyning	Aelle de Sussex
Æðelbald West-Seaxna Cyning	Ethelbaldo de Wessex
Æðelrǣd	Etelredo de Mercia
Ælfweard West-Seaxes	Ethelweard
Bēagel	Bagel
Rēcels	Incienso
Iapanisc āttorcopplic crabba	Macrocheira kaempferi
Stromnæss, Sūþgeorgia	Stromness (Georgia del Sur)
Woruldlic Gemōt þāra Ciricena	Consejo Mundial de Iglesias
Blæcesburg, Virginia	Blacksburg (Virginia)
Ériu	Ériu
Marjorie Estiano	Marjorie Estiano
Ítróttarfelag Fuglafjarðar	ÍF Fuglafjørður
Fotþōðer	Fútbol (homonimia)
Transformers	Transformers (desambiguación)
Oresundes brycg	Puente de Oresund
Denegield	Danegeld
Vadillo	Vadillo
Spell Twēgra Burga	Historia de dos ciudades (novela)
Morbid Angel	Morbid Angel
John Ashcroft	John Ashcroft
Alexander Ovechkin	Aleksandr Ovechkin
Orosius	Paulo Orosio
Alexis Tsipras	Alexis Tsipras
Dufenal I Scotta	Donald I de Escocia
Constontinus I Scotta Cyning	Constantino I de Escocia
Joseph Serchuk	Joseph Serchuk
Babez for breakfast	Babez For Breakfast
Philip Jaisohn	Seo Jae-pil
Widukind	Viduquindo
Wælheall Herig	Walhalla (monumento)
Æbbandūn	Abingdon
Law & Order	Law & Order
Westmannland	Västmanland
Hengest	Hengest
Moretoin	Mortain
Leaves' Eyes	Leaves' Eyes
Jeanette Biedermann	Jeanette Biedermann
Corn Flakes	Corn Flakes de Kellogg's
Amol	Amol
Penda Miercna Cyning	Penda de Mercia
Dūnstān	Dunstán
Mælcolm II Scotta Cyning	Malcolm II de Escocia
Ēadgar Scotta Cyning	Edgardo de Escocia
Ofergewiht	Sobrepeso
Constontinus II Scotta Cyning	Constantino II de Escocia
Pak Hon-yong	Pak Heon-yeong
Americanisc frēona rīcisc fōtballtēam	Selección femenina de fútbol de los Estados Unidos
Obituary	Obituary
Berserca	Berserker
Jordan Galland	Jordan Galland
Minoru Yamasaki	Minoru Yamasaki
Offa	Offa
Canceler	Canciller
Almaluez	Almaluez
Pulgara Cyning	Anexo:Monarcas de Bulgaria
Cuneglæsse	Cynoglossum officinale
Ēadmund se Martyr	Edmundo del Anglia Oriental
Australisca Witenagemōt	Parlamento de Australia
Lao	Pueblo laosiano
Wīfel	Curculionoidea
Agalloch	Agalloch
Godspell Mattheus	Evangelio de Mateo
Ēadweard Cyning Næss	Base King Edward Point
Ēadmund	Edmund
Palestinisce Landscipas	Territorios Palestinos
Ajattara	Ajattara
James Ēa	Río James (Virginia)
Ȝ	Yogh
Gærsīeg, Sūþgeorgia	Isla Grass
Nazarēth	Nazaret
Rise of Nations	Rise of Nations
Kate Sheppard	Kate Sheppard
Geþingedōm	Subdivisiones de Escocia
Getalu Smallville-belimpdǣla	Anexo:Episodios de Smallville
Kwara Rīce	Kwara
Windlesōra	Windsor (Berkshire)
America's Cup	Copa América (regata)
Wīnlendisc cystel	Castanea dentata
Rædwald Ēastengla Cyning	Redvaldo de Estanglia
Ēadbald	Eadbaldo de Kent
Oswiu Norþhymbra Cyning	Oswiu de Northumbria
Paramore	Paramore
Recedham	Rochdale
Illative cāsus	Caso ilativo
Herelic munucregol	Orden militar
Ǣȝhnōg	Ponche de huevo
Coritiba Foot Ball Club	Coritiba Foot Ball Club
Tansonnhates Geondrīciscum Lyfthæfene	Aeropuerto Internacional de Tan Son Nhat
Þresc stīele	Thrash metal
The Chronicles of Narnia	Las Crónicas de Narnia
Aliud	Aliud
Iacub Colas	Yakub Kolas
Baraona	Baraona
James Hetfield	James Hetfield
Keane	Keane
Medinaceli	Medinaceli
Láchar	Láchar
Burgo de Osma-Ciudad de Osma	El Burgo de Osma
Suellacabras	Suellacabras
Yanguas	Yanguas
Get Heavy	Get Heavy
Pensacola	Pensacola
The Arockalypse	The Arockalypse
Anath	Anat
San Esteban de Gormaz	San Esteban de Gormaz
The Monsterican Dream	The Monsterican Dream
Barbourscīr, Westvirginia	Condado de Barbour (Virginia Occidental)
Duval Scīr, Florida	Condado de Duval (Florida)
Hāmtūnscīr Scīr, West Virginia	Condado de Hampshire (Virginia Occidental)
Rēadgrot mid flīetan	Rote Grütze
Samsung Galaxy Note	Samsung Galaxy Note
Perfume	Perfume (banda)
Park Jung-yang	Park Jung-yang
Rōwrenoc (Virginia)	Roanoke (Virginia)
Sūþtūn Hōh	Sutton Hoo
Tuidi	Río Tweed
Sǣbeorg	Monte submarino
Dornwaraceaster	Dorchester (Dorset)
Chris Pratt	Chris Pratt
Walhshalh	Walsall
Bēdesford, Virginia	Bedford (Virginia)
Ēadƿeard Æðeling Scīr, Virginia	Condado de Prince Edward
Angul	Angeln
Cañamaque	Cañamaque
Cambihtuc	Nymphicus hollandicus
Navaleno	Navaleno
Hwælsang	Canto de las ballenas
Lanercscīr	Lanarkshire
Apulder	Appledore
Wyr, Orcanege	Wyre (Orkney)
Þrīnessunnandæg	Domingo de Trinidad
Brecenscīr	Brecknockshire
Anna Ēastengla Cyning	Anna de Estanglia
Cannae	Cannas
Niht (gyden)	Nótt
Trévago	Trévago
Scīrburna	Sherborne
JavaScript weorcsearu	Intérprete de JavaScript
Dévanos	Dévanos
Mexicanisc frēona rīcisc fōtballtēam	Selección femenina de fútbol de México
Læland	Lolandia
God Hates Us All	God Hates Us All
Gemǣne Rīca of Australie	Gobernador general de Australia
Geþacasteort	Península Thatcher
Ælmer	Eilmer de Malmesbury
Grahamland	Tierra de Graham
Wikipǣdia:Sceortpæþ	Ayuda:Atajos
Ólvega	Ólvega
Eormengyld Juraj Dobrila on Pula	Universidad Yurai Dobrila de Pula
Scieppend	Deidad creadora
Dopenid	Fulica
Swearttægelhara	Lepus californicus
Sybelhūs on Lundne	Banqueting House
Beadu þæs Bogn	Batalla del Boyne
Puebla FC	Puebla Fútbol Club
MorphOS	MorphOS
Minga Guazú	Minga Guazú
Atari Jaguar	Atari Jaguar
Smallville (Gēar 4)	Anexo:Cuarta temporada de Smallville
Hēffe Wehbig	Haifa Wehbe
Magaña	Magaña
Ulfretūn	Newbury
Tæppa	Llave de paso
Smallville (Gēar 3)	Anexo:Tercera temporada de Smallville
Tīdunghēap	Grupo de noticias
Nile (trūðhlōð)	Nile
Scēaþ	Vaina
Stǣr Angelþēode ciricean	Historia ecclesiastica gentis Anglorum
Rēan	Ran
Vindicationīeg	Isla Vindicación
Negombo	Negombo
Centenera de Andaluz	Centenera de Andaluz
Lox (catte)	Lynx (animal)
Gewuldorbeagungīeg (on Sūþorcanege)	Isla Coronación
Lǣden-ofgangena stæfrǣwa	Anexo:Alfabetos derivados del latino
Huntandūn	Huntingdon
Tomtun	Tamworth
City of Heroes	City of Heroes
World of Warcraft: Wrath of the Lich King	World of Warcraft: Wrath of the Lich King
Ambihtlicu Cīnisc sprǣc	Mandarín estándar
Leþ Hæfen	Puerto Leith
Falster	Falster
Janus (Windows beta)	Windows 3.x
Ealdfriþ	Aldfrith
Difelinburg	Castillo de Dublín
SOX leoht-fæt	Lámpara de vapor de sodio
Madrynhȳð	Puerto Madryn
Wuduhen	Gallirallus australis
Gawain and se Grēna Cniht	Sir Gawain y el Caballero Verde
Maroare	Moravos
Centro Federal de Educação Tecnológica Celso Suckow da Fonseca	Centro Federal de Educação Tecnológica Celso Suckow da Fonseca
Chrono Trigger	Chrono Trigger
Antônio Fagundes	Antônio Fagundes
Télépopmusik	Télépopmusik
Selfrīcsiendlica landbūnessa	Región autónoma
Getæl dēora swēga	Anexo:Nombre de los sonidos de los animales
Berewicscīr	Berwickshire
Axanmynster	Axminster
Ægelesþrep	Aylesford
Lex Acilia Calpurnia	Ley Acilia Calpurnia
Bloomesdæg	Bloomsday
Barca	Barca (Libia)
Bellingshausenīeg	Isla de Bellingshausen
Rīdungfȳrramm	Torpedo humano
Wedrebi	Wetherby
Adreminte	Tanacetum parthenium
Stæfford	Stafford
Almarza	Almarza
Aldealices	Aldealices
Aldealafuente	Aldealafuente
Alentisque	Alentisque
Adradas	Adradas
Alconaba	Alconaba
Abejar	Abejar
Almajano	Almajano
Arenillas	Arenillas
Aldealpozo	Aldealpozo
Alcubilla de las Peñas	Alcubilla de las Peñas
Aldealseñor	Aldealseñor
Alcubilla de Avellaneda	Alcubilla de Avellaneda
Covaleda	Covaleda
Casarejos	Casarejos
Cerbón	Cerbón
Calatañazor	Calatañazor
Almazul	Almazul
Cidones	Cidones
Besliwdifca	Bezliúdivka
Alpanseque	Alpanseque
Arcos de Jalón	Arcos de Jalón
Aldehuela de Periáñez	Aldehuela de Periáñez
Beratón	Beratón
Almenar de Soria	Almenar de Soria
Maján	Maján
Coscurita	Coscurita
Barcones	Barcones
Castilfrío de la Sierra	Castilfrío de la Sierra
Castilruiz	Castilruiz
Miño de Medinaceli	Miño de Medinaceli
Vinuesa	Vinuesa
Cigudosa	Cigudosa
Candilichera	Candilichera
Ausejo de la Sierra	Ausejo de la Sierra
Carabantes	Carabantes
Soliedra	Soliedra
Taroda	Taroda
Nepas	Nepas
Valtajeros	Valtajeros
Arévalo de la Sierra	Arévalo de la Sierra
Pozalmuro	Pozalmuro
Cabrejas del Pinar	Cabrejas del Pinar
Villasayas	Villasayas
Cubilla	Cubilla
Castillejo de Robledo	Castillejo de Robledo
Escobosa de Almazán	Escobosa de Almazán
Estepa de San Juan	Estepa de San Juan
Carrascosa de la Sierra	Carrascosa de la Sierra
Las Aldehuelas	Las Aldehuelas
Bayubas de Arriba	Bayubas de Arriba
Borobia	Borobia
Bliecos	Bliecos
Buberos	Buberos
Muriel Viejo	Muriel Viejo
Oncala	Oncala
Fuentecambrón	Fuentecambrón
Cabrejas del Campo	Cabrejas del Campo
Frechilla de Almazán	Frechilla de Almazán
Ergo Proxy	Ergo Proxy
Valdelagua del Cerro	Valdelagua del Cerro
Ciria	Ciria
Buitrago	Buitrago
Talveila	Talveila
Salduero	Salduero
Fuentes de Magaña	Fuentes de Magaña
Viana de Duero	Viana de Duero
Tardelcuende	Tardelcuende
Duruelo de la Sierra	Duruelo de la Sierra
Bayubas de Abajo	Bayubas de Abajo
Fuentearmegil	Fuentearmegil
Fuentelmonge	Fuentelmonge
Rollamienta	Rollamienta
Villar del Ala	Villar del Ala
Velilla de los Ajos	Velilla de los Ajos
Momblona	Momblona
Fresno de Caracena	Fresno de Caracena
Valdegeña	Valdegeña
Velamazán	Velamazán
Torlengua	Torlengua
Fuentecantos	Fuentecantos
Carrascosa de Abajo	Carrascosa de Abajo
Pinilla del Campo	Pinilla del Campo
Serón de Nágima	Serón de Nágima
Blacos	Blacos
Valdeavellano de Tera	Valdeavellano de Tera
Narros	Narros
Valdeprado	Valdeprado (Soria)
Borjabad	Borjabad
Fuentelsaz de Soria	Fuentelsaz de Soria
San Leonardo de Yagüe	San Leonardo de Yagüe
Muriel de la Fuente	Muriel de la Fuente
Villar del Río	Villar del Río
Valderrodilla	Valderrodilla
Espejón	Espejón
Liceras	Liceras
Matalebreras	Matalebreras
Quintana Redonda	Quintana Redonda
Nafría de Ucero	Nafría de Ucero
Sotillo del Rincón	Sotillo del Rincón
Torrubia de Soria	Torrubia de Soria
Noviercas	Noviercas
Tajueco	Tajueco
Valdenebro	Valdenebro
Villaciervos	Villaciervos
Villanueva de Gormaz	Villanueva de Gormaz
Yelo	Yelo
Montenegro de Cameros	Montenegro de Cameros
Ucero	Ucero
Langa de Duero	Langa de Duero
Quiñonería	Quiñonería
Villar del Campo	Villar del Campo
Portillo de Soria	Portillo de Soria
Gormaz	Gormaz
Santa Cruz de Yanguas	Santa Cruz de Yanguas
Villaseca de Arciel	Villaseca de Arciel
Reznos	Reznos
Cueva de Ágreda	Cueva de Ágreda
Nolay	Nolay
Cirujales del Río	Cirujales del Río
Caracena	Caracena
Cubo de la Solana	Cubo de la Solana
Miño de San Esteban	Miño de San Esteban
Fuentestrún	Fuentestrún
Espeja de San Marcelino	Espeja de San Marcelino
Matamala de Almazán	Matamala de Almazán
La Póveda de Soria	La Póveda de Soria
Los Rábanos	Los Rábanos
Quintanas de Gormaz	Quintanas de Gormaz
Santa María de Huerta	Santa María de Huerta
San Pedro Manrique	San Pedro Manrique
Velilla de la Sierra	Velilla de la Sierra
Valdemaluque	Valdemaluque
San Felices	San Felices (Soria)
Renieblas	Renieblas
Morón de Almazán	Morón de Almazán
Los Villares de Soria	Los Villares de Soria
Torreblacos	Torreblacos
Vizmanos	Vizmanos
Tejado	Tejado (Soria)
Retortillo de Soria	Retortillo de Soria
Herrera de Soria	Herrera de Soria
Deza	Deza (Soria)
Monteagudo de las Vicarías	Monteagudo de las Vicarías
La Riba de Escalote	La Riba de Escalote
Montejo de Tiermes	Montejo de Tiermes
La Losilla	La Losilla
Recuerda	Recuerda (Soria)
Tajahuerce	Tajahuerce
Santa María de las Hoyas	Santa María de las Hoyas
Fuentepinilla	Fuentepinilla
Golmayo	Golmayo
Rioseco de Soria	Rioseco de Soria
Gómara	Gómara
Stromnæs	Stromness (Escocia)
Hwǣlbordfarung	Skateboarding
Rōmānisc Cāsere	Emperador romano
Weogornaceasterscīrsēaw	Salsa Worcestershire
Picilemwes eorþbeofung 2010 gēares	Terremoto de Pichilemu de 2010
Maybach Exelero	Maybach Exelero
Īslendisc frēona rīcisc fōtþōðerhēap	Selección femenina de fútbol de Islandia
Worulde Fanan	Flags of the World
Dēaðas in 2005. gēare	Anexo:Fallecidos en 2005
York University	Universidad de York
Cirenceaster	Cirencester
Strēoneshalh	Whitby
Skræling	Skræling
Grēnelandes Norren sprǣc	Nórdico groenlandés
BloodRayne 2	BloodRayne 2
Brytenwealda	Bretwalda
Glamorgan	Glamorganshire
Sǣearmlandes Rīcisc Edisc	Parque nacional de Fiordland
Port Authority of New York and New Jersey	Autoridad Portuaria de Nueva York y Nueva Jersey
Getalu īega be landware	Anexo:Islas por población
Cwatbrycg	Bridgnorth
Street Fighter IV	Street Fighter IV
Help:Innoþ	Ayuda:Contenidos
Wikipǣdia:Tutorial	Ayuda:Tutorial
Wīntrēow	Planta de guía
Brycgstōwīeg	Isla Blanca (Sandwich del Sur)
Witch Hunter Robin	Witch Hunter Robin
Twilight of the Thunder God	Twilight of the Thunder God
Pontifícia Universidade Católica de Minas Gerais	Pontifícia Universidade Católica de Minas Gerais
Smallville (Gēar 5)	Anexo:Quinta temporada de Smallville
Deorwente	Río Derwent (Derbyshire)
Universidad de los Andes (Cile)	Universidad de los Andes (Chile)
Oenoīeg	Oeno
3 World Trade Center	Three World Trade Center
Granta	Río Cam
Los Angeles Sol	Los Angeles Sol
Rūnstæfisc gerīmbōc	Calendario rúnico
Waneting	Wantage
Hrodulf se rēadnosoda hrāndēor	Rodolfo el reno
Murilo Rosa	Murilo Rosa
Molinos de Duero	Molinos de Duero
Vozmediano	Vozmediano
Hinojosa del Campo	Hinojosa del Campo
Elpendīeg	Isla Elefante
Faroisce cwidas	Kvaedi
Elenesburh	Helensburgh
Sūþern Strēamflēot	Kangerlussuaq
Tottaness	Totnes
Burns Niht	Noche de Burns
Vrahovice	Vrahovice
Walhshalh Weald	Walsall Wood
Gēatland	Isla de Gotland
Būc	Estómago
Candelmæssanīeg	Isla Candelaria
Loppestre	Nephropidae
Rello	Rello
Nīwes Sǣlandes Weorces Stēormǣlhēap	Partido Laborista de Nueva Zelanda
Rebollar	Rebollar (Soria)
Unicron	Unicron
Garray	Garray
Stēamwægn	Automóvil de vapor
Simeon II Pulgara Cyning	Simeón de Bulgaria
Lopphāma	Weta
Heortæppelbroþ	Sopa de tomate
Chicago Red Stars	Chicago Red Stars
Cutey Honey	Cutie Honey
Besancurt	Bézancourt
Clarenceīeg, Sūþhjaltland	Isla Clarence (Antártida)
Umm Culþþūm	Umm Kalzum
Tenercebrai	Tinchebray
2 World Trade Center	Two World Trade Center
Cōcīeg (þāra Sūþsandwic Īeglanda)	Isla Cook
Cooperīeg	Isla Cooper
Universidade Tecnológica Federal do Paraná	Universidad Tecnológica Federal de Paraná
Stæffordscīr hord	Terry Herbert
Gemyndigung Twintorra	National September 11 Memorial & Museum
Swamphæn	Porphyrio
Froggmann	Buzo militar
Beadu Omdurmanes	Batalla de Omdurmán
Crumbaþynscīr	Cromartyshire
Ƿ	Wynn
Ninus	Nino
Lundene Foreweard (1839.)	Tratado de Londres (1839)
Hellraiser	Hellraiser (película)
Æsir–Vanir þurhgefeht	Guerra entre los Æsir y los Vanir
Elisabeþ Cwēn Land	Tierra de la Reina Isabel
Teach Children to Worship Satan	Teach Children To Worship Satan
Wikipǣdia:Ambihtsecghof	Wikipedia:Embajadas
Sēo Rād tō Wiganshwearfe	El camino a Wigan Pier
National Hockey League	National Hockey League
Seleciricescīr	Selkirkshire
Perþscīr	Perthshire
Flyhthæfen	Aeropuerto
Drēag	Draugr
Universidad de Santiago de Chile	Universidad de Santiago de Chile
Egilseg	Egilsay
Leskovīeg	Isla Leskov
Major Antônio Couto Pereira Stadium	Estadio Couto Pereira
Nīwes Sǣlandes Grēne Stēormǣlhēap	Partido Verde de Aotearoa
Stǣrlice gemynddagas	Anexo:Calendario de aniversarios
Pecland	Parque nacional del Distrito de los Picos
Uzumaki	Uzumaki (manga)
4 World Trade Center	Four World Trade Center
KMFDM	KMFDM
Women's Professional Soccer	Women's Professional Soccer
Sǣweardþrēat	Guardia costera
Agnes Monica	Agnes Mónica
Montaguīeg	Isla Jorge (Sándwich del Sur)
Wīdsīð	Widsith
Evile	Evile
Pasquier Quesnel	Pascasio Quesnel
Eoh	Ēoh
Feoh (rūnstæf)	Fehu
Flocc:Ƿeras	Categoría:Hombre
Flocc:Þēodscland	Categoría:Alemania
Flocc:Italia	Categoría:Italia
Flocc:Geānedu Rīcu American	Categoría:Estados Unidos
Flocc:Russland	Categoría:Rusia
Flocc:Canada	Categoría:Canadá
Flocc:Geānede Cynerīce	Categoría:Reino Unido
Flocc:Spēonland	Categoría:España
Flocc:Cīna	Categoría:China
Flocc:Iapan	Categoría:Japón
Flocc:Australia	Categoría:Australia
Flocc:Mexico	Categoría:México
Flocc:Indea	Categoría:India
Flocc:Saudisc Arabea	Categoría:Arabia Saudita
Flocc:Israhēl	Categoría:Israel
Flocc:Turcland	Categoría:Turquía
Flocc:Sūðaffrica	Categoría:Sudáfrica
Flocc:Ǣgypt	Categoría:Egipto
Flocc:Persealand	Categoría:Irán
Flocc:Nīwe Sǣland	Categoría:Nueva Zelanda
Flocc:Argentina	Categoría:Argentina
Traversayīega	Archipiélago Marqués de Traverse
Wergyld	Wergeld
Siebenbürgen	Siebenbürgen
Flocc:Afghanistan	Categoría:Afganistán
Flocc:Algeria	Categoría:Argelia
Flocc:Ēastrīce	Categoría:Austria
Flocc:Bangladesc	Categoría:Bangladés
Flocc:Cūba	Categoría:Cuba
Flocc:Sigelhearwenaland	Categoría:Etiopía
Flocc:Indonesia	Categoría:Indonesia
Flocc:Irac	Categoría:Irak
Flocc:Niðerland	Categoría:Países Bajos
Flocc:Nigeria	Categoría:Nigeria
Flocc:Pacistan	Categoría:Pakistán
Flocc:Pōlaland	Categoría:Polonia
Flocc:Portugal	Categoría:Portugal
Flocc:Sudan	Categoría:Sudán
Flocc:Tansania	Categoría:Tanzania
Flocc:Ucrægna	Categoría:Ucrania
Flocc:Fietnam	Categoría:Vietnam
Flocc:Rōmānisc Cāsere	Categoría:Imperio romano
Flocc:Sycedēor	Categoría:Mammalia
Flocc:Fugolas	Categoría:Aves
Flocc:Plantan	Categoría:Plantae
Flocc:Stǣr	Categoría:Historia
Flocc:Ferscipe	Categoría:Sociedad
Flocc:Gelēafan	Categoría:Religión
Flocc:Plegan	Categoría:Deporte
Flocc:Sprǣc	Categoría:Lenguaje
Flocc:Eorþ	Categoría:Tierra
Victor Iusccenco	Víktor Yúshchenko
Slowly We Rot	Slowly We Rot
Surtur Rising	Surtur Rising
Thila-īeg	Isla Thule
Gealdor	Galdr
Saint Louis Athletica	Saint Louis Athletica
Palmerland	Tierra de Palmer
Pagetbeorg	Monte Paget
World Trade Center 5 Torr	5 World Trade Center
Hedingelei	Headingley
Hocig	Hockey
Frēodōm	Freedom
Īsensmiþ	Herrero
Visokoi-īeg	Isla Visokoi
Willisīega	Islas Willis
Wiogoraceastre	Worcester (Worcestershire)
Abbodesse	Abadesa
Ganet	Morus (animal)
Geondrīciscra laga fōtþōðer	Fútbol de reglas internacionales
Mōr	Turbera
Pickersgillīega	Islas Pickersgill
Três Pontas	Três Pontas
Swǣfisc cnotta	Nudo suevo
Saundersīeg	Isla Saunders (Sandwich del Sur)
Ānlāfes Æþelinges Hæfen	Puerto del Principe Olav
Universidad del Desarrollo	Universidad del Desarrollo
Kupriyanovīega	Islas Kupriyanov
Eormengyld Finis Terrae	Universidad Finis Terrae
Loch a' Choire	Tarn (lago)
Smith & Wesson 500	S&W Modelo 500
Apulder on Cente	Appledore (Kent)
Richard Pearse	Richard Pearse
Philadelphia Independence	Philadelphia Independence
Flocc:Scīrung	Categoría:Wikipedia:Desambiguación
Flocc:Olympisc Gamen	Categoría:Juegos Olímpicos
Flocc:Crīstendōm	Categoría:Cristianismo
Flocc:Alladōm	Categoría:Islam
Ieldra Fuþark	Futhark antiguo
Beorgford	Burford
Decatur	Decatur
Wilcumanīega	Islas Bienvenido (Georgias del Sur)
Ammomanes	Ammomanes
Earn	Águila
Bresl/ᚱᚢᚾ	Kringle
Scyrte	Falda
Abercurnig	Abercorn
Occidental (California)	Occidental (California)
Smallville	Smallville
Elpend	Elephantidae
Elworuldontygenes	Altermundialismo
Bochotnica	Bochotnica
Anna Hutchison	Anna Hutchison
Universidade do Estado de Minas Gerais	Universidade do Estado de Minas Gerais
Grantasæte	Grantchester
Adesa	Azuela
Cūlingon	Cooling
Mancus	Mancuso (moneda)
Āhyrstod cȳse	Sándwich de queso
Sceota	Salmo trutta
Camila Morgado	Camila Morgado
Flocc:Sidaþing	Categoría:Cultura
Flocc:Gēar	Categoría:Años
Flocc:Worulddǣl	Categoría:Continentes
Flocc:Lyftcræftas	Categoría:Aeronaves
Gealdorstæf	Símbolos mágicos de Islandia
Wikipǣdia:Gecorene gemynddagas	Wikipedia:Efemérides
Wikipǣdia:Tutorial (Editing)	Ayuda:Tutorial (edición)
Bysen:Stēorungsunnanendebyrdnes	Plantilla:Sistema Solar
Smiþþfeld, Lunden	Smithfield (Londres)
Wikipǣdia:Nīwe ēacan	Wikipedia:¿Sabías que...
Wikipǣdia:Wikibōceras	Wikipedia:Wikipedistas
Scearseax	Maquinilla de afeitar
Wikipǣdia:Snell bīcniend	Wikipedia:Índice alfabético
Wikipǣdia:Recentchanges	Ayuda:Cambios recientes
Morgenmearh	Salchicha de desayuno
Basu	Púrpura
Yfelland Ƿeard	Badlands Guardian
Æðelinga īg	Athelney
Estadio La Barranquita	Estadio La Barranquita
Flocc:Flēogeball	Categoría:Voleibol
Flocc:Wikipedia bots	Categoría:Wikipedia:Bots
Ened	Pato
Bysen:Cquote	Plantilla:Cita
Flocc:Þēodisc	Categoría:Alemanes
Eormengyld ''Guglielmo Marconi''	Università degli Studi @@@u0026Guglielmo Marconi"
Flocc:Land	Categoría:Países
Catherine	Catherine
Wikipǣdia:Bewitendas	Wikipedia:Bibliotecarios
Flocc:Lēode	Categoría:Personas
Wikipǣdia:Bēna tō and fram bewitendhāde	Wikipedia:Candidaturas a bibliotecario
Flocc:Tīd	Categoría:Tiempo
Flocc:Bodiȝlār	Categoría:Anatomía
Wikipǣdia:Betwuxsprǽclice bendas	Ayuda:Enlace interlingüístico
Flocc:Leornung	Categoría:Educación
Cyningesbeorg	Königsberg
Ægypt	Egipto
Yulia Lipnitskaya	Yúliya Lipnítskaya
Flocc:Ūtwitan	Categoría:Filósofos
Bysen:Bot	Plantilla:Bot
Wikipǣdia:Hwæt Wikipǣdia Nis	Wikipedia:Lo que Wikipedia no es
Canada	Canadá
Flocc:Ungerland	Categoría:Hungría
Flocc:Belgice	Categoría:Bélgica
Flocc:Cipros	Categoría:Chipre
Flocc:Cecland	Categoría:República Checa
Flocc:Denemearc	Categoría:Dinamarca
Flocc:Estland	Categoría:Estonia
Flocc:Finnland	Categoría:Finlandia
Flocc:Crecaland	Categoría:Grecia
Flocc:Lettland	Categoría:Letonia
Flocc:Īsland	Categoría:Islandia
Flocc:Letseburg	Categoría:Luxemburgo
Flocc:Liþuania	Categoría:Lituania
Flocc:Melita	Categoría:Malta
Flocc:Swēoland	Categoría:Suecia
Flocc:Slofacia	Categoría:Eslovaquia
Flocc:Īrland Cynewīse	Categoría:Irlanda
Flocc:Fulgōd ȝeƿritu	Categoría:Wikipedia:Artículos destacados
Flocc:Spærcletelle gamen	Categoría:Videojuegos
Heofon	Cielo (religión)
Flocc:Microsoft	Categoría:Microsoft
Bysen:Flagicon	Plantilla:Bandera
Flocc:Land on Europan	Categoría:Países de Europa
Flocc:Europe	Categoría:Europa
Flocc:Wikipedia:Help	Categoría:Ayuda
Help:Mōtungtramet	Wikipedia:Convenciones sobre páginas de discusión
Wikipǣdia:Efenealde belimpas	Portal:Actualidad
Bysen:Documentation	Plantilla:Documentación
Wikipǣdia:Protected pages	Wikipedia:Política de protección
Flocc:Wikibōceras	Categoría:Wikipedia:Wikipedistas
Wikipǣdia:Gemǣnscipes Ingang	Portal:Comunidad
Flocc:Brūcendsprǣc	Categoría:Wikipedia:Wikipedistas por idioma
Wikipǣdia:Fīf styde	Wikipedia:Los cinco pilares
Wikipǣdia:Ānsund styccegewrit	Wikipedia:Esbozo
Wikipǣdia:Bealu	Wikipedia:Vandalismo
Sung Jae-ki	Sung Jae-ki
Sundorrīcesdæg	Anexo:Día de la Independencia
Instituto Federal da Bahia	Instituto Federal da Bahia
Bysen:Softredirect	Plantilla:Redirección suave
Bysen:Delete	Plantilla:Destruir
Snægel	Gastropoda
Bryttisce Wealdendas	Anexo:Monarcas británicos
Flocc:Searucræft	Categoría:Tecnología
Flocc:Sprǣca	Categoría:Lenguas
Flocc:Gerīmbōc	Categoría:Calendarios
Flocc:Hāliȝdagas	Categoría:Días festivos
Help:Onbregdan nīwne tramet	Ayuda:Cómo empezar una página
Flocc:Wikipǣdia	Categoría:Wikipedia
Flocc:Unȝebēacniende trametas	Categoría:Wikipedia:Páginas no indexadas
Flocc:Pages with broken file links	Categoría:Wikipedia:Páginas con enlaces rotos a archivos
Wikipǣdia:Manual of Style	Wikipedia:Manual de estilo
Bysen:-	Plantilla:--
Bysen:Navbox	Plantilla:Navegación
Handspearctellend	Dispositivo móvil
Flocc:Byrig on Persum	Categoría:Localidades de Irán
Ēadweard Cyning Cofa	Caleta Vago
Éire	Éire
Bysen:Sēðung þurfed	Plantilla:Cita requerida
Bysen:!	Plantilla:!
Flocc:Fana bysen	Categoría:Wikipedia:Plantillas de banderas
Bysen:((	Plantilla:((
Bysen:!-	Plantilla:!-
Bysen:!!	Plantilla:!!
Bysen:=	Plantilla:=
Bysen:Navbar	Plantilla:Navbar
Bysen:Unicode	Plantilla:Unicode
Bysen:E	Plantilla:E
Bysen:Clear	Plantilla:Clear
Bysen:Color	Plantilla:Color
Bysen:Anchor	Plantilla:Ancla
Wikipǣdia:List of articles all languages should have	Wikipedia:Lista de artículos que toda Wikipedia debería tener
Flocc:Affrica	Categoría:África
Flocc:Mǣdmōnaþ	Categoría:Julio
Flocc:Þorpas	Categoría:Localidades rurales
Flocc:Bēc	Categoría:Libros
Flocc:Mōnþas	Categoría:Meses
Bysen:Wikisource	Plantilla:Wikisource
Bysen:Babel	Plantilla:Babel
Bysen:Commons	Plantilla:Commons
Bysen:Link GA	Plantilla:Bueno
Bysen:Reflist	Plantilla:Listaref
Bysen:NavPeriodicTable	Plantilla:Ficha de elemento químico/minitabla periódica
Wikipǣdia:Fulgōdra gewrita hwætgōdnesse	Wikipedia:Qué es un artículo destacado
Bysen:Stycce	Plantilla:Esbozo
Flocc:Līf	Categoría:Vida
Cosco	Cuzco
Flocc:Solmōnaþ	Categoría:Febrero
Flocc:1949	Categoría:1949
Bysen:Stedefindend scite/Writ	Plantilla:Mapa de localización/Info
Flocc:Ceorfdēor	Categoría:Insecta
Flocc:Asia	Categoría:Asia
Flocc:Cile	Categoría:Chile
Flocc:21e gēarhundred	Categoría:Siglo XXI
Flocc:Lesotho	Categoría:Lesoto
Flocc:Brūcend uk	Categoría:Wikipedia:Wikipedistas con conocimientos de ucraniano
Flocc:Sūðamerica	Categoría:América del Sur
Flocc:Brūcend uk-M	Categoría:Wikipedia:Wikipedistas con nivel nativo de ucraniano
Flocc:1918	Categoría:1918
Flocc:1954	Categoría:1954
Flocc:Ǣt	Categoría:Alimentos
Flocc:1946	Categoría:1946
Bysen:Fs player	Plantilla:Jugador de fútbol
Flocc:Gyldfōtþōðer	Categoría:Fútbol
Flocc:1945	Categoría:1945
Flocc:1926	Categoría:1926
Bysen:NowCommons	Plantilla:EnCommons
Flocc:1920	Categoría:1920
Bysen:Infobox Football club	Plantilla:Ficha de equipo de fútbol
Flocc:Bysen mid ūtweardum hlence	Categoría:Wikipedia:Plantillas de enlaces externos
Bysen:Country data Slovakia	Plantilla:Geodatos Eslovaquia
Bysen:Country flagnavy	Plantilla:Banderanavalpaís
Bysen:Country data Czech Republic	Plantilla:Geodatos República Checa
Bysen:Country data Honduras	Plantilla:Geodatos Honduras
Bysen:Country data Bolivia	Plantilla:Geodatos Bolivia
Bysen:Country data Denemearc	Plantilla:Geodatos Dinamarca
Bysen:Country data Īsland	Plantilla:Geodatos Islandia
Bysen:Country data Poland	Plantilla:Geodatos Polonia
Flocc:Brūcend fr-1	Categoría:Wikipedia:Wikipedistas con nivel básico de francés
Bysen:Country data Norway	Plantilla:Geodatos Noruega
Bysen:Wikiquote	Plantilla:Wikiquote
Bysen:Country showdata	Plantilla:Mostrar geodatos
Bysen:Country data Mexico	Plantilla:Geodatos México
Bysen:Infobox television	Plantilla:Ficha de serie de televisión
Flocc:Americisc Awendung Wig	Categoría:Independencia de Estados Unidos
Bysen:IUCN2008	Plantilla:IUCN2008
Bysen:Country data Australia	Plantilla:Geodatos Australia
Bysen:Cyþþubox ieg	Plantilla:Ficha de isla
Bysen:Country data France	Plantilla:Geodatos Francia
Bysen:Ambox	Plantilla:Metaplantilla de avisos
Flocc:Americanisc stǣr	Categoría:Historia de Estados Unidos
Bysen:Fossil range/bar	Plantilla:Rango fósil/barra
Bysen:Infobox Country	Plantilla:Ficha de país
Bysen:Max	Plantilla:Max
Bysen:Country data Austria	Plantilla:Geodatos Austria
Bysen:Infobox Mīlitisc Gemōt	Plantilla:Ficha de conflicto
Bysen:Country data Finland	Plantilla:Geodatos Finlandia
Wikipǣdia:Tutorial (Wikipedia links)	Ayuda:Tutorial (enlaces internos)
Bysen:Country data Japan	Plantilla:Geodatos Japón
Bysen:Start box	Plantilla:S-inicio
Flocc:Crabbas	Categoría:Brachyura
Bysen:Cite journal	Plantilla:Cita publicación
Bysen:Lang-ar	Plantilla:Lang-ar
Bysen:Cite news	Plantilla:Cita noticia
Bysen:Featured article	Plantilla:Artículo destacado
Bysen:Country data Russia	Plantilla:Geodatos Rusia
Flocc:Paris	Categoría:París
Flocc:Brūcend en-4	Categoría:Wikipedia:Wikipedistas con nivel experto de inglés
Flocc:Brūcend en	Categoría:Wikipedia:Wikipedistas con conocimientos de inglés
Flocc:Croatia	Categoría:Croacia
Flocc:Brūcend en-2	Categoría:Wikipedia:Wikipedistas con nivel intermedio de inglés
Bysen:Infobox	Plantilla:Ficha
Bysen:Main other	Plantilla:Main other
Flocc:Francena cyningas	Categoría:Reyes de Francia
Flocc:Stafas	Categoría:Alfabeto
Wikipǣdia:Gecorene gemynddagas/23 Hāligmōnaþ	Plantilla:Efemérides - 23 de septiembre
Wikipǣdia:Gecorene gemynddagas/4 Solmōnaþ	Plantilla:Efemérides - 4 de febrero
Wikipǣdia:Gecorene gemynddagas/22 Hāligmōnaþ	Plantilla:Efemérides - 22 de septiembre
Bysen:Lang-da	Plantilla:Lang-da
Wikipǣdia:Gecorene gemynddagas/30 Blōtmōnaþ	Plantilla:Efemérides - 30 de noviembre
Wikipǣdia:Gecorene gemynddagas/18 Solmōnaþ	Plantilla:Efemérides - 18 de febrero
Wikipǣdia:Gecorene gemynddagas/28 Æfterra Gēola	Plantilla:Efemérides - 28 de enero
Bysen:Legend	Plantilla:Leyenda
Wikipǣdia:Gecorene gemynddagas/14 Æfterra Gēola	Plantilla:Efemérides - 14 de enero
Wikipǣdia:Gecorene gemynddagas/25 Solmōnaþ	Plantilla:Efemérides - 25 de febrero
Wikipǣdia:Gecorene gemynddagas/10 Wēodmōnaþ	Plantilla:Efemérides - 10 de agosto
Flocc:Bryttisce wrīteras	Categoría:Escritores del Reino Unido
Wikipǣdia:Gecorene gemynddagas/15 Winterfylleþ	Plantilla:Efemérides - 15 de octubre
Wikipǣdia:Gecorene gemynddagas/31 Wēodmōnaþ	Plantilla:Efemérides - 31 de agosto
Wikipǣdia:Gecorene gemynddagas/12 Blōtmōnaþ	Plantilla:Efemérides - 12 de noviembre
Wikipǣdia:Gecorene gemynddagas/30 Mǣdmōnaþ	Plantilla:Efemérides - 30 de julio
Wikipǣdia:Gecorene gemynddagas/3 Wēodmōnaþ	Plantilla:Efemérides - 3 de agosto
Wikipǣdia:Gecorene gemynddagas/27 Wēodmōnaþ	Plantilla:Efemérides - 27 de agosto
Bysen:Cite web	Plantilla:Cita web
Wikipǣdia:Gecorene gemynddagas/21 Æfterra Gēola	Plantilla:Efemérides - 21 de enero
Wikipǣdia:Gecorene gemynddagas/8 Solmōnaþ	Plantilla:Efemérides - 8 de febrero
Bysen:Country data Italy	Plantilla:Geodatos Italia
Wikipǣdia:Gecorene gemynddagas/20 Æfterra Gēola	Plantilla:Efemérides - 20 de enero
Wikipǣdia:Gecorene gemynddagas/23 Æfterra Gēola	Plantilla:Efemérides - 23 de enero
Wikipǣdia:Gecorene gemynddagas/28 Hāligmōnaþ	Plantilla:Efemérides - 28 de septiembre
Bysen:Imdb title	Plantilla:IMDb título
Wikipǣdia:Gecorene gemynddagas/31 Gēolmōnaþ	Plantilla:Efemérides - 31 de diciembre
Wikipǣdia:Gecorene gemynddagas/1 Solmōnaþ	Plantilla:Efemérides - 1 de febrero
Wikipǣdia:Gecorene gemynddagas/14 Gēolmōnaþ	Plantilla:Efemérides - 14 de diciembre
Wikipǣdia:Gecorene gemynddagas/25 Æfterra Gēola	Plantilla:Efemérides - 25 de enero
Wikipǣdia:Gecorene gemynddagas/6 Wēodmōnaþ	Plantilla:Efemérides - 6 de agosto
Wikipǣdia:Gecorene gemynddagas/24 Wēodmōnaþ	Plantilla:Efemérides - 24 de agosto
Wikipǣdia:Gecorene gemynddagas/9 Blōtmōnaþ	Plantilla:Efemérides - 9 de noviembre
Wikipǣdia:Gecorene gemynddagas/18 Æfterra Gēola	Plantilla:Efemérides - 18 de enero
Wikipǣdia:Gecorene gemynddagas/17 Wēodmōnaþ	Plantilla:Efemérides - 17 de agosto
Wikipǣdia:Gecorene gemynddagas/27 Mǣdmōnaþ	Plantilla:Efemérides - 27 de julio
Bysen:Country data	Plantilla:Geodatos
Wikipǣdia:Gecorene gemynddagas/20 Wēodmōnaþ	Plantilla:Efemérides - 20 de agosto
Wikipǣdia:Gecorene gemynddagas/1 Winterfylleþ	Plantilla:Efemérides - 1 de octubre
Wikipǣdia:Gecorene gemynddagas/5 Winterfylleþ	Plantilla:Efemérides - 5 de octubre
Wikipǣdia:Gecorene gemynddagas/8 Winterfylleþ	Plantilla:Efemérides - 8 de octubre
Wikipǣdia:Gecorene gemynddagas/15 Solmōnaþ	Plantilla:Efemérides - 15 de febrero
Bysen:Coor URL	Plantilla:Coor URL
Bysen:·	Plantilla:,
Bysen:Min	Plantilla:Min
Bysen:Wiktionarypar2	Plantilla:Wikcionario
Bysen:Country data Sweden	Plantilla:Geodatos Suecia
Flocc:Byrig on Dēnum	Categoría:Localidades de Dinamarca
Flocc:Eorþtilþ	Categoría:Agricultura
Wikipǣdia:Gecorene gemynddagas/26 Blōtmōnaþ	Plantilla:Efemérides - 26 de noviembre
Wikipǣdia:Gecorene gemynddagas/26 Wēodmōnaþ	Plantilla:Efemérides - 26 de agosto
Wikipǣdia:Gecorene gemynddagas/12 Gēolmōnaþ	Plantilla:Efemérides - 12 de diciembre
Wikipǣdia:Gecorene gemynddagas/25 Gēolmōnaþ	Plantilla:Efemérides - 25 de diciembre
Wikipǣdia:Gecorene gemynddagas/10 Æfterra Gēola	Plantilla:Efemérides - 10 de enero
Wikipǣdia:Gecorene gemynddagas/31 Æfterra Gēola	Plantilla:Efemérides - 31 de enero
Wikipǣdia:Gecorene gemynddagas/6 Winterfylleþ	Plantilla:Efemérides - 6 de octubre
Wikipǣdia:Gecorene gemynddagas/6 Hrēþmōnaþ	Plantilla:Efemérides - 6 de marzo
Wikipǣdia:Gecorene gemynddagas/18 Hrēþmōnaþ	Plantilla:Efemérides - 18 de marzo
Wikipǣdia:Gecorene gemynddagas/17 Winterfylleþ	Plantilla:Efemérides - 17 de octubre
Wikipǣdia:Gecorene gemynddagas/27 Hrēþmōnaþ	Plantilla:Efemérides - 27 de marzo
Wikipǣdia:Gecorene gemynddagas/19 Hrēþmōnaþ	Plantilla:Efemérides - 19 de marzo
Wikipǣdia:Gecorene gemynddagas/2 Winterfylleþ	Plantilla:Efemérides - 2 de octubre
Wikipǣdia:Gecorene gemynddagas/2 Mǣdmōnaþ	Plantilla:Efemérides - 2 de julio
Wikipǣdia:Gecorene gemynddagas/10 Hrēþmōnaþ	Plantilla:Efemérides - 10 de marzo
Wikipǣdia:Gecorene gemynddagas/1 Ēastermōnaþ	Plantilla:Efemérides - 1 de abril
Wikipǣdia:Gecorene gemynddagas/31 Mǣdmōnaþ	Plantilla:Efemérides - 31 de julio
Wikipǣdia:Gecorene gemynddagas/12 Wēodmōnaþ	Plantilla:Efemérides - 12 de agosto
Wikipǣdia:Gecorene gemynddagas/26 Solmōnaþ	Plantilla:Efemérides - 26 de febrero
Wikipǣdia:Gecorene gemynddagas/17 Mǣdmōnaþ	Plantilla:Efemérides - 17 de julio
Wikipǣdia:Gecorene gemynddagas/5 Wēodmōnaþ	Plantilla:Efemérides - 5 de agosto
Wikipǣdia:Gecorene gemynddagas/16 Hāligmōnaþ	Plantilla:Efemérides - 16 de septiembre
Wikipǣdia:Gecorene gemynddagas/31 Winterfylleþ	Plantilla:Efemérides - 31 de octubre
Wikipǣdia:Gecorene gemynddagas/12 Solmōnaþ	Plantilla:Efemérides - 12 de febrero
Wikipǣdia:Gecorene gemynddagas/15 Æfterra Gēola	Plantilla:Efemérides - 15 de enero
Wikipǣdia:Gecorene gemynddagas/19 Hāligmōnaþ	Plantilla:Efemérides - 19 de septiembre
Wikipǣdia:Gecorene gemynddagas/16 Æfterra Gēola	Plantilla:Efemérides - 16 de enero
Wikipǣdia:Gecorene gemynddagas/13 Mǣdmōnaþ	Plantilla:Efemérides - 13 de julio
Wikipǣdia:Gecorene gemynddagas/2 Æfterra Gēola	Plantilla:Efemérides - 2 de enero
Wikipǣdia:Gecorene gemynddagas/9 Mǣdmōnaþ	Plantilla:Efemérides - 9 de julio
Wikipǣdia:Gecorene gemynddagas/10 Solmōnaþ	Plantilla:Efemérides - 10 de febrero
Wikipǣdia:Gecorene gemynddagas/5 Hrēþmōnaþ	Plantilla:Efemérides - 5 de marzo
Wikipǣdia:Gecorene gemynddagas/29 Sēremōnaþ	Plantilla:Efemérides - 29 de junio
Wikipǣdia:Gecorene gemynddagas/14 Blōtmōnaþ	Plantilla:Efemérides - 14 de noviembre
Wikipǣdia:Gecorene gemynddagas/6 Æfterra Gēola	Plantilla:Efemérides - 6 de enero
Wikipǣdia:Gecorene gemynddagas/18 Mǣdmōnaþ	Plantilla:Efemérides - 18 de julio
Wikipǣdia:Gecorene gemynddagas/23 Mǣdmōnaþ	Plantilla:Efemérides - 23 de julio
Wikipǣdia:Gecorene gemynddagas/1 Mǣdmōnaþ	Plantilla:Efemérides - 1 de julio
Wikipǣdia:Gecorene gemynddagas/20 Gēolmōnaþ	Plantilla:Efemérides - 20 de diciembre
Wikipǣdia:Gecorene gemynddagas/30 Wēodmōnaþ	Plantilla:Efemérides - 30 de agosto
Wikipǣdia:Gecorene gemynddagas/11 Wēodmōnaþ	Plantilla:Efemérides - 11 de agosto
Wikipǣdia:Gecorene gemynddagas/9 Wēodmōnaþ	Plantilla:Efemérides - 9 de agosto
Wikipǣdia:Gecorene gemynddagas/29 Blōtmōnaþ	Plantilla:Efemérides - 29 de noviembre
Wikipǣdia:Gecorene gemynddagas/2 Ēastermōnaþ	Plantilla:Efemérides - 2 de abril
Wikipǣdia:Gecorene gemynddagas/12 Mǣdmōnaþ	Plantilla:Efemérides - 12 de julio
Wikipǣdia:Gecorene gemynddagas/29 Wēodmōnaþ	Plantilla:Efemérides - 29 de agosto
Wikipǣdia:Gecorene gemynddagas/24 Sēremōnaþ	Plantilla:Efemérides - 24 de junio
Wikipǣdia:Gecorene gemynddagas/25 Blōtmōnaþ	Plantilla:Efemérides - 25 de noviembre
Wikipǣdia:Gecorene gemynddagas/21 Wēodmōnaþ	Plantilla:Efemérides - 21 de agosto
Wikipǣdia:Gecorene gemynddagas/29 Mǣdmōnaþ	Plantilla:Efemérides - 29 de julio
Wikipǣdia:Gecorene gemynddagas/29 Æfterra Gēola	Plantilla:Efemérides - 29 de enero
Wikipǣdia:Gecorene gemynddagas/5 Gēolmōnaþ	Plantilla:Efemérides - 5 de diciembre
Wikipǣdia:Gecorene gemynddagas/25 Hrēþmōnaþ	Plantilla:Efemérides - 25 de marzo
Wikipǣdia:Gecorene gemynddagas/22 Hrēþmōnaþ	Plantilla:Efemérides - 22 de marzo
Wikipǣdia:Gecorene gemynddagas/9 Hrēþmōnaþ	Plantilla:Efemérides - 9 de marzo
Wikipǣdia:Gecorene gemynddagas/12 Hrēþmōnaþ	Plantilla:Efemérides - 12 de marzo
Wikipǣdia:Gecorene gemynddagas/11 Hrēþmōnaþ	Plantilla:Efemérides - 11 de marzo
Wikipǣdia:Gecorene gemynddagas/19 Gēolmōnaþ	Plantilla:Efemérides - 19 de diciembre
Wikipǣdia:Gecorene gemynddagas/24 Solmōnaþ	Plantilla:Efemérides - 24 de febrero
Wikipǣdia:Gecorene gemynddagas/13 Solmōnaþ	Plantilla:Efemérides - 13 de febrero
Wikipǣdia:Gecorene gemynddagas/20 Solmōnaþ	Plantilla:Efemérides - 20 de febrero
Wikipǣdia:Gecorene gemynddagas/5 Æfterra Gēola	Plantilla:Efemérides - 5 de enero
Wikipǣdia:Gecorene gemynddagas/15 Hrēþmōnaþ	Plantilla:Efemérides - 15 de marzo
Wikipǣdia:Gecorene gemynddagas/23 Solmōnaþ	Plantilla:Efemérides - 23 de febrero
Wikipǣdia:Gecorene gemynddagas/13 Hrēþmōnaþ	Plantilla:Efemérides - 13 de marzo
Wikipǣdia:Gecorene gemynddagas/15 Hāligmōnaþ	Plantilla:Efemérides - 15 de septiembre
Wikipǣdia:Gecorene gemynddagas/15 Gēolmōnaþ	Plantilla:Efemérides - 15 de diciembre
Wikipǣdia:Gecorene gemynddagas/4 Hāligmōnaþ	Plantilla:Efemérides - 4 de septiembre
Wikipǣdia:Gecorene gemynddagas/8 Hāligmōnaþ	Plantilla:Efemérides - 8 de septiembre
Wikipǣdia:Gecorene gemynddagas/18 Gēolmōnaþ	Plantilla:Efemérides - 18 de diciembre
Wikipǣdia:Gecorene gemynddagas/4 Hrēþmōnaþ	Plantilla:Efemérides - 4 de marzo
Wikipǣdia:Gecorene gemynddagas/4 Winterfylleþ	Plantilla:Efemérides - 4 de octubre
Wikipǣdia:Gecorene gemynddagas/21 Blōtmōnaþ	Plantilla:Efemérides - 21 de noviembre
Wikipǣdia:Gecorene gemynddagas/1 Hāligmōnaþ	Plantilla:Efemérides - 1 de septiembre
Wikipǣdia:Gecorene gemynddagas/3 Mǣdmōnaþ	Plantilla:Efemérides - 3 de julio
Wikipǣdia:Gecorene gemynddagas/4 Mǣdmōnaþ	Plantilla:Efemérides - 4 de julio
Wikipǣdia:Gecorene gemynddagas/13 Æfterra Gēola	Plantilla:Efemérides - 13 de enero
Wikipǣdia:Gecorene gemynddagas/28 Sēremōnaþ	Plantilla:Efemérides - 28 de junio
Wikipǣdia:Gecorene gemynddagas/7 Sēremōnaþ	Plantilla:Efemérides - 7 de junio
Wikipǣdia:Gecorene gemynddagas/6 Hāligmōnaþ	Plantilla:Efemérides - 6 de septiembre
Wikipǣdia:Gecorene gemynddagas/25 Hāligmōnaþ	Plantilla:Efemérides - 25 de septiembre
Wikipǣdia:Gecorene gemynddagas/27 Æfterra Gēola	Plantilla:Efemérides - 27 de enero
Wikipǣdia:Gecorene gemynddagas/6 Mǣdmōnaþ	Plantilla:Efemérides - 6 de julio
Wikipǣdia:Gecorene gemynddagas/15 Mǣdmōnaþ	Plantilla:Efemérides - 15 de julio
Wikipǣdia:Gecorene gemynddagas/10 Hāligmōnaþ	Plantilla:Efemérides - 10 de septiembre
Wikipǣdia:Gecorene gemynddagas/26 Hāligmōnaþ	Plantilla:Efemérides - 26 de septiembre
Wikipǣdia:Gecorene gemynddagas/20 Hāligmōnaþ	Plantilla:Efemérides - 20 de septiembre
Wikipǣdia:Gecorene gemynddagas/16 Mǣdmōnaþ	Plantilla:Efemérides - 16 de julio
Wikipǣdia:Gecorene gemynddagas/14 Mǣdmōnaþ	Plantilla:Efemérides - 14 de julio
Wikipǣdia:Gecorene gemynddagas/25 Mǣdmōnaþ	Plantilla:Efemérides - 25 de julio
Wikipǣdia:Gecorene gemynddagas/12 Æfterra Gēola	Plantilla:Efemérides - 12 de enero
Wikipǣdia:Gecorene gemynddagas/23 Wēodmōnaþ	Plantilla:Efemérides - 23 de agosto
Wikipǣdia:Gecorene gemynddagas/22 Sēremōnaþ	Plantilla:Efemérides - 22 de junio
Wikipǣdia:Gecorene gemynddagas/16 Wēodmōnaþ	Plantilla:Efemérides - 16 de agosto
Wikipǣdia:Gecorene gemynddagas/30 Gēolmōnaþ	Plantilla:Efemérides - 30 de diciembre
Wikipǣdia:Gecorene gemynddagas/4 Blōtmōnaþ	Plantilla:Efemérides - 4 de noviembre
Wikipǣdia:Gecorene gemynddagas/3 Æfterra Gēola	Plantilla:Efemérides - 3 de enero
Wikipǣdia:Gecorene gemynddagas/30 Hāligmōnaþ	Plantilla:Efemérides - 30 de septiembre
Wikipǣdia:Gecorene gemynddagas/8 Æfterra Gēola	Plantilla:Efemérides - 8 de enero
Wikipǣdia:Gecorene gemynddagas/1 Hrēþmōnaþ	Plantilla:Efemérides - 1 de marzo
Wikipǣdia:Gecorene gemynddagas/14 Solmōnaþ	Plantilla:Efemérides - 14 de febrero
Wikipǣdia:Gecorene gemynddagas/7 Winterfylleþ	Plantilla:Efemérides - 7 de octubre
Wikipǣdia:Gecorene gemynddagas/19 Solmōnaþ	Plantilla:Efemérides - 19 de febrero
Wikipǣdia:Gecorene gemynddagas/28 Hrēþmōnaþ	Plantilla:Efemérides - 28 de marzo
Wikipǣdia:Gecorene gemynddagas/20 Hrēþmōnaþ	Plantilla:Efemérides - 20 de marzo
Wikipǣdia:Gecorene gemynddagas/6 Solmōnaþ	Plantilla:Efemérides - 6 de febrero
Wikipǣdia:Gecorene gemynddagas/7 Solmōnaþ	Plantilla:Efemérides - 7 de febrero
Wikipǣdia:Gecorene gemynddagas/21 Solmōnaþ	Plantilla:Efemérides - 21 de febrero
Wikipǣdia:Gecorene gemynddagas/1 Wēodmōnaþ	Plantilla:Efemérides - 1 de agosto
Wikipǣdia:Gecorene gemynddagas/14 Hrēþmōnaþ	Plantilla:Efemérides - 14 de marzo
Wikipǣdia:Gecorene gemynddagas/28 Solmōnaþ	Plantilla:Efemérides - 28 de febrero
Wikipǣdia:Gecorene gemynddagas/27 Hāligmōnaþ	Plantilla:Efemérides - 27 de septiembre
Wikipǣdia:Gecorene gemynddagas/8 Mǣdmōnaþ	Plantilla:Efemérides - 8 de julio
Wikipǣdia:Gecorene gemynddagas/11 Hāligmōnaþ	Plantilla:Efemérides - 11 de septiembre
Wikipǣdia:Gecorene gemynddagas/22 Mǣdmōnaþ	Plantilla:Efemérides - 22 de julio
Wikipǣdia:Gecorene gemynddagas/28 Wēodmōnaþ	Plantilla:Efemérides - 28 de agosto
Wikipǣdia:Gecorene gemynddagas/1 Blōtmōnaþ	Plantilla:Efemérides - 1 de noviembre
Wikipǣdia:Gecorene gemynddagas/2 Solmōnaþ	Plantilla:Efemérides - 2 de febrero
Wikipǣdia:Gecorene gemynddagas/4 Wēodmōnaþ	Plantilla:Efemérides - 4 de agosto
Wikipǣdia:Gecorene gemynddagas/22 Gēolmōnaþ	Plantilla:Efemérides - 22 de diciembre
Wikipǣdia:Gecorene gemynddagas/20 Winterfylleþ	Plantilla:Efemérides - 20 de octubre
Wikipǣdia:Gecorene gemynddagas/28 Mǣdmōnaþ	Plantilla:Efemérides - 28 de julio
Wikipǣdia:Gecorene gemynddagas/17 Æfterra Gēola	Plantilla:Efemérides - 17 de enero
Wikipǣdia:Gecorene gemynddagas/3 Solmōnaþ	Plantilla:Efemérides - 3 de febrero
Bysen:Lang-sr	Plantilla:Lang-sr
Wikipǣdia:Gecorene gemynddagas/7 Mǣdmōnaþ	Plantilla:Efemérides - 7 de julio
Wikipǣdia:Gecorene gemynddagas/24 Mǣdmōnaþ	Plantilla:Efemérides - 24 de julio
Wikipǣdia:Gecorene gemynddagas/21 Mǣdmōnaþ	Plantilla:Efemérides - 21 de julio
Wikipǣdia:Gecorene gemynddagas/6 Sēremōnaþ	Plantilla:Efemérides - 6 de junio
Wikipǣdia:Gecorene gemynddagas/11 Mǣdmōnaþ	Plantilla:Efemérides - 11 de julio
Wikipǣdia:Gecorene gemynddagas/8 Wēodmōnaþ	Plantilla:Efemérides - 8 de agosto
Wikipǣdia:Gecorene gemynddagas/15 Wēodmōnaþ	Plantilla:Efemérides - 15 de agosto
Wikipǣdia:Gecorene gemynddagas/10 Mǣdmōnaþ	Plantilla:Efemérides - 10 de julio
Wikipǣdia:Gecorene gemynddagas/16 Hrēþmōnaþ	Plantilla:Efemérides - 16 de marzo
Wikipǣdia:Gecorene gemynddagas/14 Winterfylleþ	Plantilla:Efemérides - 14 de octubre
Wikipǣdia:Gecorene gemynddagas/17 Hrēþmōnaþ	Plantilla:Efemérides - 17 de marzo
Wikipǣdia:Gecorene gemynddagas/24 Hrēþmōnaþ	Plantilla:Efemérides - 24 de marzo
Wikipǣdia:Gecorene gemynddagas/21 Hrēþmōnaþ	Plantilla:Efemérides - 21 de marzo
Wikipǣdia:Gecorene gemynddagas/5 Solmōnaþ	Plantilla:Efemérides - 5 de febrero
Wikipǣdia:Gecorene gemynddagas/3 Winterfylleþ	Plantilla:Efemérides - 3 de octubre
Wikipǣdia:Gecorene gemynddagas/7 Hāligmōnaþ	Plantilla:Efemérides - 7 de septiembre
Wikipǣdia:Gecorene gemynddagas/26 Mǣdmōnaþ	Plantilla:Efemérides - 26 de julio
Wikipǣdia:Gecorene gemynddagas/14 Sēremōnaþ	Plantilla:Efemérides - 14 de junio
Flocc:Beorgas	Categoría:Montañas
Flocc:20e gēarhundred	Categoría:Siglo XX
Bysen:IPA	Plantilla:AFI
Bysen:HāligmōnaþGerīmbōc	Plantilla:Septiembre
Wikipǣdia:Gecorene gemynddagas/7 Hrēþmōnaþ	Plantilla:Efemérides - 7 de marzo
Wikipǣdia:Gecorene gemynddagas/29 Hrēþmōnaþ	Plantilla:Efemérides - 29 de marzo
Flocc:Bysen Brūcend Box Spræc	Categoría:Wikipedia:Plantillas Babel
Wikipǣdia:Gecorene gemynddagas/28 Ēastermōnaþ	Plantilla:Efemérides - 28 de abril
Bysen:LangWithName	Plantilla:LangWithName
Flocc:Hwæsingatūn	Categoría:Washington
Flocc:Wihta	Categoría:Criaturas mitológicas
Wikipǣdia:Gecorene gemynddagas/30 Hrēþmōnaþ	Plantilla:Efemérides - 30 de marzo
Wikipǣdia:Gecorene gemynddagas/22 Solmōnaþ	Plantilla:Efemérides - 22 de febrero
Wikipǣdia:Gecorene gemynddagas/31 Hrēþmōnaþ	Plantilla:Efemérides - 31 de marzo
Wikipǣdia:Gecorene gemynddagas/23 Hrēþmōnaþ	Plantilla:Efemérides - 23 de marzo
Wikipǣdia:Gecorene gemynddagas/17 Solmōnaþ	Plantilla:Efemérides - 17 de febrero
Bysen:MONTHNAME	Plantilla:Nombre mes
Wikipǣdia:Gecorene gemynddagas/30 Æfterra Gēola	Plantilla:Efemérides - 30 de enero
Wikipǣdia:Gecorene gemynddagas/9 Solmōnaþ	Plantilla:Efemérides - 9 de febrero
Wikipǣdia:Gecorene gemynddagas/8 Hrēþmōnaþ	Plantilla:Efemérides - 8 de marzo
Bysen:Sortname	Plantilla:Sortname
Flocc:Gebēd	Categoría:Oraciones
Wikipǣdia:Gecorene gemynddagas/29 Solmōnaþ	Plantilla:Efemérides - 29 de febrero
Wikipǣdia:Gecorene gemynddagas/2 Hrēþmōnaþ	Plantilla:Efemérides - 2 de marzo
Bysen:Country data Ireland	Plantilla:Geodatos Irlanda
Wikipǣdia:Gecorene gemynddagas/27 Solmōnaþ	Plantilla:Efemérides - 27 de febrero
Wikipǣdia:Gecorene gemynddagas/26 Hrēþmōnaþ	Plantilla:Efemérides - 26 de marzo
Flocc:Country data templates	Categoría:Wikipedia:Plantillas de geodatos
Bysen:Namespace detect	Plantilla:Detecta espacio de nombres
Wikipǣdia:Gecorene gemynddagas/Solmōnaþ	Wikipedia:Efemérides/Febrero
Bysen:Country data England	Plantilla:Geodatos Inglaterra
Flocc:19e gēarhundred	Categoría:Siglo XIX
Flocc:Wrīteras	Categoría:Escritores
Bysen:Country data Switzerland	Plantilla:Geodatos Suiza
Flocc:Eormengyld	Categoría:Universidades
Bysen:Lang-cs	Plantilla:Lang-cs
Bysen:Lang-he	Plantilla:Lang-he
Bysen:Infobox OS	Plantilla:Ficha de sistema operativo
Bysen:Both	Plantilla:Ambas
Flocc:Æfterra Gēola	Categoría:Enero
Bysen:Lang-fa	Plantilla:Lang-fa
Wikipǣdia:Gecorene gemynddagas/12 Winterfylleþ	Plantilla:Efemérides - 12 de octubre
Wikipǣdia:Gecorene gemynddagas/11 Solmōnaþ	Plantilla:Efemérides - 11 de febrero
Wikipǣdia:Gecorene gemynddagas/5 Blōtmōnaþ	Plantilla:Efemérides - 5 de noviembre
Wikipǣdia:Gecorene gemynddagas/11 Æfterra Gēola	Plantilla:Efemérides - 11 de enero
Wikipǣdia:Gecorene gemynddagas/3 Hāligmōnaþ	Plantilla:Efemérides - 3 de septiembre
Wikipǣdia:Gecorene gemynddagas/24 Hāligmōnaþ	Plantilla:Efemérides - 24 de septiembre
Bysen:Rtl-lang	Plantilla:Rtl-lang
Bysen:Please don't change this page	Ayuda:Introducción 2
Bysen:CAN	Plantilla:CAN
Bysen:Lang-de	Plantilla:Lang-de
Bysen:Country data Austria-Hungary	Plantilla:Geodatos Imperio austrohúngaro
Bysen:Lang-la	Plantilla:Lang-la
Flocc:Wucu	Categoría:Semanas
Bysen:Lang-af	Plantilla:Lang-af
Wikipǣdia:Gecorene gemynddagas/Gēolmōnaþ	Wikipedia:Efemérides/Diciembre
Bysen:Infobox Album	Plantilla:Ficha de álbum
Bysen:User	Plantilla:U
Wikipǣdia:Gecorene gemynddagas/16 Gēolmōnaþ	Plantilla:Efemérides - 16 de diciembre
Wikipǣdia:Gecorene gemynddagas/9 Æfterra Gēola	Plantilla:Efemérides - 9 de enero
Wikipǣdia:Gecorene gemynddagas/7 Æfterra Gēola	Plantilla:Efemérides - 7 de enero
Wikipǣdia:Gecorene gemynddagas/19 Mǣdmōnaþ	Plantilla:Efemérides - 19 de julio
Wikipǣdia:Gecorene gemynddagas/13 Wēodmōnaþ	Plantilla:Efemérides - 13 de agosto
Wikipǣdia:Gecorene gemynddagas/12 Hāligmōnaþ	Plantilla:Efemérides - 12 de septiembre
Wikipǣdia:Gecorene gemynddagas/2 Hāligmōnaþ	Plantilla:Efemérides - 2 de septiembre
Wikipǣdia:Gecorene gemynddagas/7 Wēodmōnaþ	Plantilla:Efemérides - 7 de agosto
Wikipǣdia:Gecorene gemynddagas/4 Ēastermōnaþ	Plantilla:Efemérides - 4 de abril
Wikipǣdia:Gecorene gemynddagas/22 Æfterra Gēola	Plantilla:Efemérides - 22 de enero
Wikipǣdia:Gecorene gemynddagas/4 Æfterra Gēola	Plantilla:Efemérides - 4 de enero
Wikipǣdia:Gecorene gemynddagas/19 Wēodmōnaþ	Plantilla:Efemérides - 19 de agosto
Wikipǣdia:Gecorene gemynddagas/18 Hāligmōnaþ	Plantilla:Efemérides - 18 de septiembre
Wikipǣdia:Gecorene gemynddagas/4 Gēolmōnaþ	Plantilla:Efemérides - 4 de diciembre
Wikipǣdia:Gecorene gemynddagas/2 Wēodmōnaþ	Plantilla:Efemérides - 2 de agosto
Wikipǣdia:Gecorene gemynddagas/21 Gēolmōnaþ	Plantilla:Efemérides - 21 de diciembre
Wikipǣdia:Gecorene gemynddagas/20 Mǣdmōnaþ	Plantilla:Efemérides - 20 de julio
Wikipǣdia:Gecorene gemynddagas/18 Wēodmōnaþ	Plantilla:Efemérides - 18 de agosto
Wikipǣdia:Gecorene gemynddagas/24 Æfterra Gēola	Plantilla:Efemérides - 24 de enero
Wikipǣdia:Brōðra rǣdscēawung	Wikiproyecto:Revisión por pares
Bysen:Year nav	Plantilla:Año
Flocc:Flyhthæfenan on Fietname	Categoría:Aeropuertos de Vietnam
Flocc:Gebed	Categoría:Oraciones cristianas
Flocc:Cyningas of Englalande	Categoría:Reyes de Inglaterra
Flocc:Bryttisce cyningas	Categoría:Gobernantes de Reino Unido
Bysen:GRA mid rīce namum	Plantilla:Estados de Estados Unidos de América
Bysen:Imdb name	Plantilla:IMDb nombre
Flocc:Tunisia	Categoría:Túnez
Bysen:Cyþþubox Ira tun	Plantilla:Ficha de localidad de Irlanda
Bysen:Wikispell	Plantilla:Wikinoticias
Bysen:Oppose	Plantilla:En contra
Flocc:Þēodisc burg	Categoría:Localidades de Alemania
Flocc:Norþ Carolīna	Categoría:Carolina del Norte
Flocc:Puerto Rico	Categoría:Puerto Rico
Bysen:ColBreak	Plantilla:Nueva columna
Flocc:Byrig þāra Geāndena Rīca American	Categoría:Ciudades de Estados Unidos
Bysen:Country data West Germany	Plantilla:Geodatos Alemania Occidental
Bysen:Lang-ru	Plantilla:Lang-ru
Bysen:Country data East Germany	Plantilla:Geodatos Alemania Oriental
Bysen:Browsebar	Plantilla:Portales de Wikipedia
Bysen:SolmōnaþGerīmbōc	Plantilla:Febrero
Flocc:Brittisca Here	Categoría:Ejército Británico
Bysen:Disambig	Plantilla:Desambiguación
Bysen:Country data Nazi Germany	Plantilla:Geodatos Alemania nazi
Bysen:Doi	Plantilla:Doi
Bysen:Country data German Empire	Plantilla:Geodatos Imperio alemán
Flocc:Coreanisc stǣr	Categoría:Historia de Corea
Bysen:Fb	Plantilla:Self-i
Bysen:Lang-grc	Plantilla:Lang-grc
Bysen:Infobox Film	Plantilla:Ficha de película
Bysen:Lang-en	Plantilla:Lang-en
Bysen:Fix	Plantilla:Solicitud de referencias
Flocc:Byrig on Oklahoman	Categoría:Asentamientos de Oklahoma
Bysen:Lang-id	Plantilla:Lang-id
Bysen:Monþes lengþ	Plantilla:Días mes
Bysen:Period end	Plantilla:Period end
Bysen:Lang-fr	Plantilla:Lang-fr
Bysen:Fossil range	Plantilla:Rango fósil
Bysen:Betwuxwici	Plantilla:InterWiki
Flocc:Byrig in þǣm Niðerlandum	Categoría:Localidades de los Países Bajos
Wikipǣdia:Gecorene gemynddagas/Hāligmōnaþ	Wikipedia:Efemérides/Septiembre
Bysen:Coord	Plantilla:Coord
Flocc:Byrig on Lincolnscīre	Categoría:Localidades de Lincolnshire
Flocc:Wyoming	Categoría:Wyoming
Wikipǣdia:Gecorene gemynddagas/14 Hāligmōnaþ	Plantilla:Efemérides - 14 de septiembre
Wikipǣdia:Gecorene gemynddagas/20 Sēremōnaþ	Plantilla:Efemérides - 20 de junio
Wikipǣdia:Gecorene gemynddagas/22 Wēodmōnaþ	Plantilla:Efemérides - 22 de agosto
Wikipǣdia:Gecorene gemynddagas/9 Hāligmōnaþ	Plantilla:Efemérides - 9 de septiembre
Wikipǣdia:Gecorene gemynddagas/13 Hāligmōnaþ	Plantilla:Efemérides - 13 de septiembre
Wikipǣdia:Gecorene gemynddagas/1 Æfterra Gēola	Plantilla:Efemérides - 1 de enero
Wikipǣdia:Gecorene gemynddagas/14 Wēodmōnaþ	Plantilla:Efemérides - 14 de agosto
Wikipǣdia:Gecorene gemynddagas/6 Gēolmōnaþ	Plantilla:Efemérides - 6 de diciembre
Flocc:Grēneland	Categoría:Groenlandia
Wikipǣdia:Gecorene gemynddagas/Winterfylleþ	Wikipedia:Efemérides/Octubre
Flocc:User sk	Categoría:Wikipedia:Wikipedistas con conocimientos de eslovaco
Flocc:Brūcend eo	Categoría:Wikipedia:Wikipedistas con conocimientos de esperanto
Flocc:Brūcend fr	Categoría:Wikipedia:Wikipedistas con conocimientos de francés
Flocc:Brūcend cy	Categoría:Wikipedia:Wikipedistas con conocimientos de galés
Flocc:Brūcend got	Categoría:Wikipedia:Wikipedistas con conocimientos de gótico
Flocc:Brūcend ang	Categoría:Wikipedia:Wikipedistas con conocimientos de inglés antiguo
Flocc:Brūcend la	Categoría:Wikipedia:Wikipedistas con conocimientos de latín
Flocc:Brūcend lt	Categoría:Wikipedia:Wikipedistas con conocimientos de lituano
Flocc:Brūcend pt	Categoría:Wikipedia:Wikipedistas con conocimientos de portugués
Flocc:Brūcend sv	Categoría:Wikipedia:Wikipedistas con conocimientos de sueco
Flocc:Brūcend fr-3	Categoría:Wikipedia:Wikipedistas con nivel avanzado de francés
Flocc:Brūcend cy-3	Categoría:Wikipedia:Wikipedistas con nivel avanzado de galés
Flocc:Brūcend ang-3	Categoría:Wikipedia:Wikipedistas con nivel avanzado de inglés antiguo
Flocc:Brūcend it-3	Categoría:Wikipedia:Wikipedistas con nivel avanzado de italiano
Flocc:Brūcend pl-3	Categoría:Wikipedia:Wikipedistas con nivel avanzado de polaco
Flocc:Brūcend fi-1	Categoría:Wikipedia:Wikipedistas con nivel básico de finés
Flocc:Brūcend cy-1	Categoría:Wikipedia:Wikipedistas con nivel básico de galés
Flocc:Brūcend ang-1	Categoría:Wikipedia:Wikipedistas con nivel básico de inglés antiguo
Flocc:Brūcend nl-1	Categoría:Wikipedia:Wikipedistas con nivel básico de neerlandés
Flocc:Brūcend pl-1	Categoría:Wikipedia:Wikipedistas con nivel básico de polaco
Flocc:Brūcend fr-4	Categoría:Wikipedia:Wikipedistas con nivel experto de francés
Flocc:Brūcend cy-4	Categoría:Wikipedia:Wikipedistas con nivel experto de galés
Flocc:Brūcend ang-4	Categoría:Wikipedia:Wikipedistas con nivel experto de inglés antiguo
Flocc:Brūcend it-4	Categoría:Wikipedia:Wikipedistas con nivel experto de italiano
Flocc:Brūcend pl-4	Categoría:Wikipedia:Wikipedistas con nivel experto de polaco
Flocc:Brūcend fr-2	Categoría:Wikipedia:Wikipedistas con nivel intermedio de francés
Flocc:Brūcend cy-2	Categoría:Wikipedia:Wikipedistas con nivel intermedio de galés
Flocc:Brūcend ang-2	Categoría:Wikipedia:Wikipedistas con nivel intermedio de inglés antiguo
Flocc:Brūcend it-2	Categoría:Wikipedia:Wikipedistas con nivel intermedio de italiano
Flocc:Brūcend la-2	Categoría:Wikipedia:Wikipedistas con nivel intermedio de latín
Flocc:Brūcend pl-2	Categoría:Wikipedia:Wikipedistas con nivel intermedio de polaco
Flocc:Brūcend sv-2	Categoría:Wikipedia:Wikipedistas con nivel intermedio de sueco
Flocc:Brūcend fr-M	Categoría:Wikipedia:Wikipedistas con nivel nativo de francés
Flocc:Brūcend cy-M	Categoría:Wikipedia:Wikipedistas con nivel nativo de galés
Flocc:Brūcend ang-N	Categoría:Wikipedia:Wikipedistas con nivel nativo de inglés antiguo
Flocc:Brūcend is-M	Categoría:Wikipedia:Wikipedistas con nivel nativo de islandés
Flocc:Brūcend lt-N	Categoría:Wikipedia:Wikipedistas con nivel nativo de lituano
Flocc:Brūcend nl-M	Categoría:Wikipedia:Wikipedistas con nivel nativo de neerlandés
Flocc:Brūcend ru-M	Categoría:Wikipedia:Wikipedistas con nivel nativo de ruso
Flocc:Brūcend fr-5	Categoría:Wikipedia:Wikipedistas con nivel profesional de francés
Flocc:Brūcend cy-5	Categoría:Wikipedia:Wikipedistas con nivel profesional de galés
Flocc:Brūcend ang-5	Categoría:Wikipedia:Wikipedistas con nivel profesional de inglés antiguo
Flocc:Brūcend it-5	Categoría:Wikipedia:Wikipedistas con nivel profesional de italiano
Flocc:Brūcend la-5	Categoría:Wikipedia:Wikipedistas con nivel profesional de latín
Flocc:Brūcend pl-5	Categoría:Wikipedia:Wikipedistas con nivel profesional de polaco
Flocc:Feormung	Categoría:Entretenimiento
Flocc:Hēafodstōlas þæs Sericus Gārsecges	Categoría:Capitales de Oceanía
Flocc:Turcas and Caicos Īegland	Categoría:Islas Turcas y Caicos
Flocc:Tudoryld	Categoría:Inglaterra de los Tudor
Flocc:Articles that need to be wikified	Categoría:Wikipedia:Wikificar
Flocc:Sericus Garsecg	Categoría:Océano Pacífico
Flocc:User sk-N	Categoría:Wikipedia:Wikipedistas con nivel nativo de eslovaco
Flocc:Brūcend de	Categoría:Wikipedia:Wikipedistas con conocimientos de alemán
Flocc:Brūcend de-2	Categoría:Wikipedia:Wikipedistas con nivel intermedio de alemán
Flocc:Brūcend de-3	Categoría:Wikipedia:Wikipedistas con nivel avanzado de alemán
Flocc:Brūcend de-4	Categoría:Wikipedia:Wikipedistas con nivel experto de alemán
Flocc:Brūcend el	Categoría:Wikipedia:Wikipedistas con conocimientos de griego antiguo
Flocc:Sūþgeorgia and þā Sūþsandwic Īegland	Categoría:Islas Georgias del Sur y Sandwich del Sur
Flocc:Brūcend en-3	Categoría:Wikipedia:Wikipedistas con nivel avanzado de inglés
Flocc:Brūcend en-5	Categoría:Wikipedia:Wikipedistas con nivel profesional de inglés
Flocc:Brūcend en-M	Categoría:Wikipedia:Wikipedistas con nivel nativo de inglés
Flocc:Brūcend es	Categoría:Wikipedia:Wikipedistas con conocimientos de español
Flocc:Brūcend es-1	Categoría:Wikipedia:Wikipedistas con nivel básico de español
Flocc:Brūcend es-2	Categoría:Wikipedia:Wikipedistas con nivel intermedio de español
Flocc:Puilla	Categoría:Apulia
Flocc:Brūcend es-3	Categoría:Wikipedia:Wikipedistas con nivel avanzado de español
Flocc:Brūcend es-4	Categoría:Wikipedia:Wikipedistas con nivel experto de español
Flocc:Brūcend es-N	Categoría:Wikipedia:Wikipedistas con nivel nativo de español
Flocc:Mexiciscu rīce	Categoría:Organización territorial de México
Flocc:Frencisc Guiana	Categoría:Guayana Francesa
Ǣht	Propiedad
Flocc:Hebrēisc sprǣc	Categoría:Idioma hebreo
Flocc:Bryttisc bōccræft	Categoría:Literatura del Reino Unido
Flocc:Brūcend pl-N	Categoría:Wikipedia:Wikipedistas con nivel nativo de polaco
Flocc:Brūcend pt-1	Categoría:Wikipedia:Wikipedistas con nivel básico de portugués
Bysen:Country data Germany	Plantilla:Geodatos Alemania
Bysen:Country data Geāned Cynerīce	Plantilla:Geodatos Reino Unido
Wikipǣdia:Gecorene gemynddagas/17 Gēolmōnaþ	Plantilla:Efemérides - 17 de diciembre
Wikipǣdia:Gecorene gemynddagas/Mǣdmōnaþ	Wikipedia:Efemérides/Julio
Bysen:Lang-be	Plantilla:Lang-be
Bysen:Cite encyclopedia	Plantilla:Cita enciclopedia
Bysen:Country data Scotland	Plantilla:Geodatos Escocia
Wikipǣdia:Tutorial (Formatting)	Ayuda:Tutorial (formato)
Flocc:Brūcend it	Categoría:Wikipedia:Wikipedistas con conocimientos de italiano
Flocc:Brūcend it-1	Categoría:Wikipedia:Wikipedistas con nivel básico de italiano
Flocc:Rīcu þāra Geāndena Rīca American	Categoría:Estados de Estados Unidos
Bysen:Mpl	Plantilla:Mpl
Flocc:Brūcend la-1	Categoría:Wikipedia:Wikipedistas con nivel básico de latín
Wikipǣdia:Gecorene gemynddagas/29 Hāligmōnaþ	Plantilla:Efemérides - 29 de septiembre
Wikipǣdia:Gecorene gemynddagas/5 Hāligmōnaþ	Plantilla:Efemérides - 5 de septiembre
Bysen:Cite doi	Plantilla:Cite doi
Flocc:Pulgara cyningas	Categoría:Monarcas de Bulgaria
Flocc:Fȳrbeorgas	Categoría:Volcanes
Flocc:Dēorabyscīr	Categoría:Derbyshire
Flocc:Byrig on Latie	Categoría:Localidades del Lacio
Flocc:Feohtan	Categoría:Artes marciales
Bysen:Country data Australasia	Plantilla:Geodatos Australasia
Flocc:Blōtmōnaþ	Categoría:Noviembre
Flocc:Difelinscīr	Categoría:Condado de Dublín
Wikipǣdia:Babel	Wikipedia:Babel
Flocc:Lēodweard	Categoría:Dirigentes
Flocc:Scopas	Categoría:Poetas
Bysen:BlōtmōnaþGerīmbōc	Plantilla:Noviembre
Flocc:Hāligmōnaþ	Categoría:Septiembre
Flocc:Byrig on Norþdakotan	Categoría:Asentamientos de Dakota del Norte
Flocc:Winterfylleþ	Categoría:Octubre
Flocc:Sǣ	Categoría:Mares
Flocc:Gēolmōnaþ	Categoría:Diciembre
Flocc:Wēodmōnaþ	Categoría:Agosto
Flocc:Þrimilcemōnaþ	Categoría:Mayo
Bysen:ÞrimilcemōnaþGerīmbōc	Plantilla:Mayo
Flocc:Brandenburg	Categoría:Brandeburgo
Flocc:Englaland	Categoría:Inglaterra
Seringas	Pueblo chino
Wikipǣdia:Gecorene gemynddagas/22 Blōtmōnaþ	Plantilla:Efemérides - 22 de noviembre
Flocc:Ēastermōnaþ	Categoría:Abril
Bysen:IPA2	Plantilla:AFI2
Flocc:Līfnamrǣden	Categoría:Taxonomía
Bysen:Lang-it	Plantilla:Lang-it
Flocc:Brūcend es-5	Categoría:Wikipedia:Wikipedistas con nivel profesional de español
Bysen:Country data Brazil	Plantilla:Geodatos Brasil
Flocc:Gestorfen in 988	Categoría:Fallecidos en 988
Flocc:Wæter	Categoría:Agua
Flocc:Hēafod and swēor	Categoría:Cabeza
Flocc:Geboren in 121	Categoría:Nacidos en 121
Wikipǣdia:MediaWiki namespace	Ayuda:Espacio de nombres de MediaWiki
Flocc:180	Categoría:180
Flocc:Gestorfen in 180	Categoría:Fallecidos en 180
Flocc:Drincas	Categoría:Bebidas
Flocc:Gestorfen in 2005	Categoría:Fallecidos en 2005
Flocc:450	Categoría:450
Wikipǣdia:Administrators' how-to guide	Ayuda:Guía para bibliotecarios
Bysen:Start date and age	Plantilla:Fecha de lanzamiento
Wikipǣdia:Manigsprǣclicu samodwyrcung	Wikipedia:Coordinación plurilingüe
Flocc:Geboren in 1974	Categoría:Nacidos en 1974
Flocc:Geboren in 1899	Categoría:Nacidos en 1899
Flocc:Oklahoma	Categoría:Oklahoma
Flocc:Iapanisc sangeras	Categoría:Cantantes de Japón
Flocc:Forman Þegnas	Categoría:Primeros ministros
Flocc:Geboren in 1954	Categoría:Nacidos en 1954
Flocc:850	Categoría:850
Flocc:Geboren in 850	Categoría:Nacidos en 850
Flocc:Hwītrussland	Categoría:Bielorrusia
Flocc:Alberta	Categoría:Alberta
Flocc:Ontario	Categoría:Ontario
Flocc:Nīwe Scotland	Categoría:Nueva Escocia
Flocc:899	Categoría:899
Flocc:Gestorfen in 899	Categoría:Fallecidos en 899
Flocc:Geocon Landscipe	Categoría:Yukón
Flocc:Massachusetts	Categoría:Massachusetts
Flocc:924	Categoría:924
Flocc:Gestorfen in 924	Categoría:Fallecidos en 924
Bysen:Editprotected	Plantilla:Edición protegida
Bysen:Country data Ungerland	Plantilla:Geodatos Hungría
Flocc:Land on Affrice	Categoría:Países de África
Bysen:ÆfterraGēolaGerīmbōc	Plantilla:Enero
Flocc:Geboren in 1239	Categoría:Nacidos en 1239
Flocc:1249	Categoría:1249
Flocc:1289	Categoría:1289
Flocc:1305	Categoría:1305
Flocc:Gestorfen in 1305	Categoría:Fallecidos en 1305
Flocc:1307	Categoría:1307
Wikipǣdia:Gecorene gemynddagas/Blōtmōnaþ	Wikipedia:Efemérides/Noviembre
Bysen:Country data New Zealand	Plantilla:Geodatos Nueva Zelanda
Flocc:Ēa Franclandes	Categoría:Ríos de Francia
Flocc:Brūcend ru	Categoría:Wikipedia:Wikipedistas con conocimientos de ruso
Flocc:1634	Categoría:1634
Flocc:1638	Categoría:1638
Bysen:En icon	Plantilla:En
Flocc:1719	Categoría:1719
Flocc:Gestorfen in 1719	Categoría:Fallecidos en 1719
Bysen:Country data Faroe Islands	Plantilla:Geodatos Islas Feroe
Flocc:121	Categoría:121
Bysen:Lang	Plantilla:Lang
Wikipǣdia:Gecorene gemynddagas/21 Hāligmōnaþ	Plantilla:Efemérides - 21 de septiembre
Bysen:Country data Americanisc	Plantilla:Geodatos Estados Unidos
Bysen:Next period	Plantilla:Next period
Flocc:Trēowu	Categoría:Árboles y arbustos
Flocc:Geboren in 1634	Categoría:Nacidos en 1634
Flocc:Geboren in 1638	Categoría:Nacidos en 1638
Flocc:Geboren in 1852	Categoría:Nacidos en 1852
Flocc:Geboren in 1892	Categoría:Nacidos en 1892
Flocc:Geboren in 1918	Categoría:Nacidos en 1918
Flocc:Geboren in 1945	Categoría:Nacidos en 1945
Flocc:Geboren in 1949	Categoría:Nacidos en 1949
Flocc:Geboren in 1981	Categoría:Nacidos en 1981
Flocc:Geboren in 1993	Categoría:Nacidos en 1993
Flocc:1715	Categoría:1715
Wikipǣdia:Gecorene gemynddagas/Ēastermōnaþ	Wikipedia:Efemérides/Abril
Bysen:Period color	Plantilla:Period color
Flocc:11e gēarhundred	Categoría:Siglo XI
Flocc:988	Categoría:988
Flocc:10e gēarhundred	Categoría:Siglo X
Flocc:7e gēarhundred	Categoría:Siglo VII
Bysen:WēodmōnaþGerīmbōc	Plantilla:Agosto
Flocc:1239	Categoría:1239
Flocc:Gestorfen in 1307	Categoría:Fallecidos en 1307
Flocc:Corsica	Categoría:Córcega
Flocc:Gestorfen in 1715	Categoría:Fallecidos en 1715
Flocc:Australisce hēafodstōlas	Categoría:Capitales australianas
Flocc:Russisce bōccræft	Categoría:Literatura de Rusia
Flocc:Sardinia	Categoría:Cerdeña
Bysen:Lang-hi	Plantilla:Lang-hi
Flocc:Florida	Categoría:Florida
Flocc:Normandig	Categoría:Normandía
Flocc:Francena caseras	Categoría:Emperadores de Francia
Flocc:Nevada	Categoría:Nevada
Flocc:Nebraska	Categoría:Nebraska
Flocc:Norþ Dakota	Categoría:Dakota del Norte
Flocc:Nīwe Eoforwīc	Categoría:Nueva York (estado)
Flocc:Rhode Īeg	Categoría:Rhode Island
Flocc:Louisiāna	Categoría:Luisiana
Flocc:Marianland	Categoría:Maryland
Flocc:Maine	Categoría:Maine
Flocc:Minnesota	Categoría:Minnesota
Flocc:Michigan	Categoría:Míchigan
Flocc:Mississippi	Categoría:Misisipi
Flocc:Missouri	Categoría:Misuri
Flocc:Vermont	Categoría:Vermont
Flocc:Virginia	Categoría:Virginia
Flocc:Idaho	Categoría:Idaho
Flocc:Iowa	Categoría:Iowa
Flocc:Arkansas	Categoría:Arkansas
Flocc:Alaska	Categoría:Alaska
Flocc:Arizona	Categoría:Arizona
Flocc:Alabama	Categoría:Alabama
Flocc:Ohio	Categoría:Ohio
Flocc:Westvirginia	Categoría:Virginia Occidental
Flocc:Wisconsin	Categoría:Wisconsin
Flocc:Indiāna	Categoría:Indiana
Flocc:Illinois	Categoría:Illinois
Flocc:Kansas	Categoría:Kansas
Flocc:California	Categoría:California
Flocc:Kentucky	Categoría:Kentucky
Flocc:Connecticut	Categoría:Connecticut
Flocc:Colorado	Categoría:Colorado
Flocc:Texas	Categoría:Texas
Flocc:Hawaii	Categoría:Hawái
Bysen:Fs end	Plantilla:Equipo de fútbol fin
Bysen:Fs start	Plantilla:Equipo de fútbol inicio
Flocc:Ōðru Woruldgūþ	Categoría:Segunda Guerra Mundial
Flocc:Nīwes Sǣlandes byrig	Categoría:Localidades de Nueva Zelanda
Bysen:Fossil range/marker	Plantilla:Rango fósil/marcador
Flocc:Hundas	Categoría:Perros
Flocc:Cattas	Categoría:Felidae
Wikipǣdia:Gecorene gemynddagas/16 Solmōnaþ	Plantilla:Efemérides - 16 de febrero
Wikipǣdia:Gecorene gemynddagas/25 Wēodmōnaþ	Plantilla:Efemérides - 25 de agosto
Flocc:Russisce wrīteras	Categoría:Escritores de Rusia
Flocc:1066	Categoría:1066
Flocc:Gestorfen in 1066	Categoría:Fallecidos en 1066
Bysen:WinterfylleþGerīmbōc	Plantilla:Octubre
Flocc:Angola	Categoría:Angola
Flocc:Botswana	Categoría:Botsuana
Flocc:Elpendbānrima	Categoría:Costa de Marfil
Flocc:Æriþrea	Categoría:Eritrea
Flocc:Gabon	Categoría:Gabón
Flocc:Gambia	Categoría:Gambia
Flocc:Guinea	Categoría:Guinea
Flocc:Camerun	Categoría:Camerún
Flocc:Grēnenæs Īega	Categoría:Cabo Verde
Flocc:Cenia	Categoría:Kenia
Flocc:Liberia	Categoría:Liberia
Flocc:Libia	Categoría:Libia
Flocc:Morocco	Categoría:Marruecos
Flocc:Mauritania	Categoría:Mauritania
Flocc:1451	Categoría:1451
Flocc:Namibia	Categoría:Namibia
Flocc:Caribisc Sǣ	Categoría:Mar Caribe
Flocc:Delaware	Categoría:Delaware
Flocc:Georgia (America)	Categoría:Georgia (Estados Unidos)
Flocc:Montāna	Categoría:Montana
Bysen:Merge	Plantilla:Fusionar
Flocc:Tennessee	Categoría:Tennessee
Flocc:Baden-Wyrttemberg	Categoría:Baden-Wurtemberg
Flocc:1852	Categoría:1852
Flocc:1892	Categoría:1892
Flocc:Gestorfen in 1926	Categoría:Fallecidos en 1926
Flocc:1973	Categoría:1973
Flocc:Gestorfen in 1973	Categoría:Fallecidos en 1973
Flocc:1975	Categoría:1975
Flocc:1981	Categoría:1981
Flocc:Gestorfen in 1982	Categoría:Fallecidos en 1982
Flocc:2004	Categoría:2004
Flocc:Gestorfen in 2004	Categoría:Fallecidos en 2004
Flocc:2005	Categoría:2005
Flocc:2006	Categoría:2006
Flocc:2007	Categoría:2007
Flocc:2008	Categoría:2008
Flocc:Ēa	Categoría:Ríos
Flocc:Sūþsudan	Categoría:Sudán del Sur
Flocc:Cead	Categoría:Chad
Flocc:Uganda	Categoría:Uganda
Flocc:Rōmānisce Cāseras	Categoría:Emperadores romanos
Flocc:Brūcend nl	Categoría:Wikipedia:Wikipedistas con conocimientos de neerlandés
Flocc:Sūþhjaltland	Categoría:Islas Shetland del Sur
Flocc:Brūcend no	Categoría:Wikipedia:Wikipedistas con conocimientos de noruego
Flocc:Niðerlanda Cyningas	Categoría:Gobernantes de los Países Bajos
Flocc:Norrena cyningas	Categoría:Reyes de Noruega
Flocc:Swēona cyningas	Categoría:Reyes de Suecia
Flocc:Armenia	Categoría:Armenia
Flocc:Bahrain	Categoría:Baréin
Flocc:Mennisc bodiȝlār	Categoría:Anatomía humana
Flocc:Feorrsīen	Categoría:Televisión
Flocc:14e gēarhundred	Categoría:Siglo XIV
Flocc:13e gēarhundred	Categoría:Siglo XIII
Flocc:2e gēarhundred	Categoría:Siglo II
Flocc:4e gēarhundred	Categoría:Siglo IV
Flocc:5e gēarhundred	Categoría:Siglo V
Flocc:18e gēarhundred	Categoría:Siglo XVIII
Flocc:6e gēarhundred	Categoría:Siglo VI
Flocc:Arabea	Categoría:Arabia
Flocc:Nīwlicu Word	Categoría:Neologismos
Flocc:Nīwesǣlendisce wrīteras	Categoría:Escritores de Nueva Zelanda
Flocc:Seaxland-Anhalt	Categoría:Sajonia-Anhalt
Flocc:Niðerseaxland	Categoría:Baja Sajonia
Flocc:Russe	Categoría:Rusos
Flocc:Unƿǣre lēode	Categoría:Personajes ficticios
Flocc:Crēcisc ūtwitan	Categoría:Filósofos de Grecia
Flocc:Sūþseaxe	Categoría:Sussex
Flocc:Bægwaraland	Categoría:Baviera
Flocc:Superman	Categoría:Superman
Flocc:Ēage	Categoría:Ojo
Flocc:Corn	Categoría:Cereales
Flocc:Nīweoforwīcburg	Categoría:Nueva York
Flocc:Norþfolc	Categoría:Norfolk
Flocc:Norþhāmtūnescīr	Categoría:Northamptonshire
Flocc:NBC	Categoría:NBC
Flocc:Snotingahāmscīr	Categoría:Nottinghamshire
Flocc:15e gēarhundred	Categoría:Siglo XV
Flocc:Georgia (land)	Categoría:Georgia
Flocc:Cambodia	Categoría:Camboya
Flocc:Americanisc sangeras	Categoría:Cantantes de Estados Unidos
Flocc:Bryttisce scopas	Categoría:Poetas del Reino Unido
Flocc:Stǣr þæs Cynerices Greatbryttenes	Categoría:Historia de Reino Unido
Flocc:Iamaica	Categoría:Jamaica
Bysen:Lang-hy	Plantilla:Lang-hy
Flocc:Scotta cyningas	Categoría:Reyes de Escocia
Flocc:Bryttiscan Fæmne Īegland	Categoría:Islas Vírgenes Británicas
Flocc:Corēa	Categoría:Corea
Flocc:Burma	Categoría:Birmania
Flocc:Taprabane	Categoría:Sri Lanka
Flocc:Tacgicastan	Categoría:Tayikistán
Flocc:Ēasttimor	Categoría:Timor Oriental
Flocc:Turcmenistan	Categoría:Turkmenistán
Flocc:Usbecastan	Categoría:Uzbekistán
Flocc:Geānedan Arabiscan Bregorīce	Categoría:Emiratos Árabes Unidos
Flocc:9e gēarhundred	Categoría:Siglo IX
Flocc:Sofiet Gesamnung	Categoría:Unión Soviética
Flocc:Wēalas	Categoría:Gales
Flocc:Blizzard Entertainment	Categoría:Blizzard Entertainment
Flocc:Foresittendas þāra Geāndena Rīca American	Categoría:Presidentes de Estados Unidos
Flocc:Europisc stǣr	Categoría:Historia de Europa
Flocc:Hascemisce Cynerīce þæs Iordanes	Categoría:Jordania
Flocc:Bosnia and Herzegovina	Categoría:Bosnia y Herzegovina
Flocc:Norþweg	Categoría:Noruega
Flocc:Barbados	Categoría:Barbados
Flocc:Paraguay	Categoría:Paraguay
Flocc:Ficgiege	Categoría:Fiyi
Flocc:Lēohtenstān	Categoría:Liechtenstein
Flocc:Uruguay	Categoría:Uruguay
Flocc:Andorra	Categoría:Andorra
Flocc:Serbia	Categoría:Serbia
Flocc:Ecuador	Categoría:Ecuador
Flocc:Peru	Categoría:Perú
Flocc:Bolifia	Categoría:Bolivia
Flocc:Albania	Categoría:Albania
Flocc:Monaco	Categoría:Mónaco
Flocc:Land on Norðamerican	Categoría:Países de América del Norte
Flocc:Fiscas	Categoría:Peces
Flocc:Mūþ	Categoría:Cavidad oral
Flocc:Wyrta	Categoría:Verduras
Flocc:Ofet	Categoría:Frutas
Flocc:Nīwu Gecȳþnes	Categoría:Nuevo Testamento
Flocc:Musea	Categoría:Museos
Flocc:Rímcræft	Categoría:Funciones
Flocc:Stǣrlice Sprǣccræft	Categoría:Lingüística histórica
Flocc:Dūnholmscīr	Categoría:Condado de Durham
Flocc:Manga	Categoría:Manga
Flocc:Eoferwicscīr	Categoría:Yorkshire
Flocc:Oferhæleðas	Categoría:Superhéroes
Flocc:Calpis	Categoría:Gibraltar
Flocc:Beadwe	Categoría:Batallas
Flocc:Weorcendebyrdnessa	Categoría:Sistemas operativos
Flocc:Mexicorīce	Categoría:Estados de México
Flocc:Hidalgo Rīce	Categoría:Estado de Hidalgo
Flocc:Hetwaraland	Categoría:Hesse
Flocc:Canadan underrīce and landscipas	Categoría:Provincias y territorios de Canadá
Flocc:Lunden	Categoría:Londres
Flocc:Lincolnscīr	Categoría:Lincolnshire
Flocc:Hēafodstōlas in American	Categoría:Localidades de América
Bysen:Incubator	Plantilla:Incubator
Flocc:Dæg þæs gēares	Categoría:Días
Flocc:Wikimedian geweorc	Categoría:Fundación Wikimedia
Flocc:Wiltūnscīr	Categoría:Wiltshire
Flocc:Wigreceastrescīr	Categoría:Worcestershire
Flocc:Haran	Categoría:Lepus
Flocc:Americanisce Ingefeoht	Categoría:Guerra Civil Estadounidense
Flocc:Byrig on Tuscanie	Categoría:Localidades de la Toscana
Flocc:Dēor	Categoría:Animales
Flocc:Hweorfdēor	Categoría:Vertebrata
Flocc:Pitcearnīega	Categoría:Islas Pitcairn
Flocc:Cægman Īegland	Categoría:Islas Caimán
Flocc:Folcland Īegland	Categoría:Islas Malvinas
Flocc:Land on Sūðamerican	Categoría:Países de América del Sur
Flocc:Colombia	Categoría:Colombia
Flocc:Anime	Categoría:Anime
Flocc:Oxnafordscīr	Categoría:Oxfordshire
Flocc:Hociȝ	Categoría:Hockey
Flocc:Heortfordscīr	Categoría:Hertfordshire
Flocc:Sicilia	Categoría:Sicilia
Flocc:Grantabrycgscīr	Categoría:Cambridgeshire
Flocc:Þēodacynewīse	Categoría:Mancomunidad de Naciones
Flocc:Līþ	Categoría:Bebidas alcohólicas
Flocc:Spearctellas	Categoría:Videoconsolas
Flocc:Englisc scīr	Categoría:Condados de Inglaterra
Flocc:Æþelingas	Categoría:Príncipes
Flocc:Ceasterscīr	Categoría:Cheshire
Flocc:Sūþrige	Categoría:Surrey
Flocc:Defenascīr	Categoría:Devon
Flocc:Se Hlāford þāra Hringa	Categoría:El Señor de los Anillos
Flocc:Rōmāniscu Folclār	Categoría:Mitología romana
Flocc:Beadanfordscīr	Categoría:Bedfordshire
Flocc:Bergan	Categoría:Bayas
Flocc:Bēor	Categoría:Cervezas
Flocc:Sang	Categoría:Canciones
Flocc:Hēafodstōlas	Categoría:Capitales nacionales
Flocc:Byrig on Paraguay	Categoría:Localidades de Paraguay
Flocc:Stōwlice hēafodstōlas Canadan	Categoría:Localidades de Canadá
Flocc:Ēastseaxe	Categoría:Essex
Flocc:Middelasia	Categoría:Asia Central
Flocc:Indisca Underworulddǣl	Categoría:Asia Meridional
Flocc:NFL	Categoría:NFL
Flocc:Tuscania	Categoría:Toscana
Flocc:Latium	Categoría:Lacio
Flocc:Lonceasterscīr	Categoría:Lancashire
Flocc:Hāmtūnescīr	Categoría:Hampshire
Flocc:Brūcend pl	Categoría:Wikipedia:Wikipedistas con conocimientos de polaco
Flocc:Gleawcesterscīr	Categoría:Gloucestershire
Flocc:Rōmānisca sprǣca	Categoría:Lenguas romances
Flocc:Fōr	Categoría:Transporte
Flocc:Sund	Categoría:Natación
Flocc:Hēapplegan	Categoría:Deportes de equipo
Flocc:Toys	Categoría:Juguetes
Flocc:Hīwscipe	Categoría:Familia
Flocc:Cornweall	Categoría:Cornualles
Flocc:Cīna Caseras	Categoría:Emperadores de China
Flocc:Antarctica	Categoría:Antártida
Flocc:Norðamerica	Categoría:América del Norte
Flocc:Sangestre	Categoría:Cantantes
Flocc:Euxinus	Categoría:Mar Negro
Flocc:Meras	Categoría:Lagos
Flocc:Byrig on Virginie	Categoría:Asentamientos de Virginia
Bysen:Country data Weimar Republic	Plantilla:Geodatos República de Weimar
Flocc:Sweartbeorg	Categoría:Montenegro
Flocc:Indisc Gārsecg	Categoría:Océano Índico
Flocc:Wægnas	Categoría:Automoción
Wealhmoru	Daucus carota
Flocc:Byrig on Francum	Categoría:Localidades de Francia
Flocc:Cent	Categoría:Kent
Flocc:Byrig on Fietname	Categoría:Localidades de Vietnam
Flocc:Byrig on þǣm Ucrægnan	Categoría:Localidades de Ucrania
Flocc:Byrig on Eotolwarum	Categoría:Localidades de Italia
Flocc:Beorgas on Brettum	Categoría:Montañas del Reino Unido
Flocc:Scotland	Categoría:Escocia
Flocc:Spēonisc bōccræft	Categoría:Literatura de España
Flocc:Hēafodstōlas in Europe	Categoría:Capitales de Europa
Flocc:Hēafodstōlas in Asie	Categoría:Capitales de Asia
Flocc:Norðerne Īrland	Categoría:Irlanda del Norte
Sadolīeg, Sūþgeorgia	Isla Saddle
Flocc:Nīwesǣlendisc bōccræft	Categoría:Literatura de Nueva Zelanda
Flocc:Īrisc bōccræft	Categoría:Literatura de Irlanda
Bysen:CompactTOC	Plantilla:Índice
Flocc:Geāsparedu līc	Categoría:Momias
Flocc:Byrig on Uermonte	Categoría:Asentamientos de Vermont
Flocc:Byrig on Floridan	Categoría:Asentamientos de Florida
Flocc:Wikipedia tutorial	Categoría:Ayuda:Tutorial
Flocc:Byrig on Illinoise	Categoría:Asentamientos de Illinois
Bysen:Wikia	Plantilla:Wikia
Flocc:World Trade Center	Categoría:World Trade Center
Flocc:Loidis	Categoría:Leeds
Flocc:Australisc Hēafodburg Landscipe	Categoría:Territorio de la Capital Australiana
Flocc:Brūcend de-5	Categoría:Wikipedia:Wikipedistas con nivel profesional de alemán
Bysen:Country data Cænada	Plantilla:Geodatos Canadá
Bysen:Flag	Plantilla:Bandera2
Bysen:Country data Barbados	Plantilla:Geodatos Barbados
Bysen:Country data Empire of Japan	Plantilla:Geodatos Imperio de Japón
Bysen:Country data Martinique	Plantilla:Geodatos Martinica
Bysen:Country data Åland Islands	Plantilla:Geodatos Åland
Bysen:Lang-pl	Plantilla:Lang-pl
Flocc:Flæmingaland	Categoría:Flandes
The Narrative	The Narrative
Flocc:Byrig on Difelinscīre	Categoría:Localidades del Condado de Dublín
Flocc:Ēastengla cyningas	Categoría:Reyes de Estanglia
Flocc:Miercna cyningas	Categoría:Reyes de Mercia
Flocc:Norþhymbra cyningas	Categoría:Reyes de Northumbria
Flocc:Westseaxna cyningas	Categoría:Reyes de Wessex
Trojany (Masovian Voivodship)	Trojany
Flocc:Willelm Shakespeare	Categoría:William Shakespeare
Flocc:Byrig þāra Faroiscan Īegena	Categoría:Localidades de las Islas Feroe
Flocc:Sigelhearwena Cāseras	Categoría:Emperadores de Etiopía
Flocc:Land on Asie	Categoría:Países de Asia
Flocc:Windows gamen	Categoría:Videojuegos para Windows
Flocc:Wicibōceras in þǣm Geānlǣhtum Rīcum American	Categoría:Wikipedia:Wikipedistas de Estados Unidos
Bysen:Lang-ti	Plantilla:Lang-ti
Bysen:Lang-sq	Plantilla:Lang-sq
Bysen:Lang-ro	Plantilla:Lang-ro
Bysen:Lang-es	Plantilla:Lang-es
Bysen:Lang-cy	Plantilla:Lang-cy
Bysen:Lang-bn	Plantilla:Lang-bn
Bysen:ĒastermōnaþGerīmbōc	Plantilla:Abril
Bysen:SēremōnaþGerīmbōc	Plantilla:Junio
Bysen:HrēþmōnaþGerīmbōc	Plantilla:Marzo
Flocc:Westmidlandscīr	Categoría:Midlands Occidentales
Flocc:Wæringscīr	Categoría:Warwickshire
Wikipǣdia:Gecorene gemynddagas/Wēodmōnaþ	Wikipedia:Efemérides/Agosto
Flocc:Seolh	Categoría:Pinnipedia
Flocc:Quebec	Categoría:Quebec
Flocc:Bryttisce ofersǣ landscipas	Categoría:Territorios británicos de ultramar
Flocc:Ostsǣ	Categoría:Mar Báltico
Flocc:Bysen Brūcend Box	Categoría:Wikipedia:Plantillas de wikipedistas
Flocc:Dēaþstīele glīwdrēame clīwene	Categoría:Grupos de death metal
Flocc:Gūþ	Categoría:Guerra
Flocc:Elisabeþyld	Categoría:Época Isabelina
Flocc:Fif Scīr	Categoría:Fife
Flocc:Lēoðlic scātung	Categoría:Patinaje artístico sobre hielo
Bysen:Lang-zh	Plantilla:Lang-zh
Bysen:Lang-mn	Plantilla:Lang-mn
Bysen:Lang-fi	Plantilla:Lang-fi
Bysen:Lang-sv	Plantilla:Lang-sv
Flocc:Frencisc Polynesia	Categoría:Polinesia Francesa
Flocc:Germanisca sprǣca	Categoría:Lenguas germánicas
Flocc:Hāmtūnscīr Scīr, West Virginia	Categoría:Condado de Hampshire (Virginia Occidental)
Flocc:Herefordscīr	Categoría:Herefordshire
Flocc:Rōmānisc stǣr	Categoría:Historia de la ciudad de Roma
Flocc:Īshocig	Categoría:Hockey sobre hielo
Wikipǣdia:Edit conflicts	Ayuda:Conflicto de edición
Flocc:Īrland	Categoría:Isla de Irlanda
Flocc:Constantinopolis	Categoría:Estambul
Wikipǣdia:Page history	Ayuda:Historial
Flocc:Mintan	Categoría:Lamiaceae
Flocc:Lægreceastrescīr	Categoría:Leicestershire
Flocc:Langbeardnaland	Categoría:Lombardía
Wikipǣdia:Snellbred	Ayuda:Referencia rápida
Wikipǣdia:This page is protected	Wikipedia:Esta página está protegida
Wikipǣdia:Show preview	Ayuda:Mostrar previsualización
Wikipǣdia:Sundortácnu	Ayuda:Caracteres especiales
Flocc:Rōm	Categoría:Roma
Flocc:Norþhymbraland	Categoría:Northumberland
Flocc:Rūncræft	Categoría:Runas
Flocc:Roteland	Categoría:Rutland
Flocc:Sancte Elene Īeg, Upstigeīeg and Tristan da Cunha	Categoría:Santa Elena, Ascensión y Tristán de Acuña
Flocc:Hjaltland	Categoría:Islas Shetland
Flocc:Scipu	Categoría:Barcos
Flocc:Scrobbesbyrigscīr	Categoría:Shropshire
Flocc:Byrig on Marianlande	Categoría:Asentamientos de Maryland
Flocc:Byrig on Pennsyluanie	Categoría:Asentamientos de Pensilvania
Flocc:Byrig on Wyominge	Categoría:Asentamientos de Wyoming
Flocc:NHL	Categoría:NHL
Flocc:Byrig on Nīwum Hāmtūnscīre	Categoría:Ciudades de Nuevo Hampshire
Flocc:Byrig on Defenum	Categoría:Localidades de Devon
Flocc:Americanisc fōtball	Categoría:Fútbol americano
Flocc:Stæffordscīr	Categoría:Staffordshire
Flocc:Bermuda	Categoría:Bermudas
Flocc:Bearrucscīr	Categoría:Berkshire
Flocc:Norþgermanisca sprǣca	Categoría:Lenguas nórdicas
Flocc:São Paulo	Categoría:Ciudad de São Paulo
Flocc:Ucrægnisc sprǣc	Categoría:Idioma ucraniano
Flocc:Westgermanisca sprǣca	Categoría:Lenguas germánicas occidentales
Flocc:Byrig on Cent	Categoría:Localidades de Kent
Flocc:Dȳfung	Categoría:Submarinismo
Flocc:Ardmachusscīr	Categoría:Condado de Armagh
Flocc:Wichlawscīr	Categoría:Condado de Wicklow
Flocc:Nīwre Gecȳþnesse bōc	Categoría:Libros del Nuevo Testamento
Flocc:Antrimscīr	Categoría:Condado de Antrim
Flocc:Mageoscīr	Categoría:Condado de Mayo
Flocc:Celtisc sprǣc	Categoría:Lenguas celtas
Flocc:Coritiba Foot Ball Club	Categoría:Coritiba Foot Ball Club
Flocc:Bryttisce Scīre	Categoría:Condados de Reino Unido
Flocc:Landscipas Denemearce	Categoría:Penínsulas de Dinamarca
Flocc:Orcanege	Categoría:Islas Órcadas
Flocc:Byrig on Polum	Categoría:Localidades de Polonia
Flocc:Tūnas on Mageoscīre	Categoría:Localidades del Condado de Mayo
Flocc:Byrig	Categoría:Localidades
Flocc:Englisc sprǣc	Categoría:Idioma anglosajón
Bárbara Paz	Bárbara Paz
Wikipǣdia:Tutorial (External links)	Ayuda:Tutorial (enlaces externos)
Flocc:Personal life	Categoría:Vida personal
Flocc:Byrig on Idahon	Categoría:Asentamientos de Idaho
Flocc:Byrig on Mississippi	Categoría:Asentamientos de Misisipi
Flocc:Byrig on Westvirginie	Categoría:Asentamientos de Virginia Occidental
Flocc:Byrig on Nīwum Eoforwīce	Categoría:Ciudades del estado de Nueva York
Bysen:Year in other calendars	Plantilla:Calendarios del mundo
Flocc:Brūcend en-1	Categoría:Wikipedia:Wikipedistas con nivel básico de inglés
Flocc:Geboren in 1946	Categoría:Nacidos en 1946
Flocc:Brūcend de-1	Categoría:Wikipedia:Wikipedistas con nivel básico de alemán
Flocc:Geboren in 1920	Categoría:Nacidos en 1920
Flocc:Germanisc mægþ	Categoría:Pueblos germánicos
Flocc:Īrisce Scīre	Categoría:Condados de Irlanda
Flocc:Skrælingcynn	Categoría:Amerindios
Hunna Rīce	Imperio huno
Universidade Fundação Mineira de Educação e Cultura	Universidad FUMEC
Bysen:Bo	Plantilla:Bo
Bysen:GēolmōnaþGerīmbōc	Plantilla:Diciembre
Bysen:MǣdmōnaþGerīmbōc	Plantilla:Julio
Wikipǣdia:Gecorene gemynddagas/Sēremōnaþ	Wikipedia:Efemérides/Junio
Wikipǣdia:Gecorene gemynddagas/Æfterra Gēola	Wikipedia:Efemérides/Enero
Wikipǣdia:Gecorene gemynddagas/Hrēþmōnaþ	Wikipedia:Efemérides/Marzo
Wikipǣdia:Gecorene gemynddagas/Þrimilcemōnaþ	Wikipedia:Efemérides/Mayo
Wikipǣdia:Tutorial (Talk pages)	Ayuda:Tutorial (páginas de discusión)
Wikipǣdia:Tutorial (Related site links)	Ayuda:Tutorial (políticas)
Bysen:Start date	Plantilla:Fecha
Wikipǣdia:Inlǽdung 3	Ayuda:Introducción 3
Wikipǣdia:10 þing þe þu nāst ymbe Wicipǣdian	Wikipedia:10 cosas que no sabías de Wikipedia
Bysen:Lang-kw	Plantilla:Lang-kw
Wikipǣdia:Tutorial (Wrap-up and more info)	Ayuda:Tutorial (para terminar)
Wikipǣdia:Tutorial (Registration)	Ayuda:Tutorial (registro)
Wikipǣdia:Ádihtoðes FAQ	Ayuda:Preguntas frecuentes/Edición
Swǣfe	Suabia
Hindberge	Rubus idaeus
Peru (ofet)	Pera
Tirzah	Tirsa (nombre)
Bysen:Syndrigebocstafas	Plantilla:Caracteres especiales
Bysen:Country flagairforce	Plantilla:Banderafuerzaaéreapaís
Lorde	Lorde
Georgius Grantanbrycge Æþeling	Jorge de Cambridge (2013)
Flocc:Wæstmas	Categoría:Cultivos
Yun Hyon-seok	Yun Hyon-seok
Broods	Broods (banda)
Module:Arguments	Módulo:Argumentos
Syndrig:RecentChanges	Especial:CambiosRecientes
Flocc:Byrig on Langbeardum	Categoría:Localidades de la Lombardía
Flocc:Gestorfen in 1975	Categoría:Fallecidos en 1975
Gōs	Ganso
Tæfl	Hnefatafl
