ܐܦܪܝܩܐ	África
ܝܦܢ	Japón
ܐܡܪܝܩܐ ܬܝܡܢܝܬܐ	América del Sur
ܢܘܪܒܝܓ	Noruega
ܩܘܛܢܝܘܬܐ ܕܐܝܪܠܢܕ	Irlanda
ܡܓܪ	Hungría
ܐܣܦܢܝܐ	España
ܐܘܚܕܢܐ ܡܚܝܕܐ	Estados Unidos
ܒܠܓܝܩܐ	Bélgica
ܠܘܟܣܡܒܘܪܓ	Luxemburgo
ܬܒܝܠ	Universo
ܐܪܥܐ	Tierra
ܡܘܬܐ	Muerte
ܒܪ ܐܢܫܐ	Homo sapiens
ܓܘܪܓ ܘܐܫܝܢܓܛܘܢ	George Washington
ܦܝܢܠܢܕ	Finlandia
ܣܘܝܕ	Suecia
ܕܐܢܡܐܪܩ	Dinamarca
ܦܘܠܢܕ	Polonia
ܠܬܘܢܝܐ	Lituania
ܐܝܛܠܝܐ	Italia
ܣܘܝܣܪܐ	Suiza
ܢܡܣܐ	Austria
ܝܘܢ	Grecia
ܛܘܪܩܝܐ	Turquía
ܦܘܪܛܘܓܠ	Portugal
ܐܘܪܘܦܐ (ܝܒܫܬܐ)	Europa
ܐܣܝܐ (ܝܒܫܬܐ)	Asia
ܐܡܪܝܩܐ ܓܪܒܝܝܬܐ	América del Norte
ܐܢܛܐܪܩܛܝܩܐ	Antártida
ܘܝܩܝܦܕܝܐ	Wikipedia
ܗܘܠܢܕܐ	Países Bajos
ܢܝܘ ܝܘܪܩ (ܡܕܝܢܬܐ)	Nueva York
ܘܐܫܢܓܛܘܢ (ܐܪܫܟܝܬܐ)	Washington D. C.
ܒܪܠܝܢ	Berlín
ܚܫܘܒܐ (ܡܐܟܢܐ)	Computadora
ܒܪܢ	Berna
ܬܣܝܪܝܟ	Zúrich
ܐܢܛܪܢܛ	Internet
ܒܪܐܩ ܐܘܒܐܡܐ	Barack Obama
ܠܘܢܕܘܢ	Londres
ܐܠܟܣܢܕܪܝܐ	Alejandría
ܚܙܘܪܐ	Manzana
ܦܐܪܝܣ	París
ܡܟܣܝܩܘ	México
ܐܘܩܝܢܘܣ ܐܛܠܢܛܝܐ	Océano Atlántico
ܐܘܩܝܢܘܣ ܫܝܢܝܐ	Océano Pacífico
ܒܘܣܛܘܢ	Boston
ܬܪܝܢܒܫܒܐ	Lunes
ܟܢܘܢ ܒ	Enero
ܫܒܛ	Febrero
ܐܕܪ	Marzo
ܟܘܫ	Etiopía
ܢܝܣܢ	Abril
ܐܝܪ	Mayo
ܚܙܝܪܢ	Junio
ܬܡܘܙ	Julio
ܐܒ	Agosto
ܐܝܠܘܠ	Septiembre
ܬܫܪܝܢ ܐ	Octubre
ܬܫܪܝܢ ܒ	Noviembre
ܟܢܘܢ ܐ	Diciembre
ܬܠܬܒܫܒܐ	Martes
ܐܪܒܥܒܫܒܐ	Miércoles
ܚܡܫܒܫܒܐ	Jueves
ܥܪܘܒܬܐ	Viernes
ܫܒܬܐ (ܙܒܢܐ)	Sábado
ܚܕܒܫܒܐ	Domingo
ܐܪܝܐ	Panthera leo
ܦܪܢܣܐ	Francia
ܟܠܒܐ	Canis lupus familiaris
ܡܠܟܘܬܐ ܡܚܝܕܬܐ	Reino Unido
ܩܛܐ	Felis silvestris catus
ܩܘܛܢܝܘܬܐ ܥܡܡܝܬܐ ܕܨܝܢ	República Popular China
ܠܫܢܐ ܦܪܢܣܝܐ	Idioma francés
ܒܪܐܙܝܠ	Brasil
ܪܘܣܝܐ	Rusia
ܝܡܐ	Mar
ܝܡܐ ܐܘܟܡܐ	Mar Negro
Π	Π
ܐܠܒܐܡܐ	Alabama
ܣܐܘ ܦܐܘܠܘ	São Paulo
ܩܝܒܩ (ܗܘܦܪܟܝܐ)	Quebec
ܓܪܡܢ	Alemania
ܒܠܐܪܘܣ	Bielorrusia
ܠܫܢܐ ܓܪܡܢܝܐ	Idioma alemán
ܐܠܗܐ	Dios
ܐܣܛܘܢܝܐ	Estonia
ܛܝܣܬܐ	Avión
ܩܪܒܐ	Guerra
1 (ܡܢܝܢܐ)	Uno
2 (ܡܢܝܢܐ)	Dos
3 (ܡܢܝܢܐ)	Tres
4 (ܡܢܝܢܐ)	Cuatro
5 (ܡܢܝܢܐ)	Cinco
ܠܐܛܒܝܐ	Letonia
ܐܘܩܪܐܝܢܐ	Ucrania
ܬܫܝܟ	República Checa
ܣܠܘܒܩܝܐ	Eslovaquia
ܣܠܘܒܢܝܐ	Eslovenia
ܡܘܠܕܘܒܐ	Moldavia
ܪܘܡܢܝܐ	Rumania
ܒܘܠܓܐܪܝܐ	Bulgaria
ܪܗܘܡܐ (ܡܕܝܢܬܐ)	Roma
ܩܘܛܢܝܘܬܐ ܕܡܩܕܘܢܝܐ	República de Macedonia
ܐܠܒܢܝܐ	Albania
ܩܪܘܐܛܝܐ	Croacia
ܒܘܣܢܐ ܘܗܪܬܣܓܘܒܝܢܐ	Bosnia y Herzegovina
ܐܙܪܒܝܓܐܢ	Azerbaiyán
ܐܢܕܘܪܐ	Andorra
ܩܘܦܪܘܣ	Chipre
ܓܘܪܓܝܐ (ܐܬܪܐ)	Georgia
ܩܙܩܣܛܐܢ	Kazajistán
ܡܝܠܛܐ	Malta
ܡܘܢܐܩܘ	Mónaco
ܛܘܪܐ ܐܘܟܡܐ	Montenegro
ܡܕܝܢܬܐ ܕܘܛܝܩܢ	Ciudad del Vaticano
ܣܢ ܡܪܝܢܘ	San Marino
ܒܪܘܟܣܠ	Región de Bruselas-Capital
ܠܘܕܒܝܓ ܒܐܢ ܒܝܛܗܘܒܢ	Ludwig van Beethoven
ܠܫܢܐ ܛܘܪܩܝܐ	Idioma turco
ܓܙܐܐܪ	Argelia
ܐܘܙܒܩܣܛܐܢ	Uzbekistán
ܘܐܪܣܘ	Varsovia
ܚܡܪܐ (ܫܬܝܐ)	Vino
ܡܝܐ	Agua
ܦܪܣ ܚܙܘܐ	Televisión
ܬܫܝܠܝ	Chile
ܐܠ ܓܪܝܩܘ	El Greco
ܝܫܘܥ	Jesús de Nazaret
ܠܫܢܐ (ܡܡܠܠܐ)	Lenguaje
ܫܘܠܛܢ ܛܪܘܢܘܬܐ	Dictadura
ܡܡܠܠܘܬ ܟܘܟܒܐ	Astronomía
ܡܪܝܡ (ܐܡܗ ܕܝܫܘܥ)	María (madre de Jesús)
ܠܝܟܛܢܫܛܝܢ	Liechtenstein
ܐܕܘܠܦ ܗܝܛܠܪ	Adolf Hitler
ܠܫܢܐ ܠܐܛܝܢܝܐ	Latín
ܒܚܪܝܢ	Baréin
ܐܪܡܢܝܐ	Armenia
ܣܪܒܝܐ	Serbia
ܣܗܪܐ	Luna
ܐܝܣܛܢܒܘܠ (ܡܕܝܢܬܐ)	Estambul
ܐܘܣܛܪܠܝܐ (ܐܬܪܐ)	Australia
ܦܝܣܝܟ	Física
ܩܘܪܐܢ	Corán
ܐܣܠܐܡ	Islam
ܟܡܬܪܐ	Pyrus
ܠܟ ܒܐܘܢܣܐ	Lech Wałęsa
ܫܠܡܐ (ܫܝܢܐ)	Paz
ܚܘܝܕܐ ܐܘܪܘܦܝܐ	Unión Europea
ܐܢܬܬܐ	Mujer
ܛܝܙܐ	Ano
ܫܚܬܐ (ܝܘܠܦܢ ܨܪܘܝܘܬܐ)	Axila
ܗܒܒܐ	Flor
ܝܘܠܦܢ ܨܪܘܝܘܬܐ	Anatomía
ܡܕܝܢܬܐ	Ciudad
ܢܐܦܠܝܘܢ ܒܘܢܐܦܪܛ	Napoleón Bonaparte
ܟܘܟܒܐ	Estrella
ܫܡܫܐ	Sol
ܩܪܝܬܐ	Pueblo (población rural)
ܝܡܐ ܕܡܕܢܚܐ	Mar Báltico
ܘܝܩܝܡܝܕܝܐ ܩܘܡܡܘܢܣ	Wikimedia Commons
ܟܬܒܐ (ܣܦܪܐ)	Libro
ܝܘܡܐ	Día
ܠܠܝܐ	Noche
ܫܢܬܐ (ܙܒܢܐ)	Año
ܕܪܐ	Siglo
ܐܘܣܠܘ	Oslo
ܠܫܒܘܢܐ	Lisboa
ܦܠܝܛܐ	Planeta
ܙܡܪܘܬܐ	Música
ܡܘܣܩܒܐ	Moscú
ܠܫܢܐ ܐܝܛܠܝܐ	Idioma italiano
ܬܫܐܕ	Chad
ܬܝܡܢܐ	Norte
ܢܝܘ ܙܝܠܢܕ	Nueva Zelanda
ܓܪܒܝܐ	Sur
ܗܢܕܘ	India
ܦܪܙܠܐ	Hierro
ܡܥܪܒܐ	Oeste
ܡܕܢܚܐ	Este
ܒܢܙܘܝܠܐ	Venezuela
ܛܠܦܣܢܐ	Ajedrez
ܡܝܢ	Maine
ܣܘܣܝܐ	Equus ferus caballus
ܐܡܣܛܪܕܐܡ	Ámsterdam
ܙܝܢܐ	Arma
ܚܝܘܬܐ	Animalia
ܩܘܠܘܡܒܝܐ	Colombia
ܢܝܘ ܗܐܡܦܫܪ	Nuevo Hampshire
ܠܝܘܢܪܕܘ ܕܗ ܒܢܬܫܝ	Leonardo da Vinci
ܡܐܣܐܬܫܘܣܬܣ	Massachusetts
ܐܘܛܪܝܟܛ (ܗܘܦܪܟܝܐ)	Provincia de Utrecht
ܟܘܢܝܬܝܟܬ	Connecticut
ܐܝܪܐܢ	Irán
ܥܝܪܐܩ	Irak
ܐܠܐܣܟܐ	Alaska
ܐܝܣܪܐܝܠ	Israel
ܐܘܛܪܝܟܛ (ܡܕܝܢܬܐ)	Utrecht
ܝܡܢ	Yemen
ܠܫܢܐ ܦܘܠܢܕܝܐ	Idioma polaco
ܝܘܪܕܢܢ	Jordania
ܩܝܪܓܝܙܣܛܐܢ	Kirguistán
ܐܪܝܙܘܢܐ	Arizona
ܟܘܘܝܬ (ܐܬܪܐ)	Kuwait
ܠܒܢܢ	Líbano
ܐܘܪܝܓܘܢ	Oregón
ܐܡܪܝܩܐ	América
ܝܘܬܐ	Utah
ܥܘܡܐܢ	Omán
ܦܐܩܣܛܐܢ	Pakistán
ܩܛܪ	Catar
ܣܥܘܕܝܐ	Arabia Saudita
ܝܘܣܦ ܣܛܐܠܝܢ	Iósif Stalin
ܣܘܪܝܐ	Siria
ܛܐܓܝܩܣܛܐܢ	Tayikistán
ܦܪܣ ܩܠܐ	Radiocomunicación
ܛܘܪܩܡܢܣܛܐܢ	Turkmenistán
ܐܡܝܪܘܬܐ ܥܪܒܝܬܐ ܡܚܝܕܬܐ	Emiratos Árabes Unidos
ܐܦܓܐܢܣܛܐܢ	Afganistán
ܕܗܒܐ	Oro
ܡܠܝ	Malí
ܦܝܠܝܦܝܢܝܐ	Filipinas
ܩܘܛܢܝܘܬܐ ܕܐܦܪܝܩܐ ܡܨܥܝܬܐ	República Centroafricana
ܐܝܣܚܩ ܢܝܘܛܢ	Isaac Newton
ܫܥܘܬܐ (ܓܘܢܐ)	Amarillo
ܬܘܢܣ (ܐܬܪܐ)	Túnez
ܬܝܡܢܐ ܕܣܘܕܐܢ	Sudán del Sur
ܩܘܛܢܝܘܬܐ ܕܩܘܢܓܘ	República del Congo
ܩܘܛܢܝܘܬܐ ܕܩܘܢܓܘ ܕܝܡܘܩܪܛܝܬܐ	República Democrática del Congo
ܦܐܦܐ ܝܘܚܢܢ ܦܘܠܘܣ ܬܪܝܢܐ	Juan Pablo II
ܛܒܝܠܝܣܝ	Tiflis
ܩܐܡܪܘܢ	Camerún
ܠܘܒܐ	Libia
ܡܘܪܝܛܢܝܐ	Mauritania
ܡܓܪܒ	Marruecos
ܢܝܓܪ	Níger
ܣܘܕܐܢ	Sudán
ܩܫܬܐ ܕܡܪܢ	Arco iris
ܗܐܡܒܘܪܓ	Hamburgo
ܝܡܬܐ ܕܐܘܢܛܪܝܘ	Lago Ontario
ܝܡܬܐ ܕܣܘܦܝܪܝܘܪ	Lago Superior
ܓܐܘܓܪܦܝܐ	Geografía
ܠܒܐ	Corazón
ܡܘܚܐ	Cerebro
ܓܠܕܐ	Piel
ܓܘܢܐ	Color
ܦܪܐܓ	Praga
ܙܪܩܐ	Azul
ܟܣܦܐ (ܣܐܡܐ)	Plata
ܡܫܝܓܢ	Míchigan
ܝܡܬܐ ܕܡܝܫܝܓܢ	Lago Míchigan
ܐܠܝܢܘܝ	Illinois
ܢܘܪܬ ܕܐܟܘܬܐ	Dakota del Norte
ܣܐܘܬ ܕܐܟܘܬܐ	Dakota del Sur
ܡܘܢܬܐܢܐ	Montana
ܘܐܝܘܡܝܢܓ	Wyoming
ܐܘܪܫܠܡ	Jerusalén
ܐܝܕܐܗܘ	Idaho
ܢܝܒܐܕܐ	Nevada
ܐܘܩܝܢܘܣ ܗܢܕܘܝܐ	Océano Índico
ܟܘܠܘܪܐܕܘ	Colorado
ܫܝܩܓܘ	Chicago
ܣܬܘܐ	Invierno
ܬܕܐܐ	Primavera
ܩܝܛܐ	Verano
ܬܫܪܝܬܐ	Otoño
ܨܕܐܡ ܚܘܣܝܢ	Sadam Husein
ܠܫܢܐ ܐܣܦܢܝܐ	Idioma español
ܓܘܓܝ	Araneae
ܐܒܐ (ܦܐܪܐ)	Fruto
ܩܘܦܐ	Mono
ܒܪܓܝܢܝܐ	Virginia
ܝܡܬܐ ܕܝܘܪܘܢ	Lago Hurón
ܢܝܘ ܝܘܪܩ (ܐܘܚܕܢܐ ܡܚܝܕܐ)	Nueva York (estado)
ܪܘܕ ܐܝܠܐܢܕ	Rhode Island
ܪܚܫܐ	Insecta
ܡܐܪܝܠܐܢܕ	Maryland
ܕܝܠܐܘܝܪ	Delaware
ܐܘܗܐܝܘ	Ohio
ܦܢܣܝܠܒܐܢܝܐ	Pensilvania
ܐܝܛܙܢ	Uetersen
ܐܓܘܣܛܘܣ ܩܣܪ	César Augusto
ܢܝܘ ܓܝܪܣܝ	Nueva Jersey
ܐܢܕܝܐܢܐ	Indiana
ܪܕܝܬܐ	Automóvil
ܓܘܪܓܝܐ (ܐܘܚܕܢܐ ܡܚܝܕܐ)	Georgia (Estados Unidos)
ܣܩܠܝܐ	Sicilia
ܣܢ (ܢܗܪܐ)	Río Sena
ܛܘܩܝܘ	Tokio
ܦܪܕܝܢܢܕ ܡܓܝܠܢ	Fernando de Magallanes
ܢܝܘ ܡܝܟܣܝܟܘ	Nuevo México
ܐܬܢܘܣ	Atenas
ܡܢܝܣܘܬܐ	Minnesota
ܒܓܕܐܕ (ܡܕܝܢܬܐ)	Bagdad
ܘܝܣܟܘܢܣܢ	Wisconsin
ܐܝܐܘܐ	Iowa
ܢܝܒܪܐܣܟܐ	Nebraska
ܟܐܢܣܐܣ	Kansas
ܡܝܙܘܪܝ	Misuri
ܐܪܟܢܣܐܣ	Arkansas
ܠܫܢܐ ܕܐܘܪܕܘ	Urdu
ܐܘܟܠܐܗܘܡܐ	Oklahoma
ܝܡܐ ܕܓܪܒܝܐ	Mar del Norte
ܒܝܝܢܐ	Viena
ܩܘܦܢܗܐܓܢ	Copenhague
ܣܛܘܩܗܘܠܡ	Estocolmo
ܗܠܣܢܩܝ	Helsinki
ܕܒܠܢ	Dublín
ܒܪܛܝܣܠܐܒܐ	Bratislava
ܟܬܒܐ ܩܕܝܫܐ	Biblia
ܥܕܬܐ ܫܪܝܪܬܐ ܕܝܫܘܥ	Verdadera Iglesia de Jesús
ܠܫܢܐ ܐܢܓܠܝܐ	Idioma inglés
ܩܘܢܣܦܣܝܘܢ (ܬܫܝܠܝ)	Concepción (Chile)
ܐܘܢܛܐܪܝܘ	Ontario
ܡܐܢܝܛܘܒܐ	Manitoba
ܐܠܒܪܛܐ	Alberta
ܢܘܒܐ ܣܩܘܛܝܐ	Nueva Escocia
ܩܘܢܣܩܘܒܘܠܐ	Końskowola
ܢܝܘ ܒܪܘܢܙܘܝܩ	Nuevo Brunswick
ܩܘܠܘܡܒܝܐ ܒܪܝܛܝܬܐ	Columbia Británica
ܓܙܪܬܐ ܕܐܡܝܪܐ ܐܕܘܐܪܕ	Isla del Príncipe Eduardo
ܣܐܣܩܐܬܫܘܐܢ	Saskatchewan
2012	2012
2011	2011
2010	2010
2009	2009
ܢܝܘܦܐܘܢܕܠܢܕ ܘܠܐܒܪܐܕܘܪ	Terranova y Labrador
2008	2008
ܐܘܚܕܢܐ ܓܪܒܝܝܐ-ܡܥܪܒܝܐ	Territorios del Noroeste
ܝܘܩܘܢ	Yukón
2005	2005
2006	2006
ܢܘܢܐܒܘܛ	Nunavut
2007	2007
ܡܐܟܘܠܬܐ	Alimento
ܚܘܝܐ	Serpentes
ܩܘܪܘܦ	Kurów
ܟܝܡܝܐ	Química
1968	1968
ܩܛܠܥܡܐ ܝܗܘܕܝܐ	Holocausto
ܡܕܪܝܕ (ܡܕܝܢܬܐ)	Madrid
ܣܢܛܝܐܓܘ ܕܐ ܬܫܝܠܝ	Santiago de Chile
ܚܐܪܘܬܐ	Libertad
ܣܝܕܢܝ	Sídney
ܝܪܘܩܐ	Verde
ܡܠܒܘܪܢ	Melbourne
ܣܘܡܩܐ	Rojo
ܢܘܪܐ (ܕܠܩܐ)	Fuego
ܢܝܠܘܣ	Nilo
ܓܙܐܐܪ (ܡܕܝܢܬܐ)	Argel
ܬܘܢܣ (ܡܕܝܢܬܐ)	Túnez (ciudad)
ܛܗܪܐܢ	Teherán
ܐܢܩܪܐ	Ankara
ܢܝܐܡܝ	Niamey
ܒܡܩܘ	Bamako
ܕܪܡܣܘܩ	Damasco
ܥܡܐܢ	Amán
ܒܝܪܘܬ	Beirut
ܒܝܬ ܨܘܒܐ	Universidad
ܒܝܬܐ (ܒܢܝܢܐ)	Casa
ܢܗܪܐ	Río
ܪܝܫܐ ܕܣܒܪܐ ܛܒܐ	Cabo de Buena Esperanza
ܫܘܚܡܠܐ	Inversión
ܩܘܪܝܛܝܒܐ	Curitiba
ܥܒܐ	Bosque
ܩܘܢܦܘܫܝܘܣ	Confucio
ܩܢܐ	Nido
ܐܘܪܘ	Euro
ܝܡܐ ܚܘܪܐ ܡܨܥܝܐ	Mar Mediterráneo
ܓܘܪܓܝܐ	Georgia (desambiguación)
ܡܫܝܚܝܘܬܐ	Cristianismo
ܩܠܒܐ:ܐܘܝܐ	Plantilla:A favor
ܪܘܙܐ	Arroz
ܝܒܫܬܐ	Continente
ܛܝܪܐ	Aves
ܐܪܫܟܝܬܐ	Capital (política)
ܠܫܢܐ ܦܘܪܛܘܓܠܝܐ	Idioma portugués
ܝܪܚܐ	Mes
ܡܘܨܛܦܐ ܟܡܐܠ ܐܛܐܛܘܪܩ	Mustafa Kemal Atatürk
ܐܠܡܐܙܢ	Almazán
ܠܫܢܐ ܝܦܢܝܐ	Idioma japonés
ܦܐܬܐ ܪܝܫܝܬܐ	Wikipedia:Portada
ܦܪܢܣܝܣܩܘ ܓܘܝܐ	Francisco de Goya
ܝܡܐ ܐܚܪܝܐ	Mar Caspio
ܝܡܬܐ ܕܐܝܪܝ	Lago Erie
ܣܠܒܐܕܘܪ ܕܐܠܝ	Salvador Dalí
ܒܢܣܢܬ ܦܢ ܟܘܟ	Vincent van Gogh
ܦܪܝܕܐ ܩܐܠܘ	Frida Kahlo
ܗܢܪܝ ܡܐܛܝܣ	Henri Matisse
ܡܝܟܠܐܢܓܠܘ	Miguel Ángel
ܦܒܠܘ ܦܝܩܐܣܘ	Pablo Picasso
ܪܡܒܪܢܛ	Rembrandt
ܐܢܕܝ ܘܘܪܗܘܠ	Andy Warhol
ܢܝܢܘܐ (ܡܕܝܢܬܐ)	Nínive
ܒܒܠ	Babilonia (ciudad)
ܐܝܪܝܚܘ	Jericó (Cisjordania)
ܩܛܠܘܢܝܐ	Cataluña
ܡܕܪܝܕ (ܗܘܦܪܟܝܐ)	Comunidad de Madrid
ܒܝܬ ܠܚܡ	Belén
ܣܕܪܐ:Candidates for speedy deletion	Categoría:Wikipedia:Borrar (definitivo)
ܪܫܡܠܘܬܐ	Capitalismo
ܐܘܡܬܐ	Nación
ܩܪܬܐܓܘ	Cartago
ܣܕܪܐ:ܐܣܛܪܘܢܘܡܝܐ	Categoría:Astronomía
ܨܚܪܐܐ	Desierto del Sahara
ܫܐܕܐ	Diablo
ܒܝܬ ܟܬܒܐ	Biblioteca
ܫܘܠܛܢܘܬܐ (ܫܘܬܐܣܐ)	Gobierno
ܬܫܝܢ ܫܝ ܗܘܐܢܓ	Qin Shi Huang
ܡܕܢܚܐ ܡܨܥܝܬܐ	Oriente Medio
ܡܠܟܘܬܐ	Monarquía
ܩܘܛܢܝܘܬܐ	República
ܐܬܪܐ	Estado
ܓܒܐ	Partido político
ܝܗܘܕܝܐ	Pueblo judío
ܝܡܡܬܐ ܪܘܪܒܬܐ	Grandes Lagos (América del Norte)
ܐܘܩܝܢܘܣ ܬܝܡܢܝܐ	Océano Antártico
ܐܕܢܐ (ܝܘܠܦܢ ܨܪܘܝܘܬܐ)	Oído
ܢܚܝܪܐ	Nariz
ܥܝܢܐ (ܝܘܠܦܢ ܨܪܘܝܘܬܐ)	Ojo
ܥܘܩܒܪܬܐ	Músculo
ܙܡܝܪܬܐ	Canción
ܓܡܠܐ	Camelus
ܫܘܫܡܢܐ	Formicidae
ܕܒܫܬܐ	Anthophila
ܠܫܢܐ ܗܘܠܢܕܝܐ	Idioma neerlandés
ܐܡܐ (ܒܝܬܝܘܬܐ)	Madre
ܐܒܐ (ܒܝܬܝܘܬܐ)	Padre
1847	1847
ܨܦܪܐ (ܙܒܢܐ)	Mañana
ܩܛܝܢܬܐ	Minuto
ܠܫܢܐ ܪܘܣܝܐ	Idioma ruso
ܩܢܘܢܐ	Derecho
ܠܫܢܐ ܨܝܢܝܐ	Idioma chino
ܕܡܐ	Sangre
ܬܓܪܘܡܬܐ	Esqueleto
ܪܐܬܐ	Pulmones
ܠܫܢܐ ܪܘܡܢܝܐ	Idioma rumano
ܡܛܪܐ	Lluvia
ܢܠܣܘܢ ܡܐܢܕܝܠܐ	Nelson Mandela
ܐܒܢܐ	Roca
ܥܢܢܐ	Nube
ܩܢܘܢܐ ܕܠܥܙܐ	Gramática
ܠܫܢܐ ܓܘܪܓܝܐ	Idioma georgiano
ܝܘܠܦܢ ܡܡܫܚܘܬܐ	Economía
ܙܘܙܐ	Divisa
ܡܕܐܬܐ	Impuesto
ܐܠܦܒܝܬ ܥܪܒܝܐ	Alfabeto árabe
ܐܠܦܒܝܬ ܝܘܢܝܐ	Alfabeto griego
ܐܠܦܒܝܬ ܠܐܛܝܢܝܐ	Alfabeto latino
ܣܕܪܐ:ܦܪܢܣܐ	Categoría:Francia
ܟܢܫܐ	Sociedad
ܓܒܪܐ	Varón
ܙܘܘܓܐ	Matrimonio
ܙܕܩܐ ܕܒܪܢܫܐ	Derechos humanos
ܩܪܒܐ ܓܘܝܐ	Guerra civil
ܓܪܡܐ ܕܣܢܘܢܝܬܐ	Esternón
ܬܪܝܢܐ	Zumo
ܚܠܒܐ (ܕܝܘܒܐ)	Leche
ܛܘܪܐ	Montaña
ܡܕܒܪܐ	Desierto
ܠܫܢܐ ܐܠܒܢܝܐ	Idioma albanés
ܠܫܢܐ ܐܪܡܢܝܐ	Idioma armenio
ܝܘܗܐܢ ܓܘܛܢܒܪܓ	Johannes Gutenberg
ܠܫܢܐ ܣܘܝܕܝܐ	Idioma sueco
ܢܝܩܘܠܐ ܛܣܠܐ	Nikola Tesla
ܡܘܫܐ	Moisés
ܬܕܐ	Mama
ܢܘܗܪܐ (ܚܙܝܬܐ)	Luz
ܠܫܢܐ ܝܘܢܝܐ	Idioma griego
ܠܫܢܐ ܦܪܣܝܐ	Idioma persa
ܬܘܕܝܬܐ	Religión
ܐܒܪܗܡ	Abraham
ܣܦܪܐ ܕܒܪܝܬܐ	Génesis
ܠܫܢܐ ܩܢܛܘܢܝܐ	Cantonés estándar
ܠܫܢܐ ܡܢܕܪܝܢܝܐ	Chino mandarín
ܦܘܠܘܣ ܫܠܝܚܐ	Pablo de Tarso
ܙܝܓܡܘܢܕ ܦܪܘܝܕ	Sigmund Freud
ܙܠܛܐ	Ensalada
ܝܗܘܕܝܘܬܐ	Judaísmo
ܠܫܢܐ ܥܒܪܝܐ	Idioma hebreo
ܟܒܕܐ	Hígado
ܛܚܠܐ	Bazo
ܟܘܠܝܬܐ	Riñón
ܫܠܦܘܚܬܐ	Vejiga urinaria
ܐܫܟܐ	Testículo
ܐܘܩܝܢܘܣ	Océano
ܒܘܕܗܐ	Buda Gautama
ܡܘܚܡܕ	Mahoma
ܟܪܣܐ	Abdomen
ܚܒܠܐ ܟܘܒܝܐ	Médula espinal
ܘܪܝܕܐ	Vena
ܡܪܒܥܐ	Útero
ܠܫܢܐ (ܗܕܡܐ)	Lengua (anatomía)
ܓܝܕܐ	Nervio
ܨܘܪܐ (ܝܘܠܦܢ ܨܪܘܝܘܬܐ)	Cuello
ܦܘܡܐ	Boca
ܓܓܪܬܐ	Laringe
ܡܥܝܐ	Intestino
ܫܪܝܬܐ	Articulación (anatomía)
ܚܕܝܐ	Tórax
ܬܝܪܬܐ	Glándula
ܚܠܒܐ (ܝܘܠܦܢ ܨܪܘܝܘܬܐ)	Diafragma (anatomía)
ܫܪܝܢܐ	Arteria
A	A
B	B
ܢܘܛܦܬܐ	Semen
G	G
U	U
Z	Z
F	F
J	J
ܐܠܦܒܝܬ	Alfabeto
T	T
C	C
R	R
D	D
Α	Α
Ω	Ω
I	I
Μ	Μ
E	E
H	H
ܗܐܪܠܡ (ܗܘܠܢܕܐ)	Haarlem
K	K
L	L
M	M
N	N
O	O
Q	Q
S	S
V	V
W	W
X	X
Y	Y
ܐܢܫܟܕܐ	Enschede
ܗܢܓܠܘ	Hengelo
Φ	Φ
ܝܘܢܐ	Columbidae
ܐܝܠܢܐ	Árbol
Λ	Λ
ܓܒܬܐ	Queso
ܥܢܒܬܐ	Uva
ܕܒܫܐ	Miel
ܒܣܪܐ	Carne
ܫܟܪ	Azúcar
ܣܦܪܙܒܢܐ	Prensa escrita
ܙܥܘܩܐ	Teléfono
ܡܪܕܘܬܐ	Cultura
ܡܥܝܐ ܥܒܝܐ	Intestino grueso
ܡܥܝܐ ܩܛܝܢܐ	Intestino delgado
ܣܘܪܓܕܐ ܝܘܠܝܝܐ	Calendario juliano
ܐܣܝܘܬܐ	Medicina
ܡܠܚܐ (ܐܨܪܐ)	Sal
ܣܕܪܐ:ܒܪܐܙܝܠ	Categoría:Brasil
ܙܘܝܬܐ (ܡܚܪܘܬܐ)	Ángulo
ܬܘܩܦܐ	Energía
ܣܦܝܢܬܐ	Buque
ܩܠܐ (ܨܘܬܐ)	Sonido
ܙܓܘܓܝܬܐ	Vidrio
ܫܛܝܚܘܬܐ	Área
ܡܢܝܢܐ	Número
ܪܦܦܐ	Segundo
ܣܥܪܬܐ	Hordeum vulgare
ܘܘܗܐܢ	Wuhan
ܡܟܬܒܢܘܬܐ ܕܐܬܪܘܬܐ	Anexo:Países
ܒܝܬ ܢܗܪܝܢ	Mesopotamia
ܕܒܐ	Ursidae
ܬܠܗܝܐ	Cáncer
ܚܛܬܐ	Triticum
ܣܘܪܓܕܐ	Calendario
ܟܘܪܗܢܐ	Enfermedad
ܣܘܪܓܕܐ ܓܪܝܓܘܪܝܐ	Calendario gregoriano
ܟܦܣܐ	Menstruación
ܥܡܐ ܩܪܕܘܝܐ	Pueblo kurdo
ܓܫܪܐ	Puente
ܡܓܕܠܐ (ܒܢܝܢܐ)	Torre
ܐܡܪܝܩܐ ܠܐܛܝܢܝܬܐ	América Latina
ܟܗܪܒܐ	Electricidad
ܡܙܝܥܢܐ ܕܩܝܕܐ ܓܘܝܐ	Motor de combustión interna
ܣܝܦܐ (ܙܝܢܐ)	Espada
ܫܡܥܘܢ ܩܢܢܝܐ	Simón el Zelote
ܩܪܩܦܬܐ	Cráneo
ܓܘܡܠܐ!	Joomla
ܐܦܫܬܐ	Pasa
ܠܫܢܐ ܕܗܣܝܐܢܓ	Chino xiang
ܠܫܢܐ ܥܪܒܝܐ	Idioma árabe
ܠܫܢܐ ܐܦܪܝܩܐܢܝܐ	Afrikáans
Β	Β
Γ	Γ
Δ	Δ
Ε	Ε
Ζ	Ζ
Η	Η
Θ	Θ
Ι	Ι
Κ	Κ
Ν	Nu (Alfabeto Griego)
Ξ	Ξ
Ο	Ο
Ρ	Ρ
Σ	Σ
Τ	Τ
Υ	Υ
Χ	Χ
Ψ	Ψ
ܐܬܐ	Bandera
ܟܪܦܬܐ	Mobiliario
ܟܘܪܣܝܐ	Silla
ܣܦܬܐ	Labio
ܦܣܡܐ	Bigote
ܥܩܠܐ	Pie
1000000000 (ܡܢܝܢܐ)	Millardo
ܓܪܡܐ ܕܨܕܥܐ	Hueso temporal
ܩܠܝܕܐ (ܓܪܡܐ)	Clavícula
ܟܬܦܐ	Hombro
ܦܟܐ ܬܚܬܝܐ	Mandíbula
ܩܠܒܐ:Link FA	Plantilla:Destacado
ܥܠܡܐ (ܐܪܥܐ)	Mundo
ܘܝܩܝܦܕܝܐ:ܬܪܥܐ ܕܟܢܫܐ	Wikipedia:Café
ܒܝܪܡܘܢܬ	Vermont
ܩܘܣܛܢܛܝܢܘܦܘܠܝܣ	Constantinopla
ܒܝܬ ܟܪܝܗܐ	Hospital
ܥܕܬܐ	Iglesia (edificio)
ܕܝܬܝܩܝ ܚܕܬܐ	Nuevo Testamento
9 (ܡܢܝܢܐ)	Nueve
1002	1002
ܦܘܕܘܠܣܟ	Podolsk
ܦܐܦܐ	Papa
5	5
4	4
ܢܝܒܐ	Diente canino
3	3
2	2
ܒܝܬ ܥܬܩܐ ܕܠܘܒܪ	Museo del Louvre
ܓܒܐ ܕܚܐܪܘܬܐ ܕܦܘܐܪܛܘ ܪܝܩܘ	Partido Independentista Puertorriqueño
6	6
ܕܝܬܝܩܝ ܥܬܝܩܬܐ	Antiguo Testamento
ܥܐܕܐ ܕܒܝܬ ܝܠܕܐ	Navidad
ܠܫܢܐ ܪܘܡܐܢܣܝܐ	Lenguas romances
ܡܬܠܬܐ	Triángulo
ܫܢܬܐ ܟܒܝܫܬܐ	Año bisiesto
ܡܘܥܡܪ ܐܠܩܕܐܦܝ	Muamar el Gadafi
ب	ب
ܥܐܕܐ ܕܩܝܡܬܐ	Pascua
ܢܝܘ ܝܘܪܩ	Nueva York (desambiguación)
ܢܦܛܐ	Petróleo
ܣܐܘܢܐ	Zapato
ܒܝܬ ܥܘܪܦܢܐ	Banco
ܟܪܡܐ	Viña
ܐܝܪܠܢܕ (ܓܙܪܬܐ)	Irlanda (isla)
1	1
ܠܘ ܫܘܢ	Lu Xun
10	10
20	20
9	9
7	7
8	8
7 (ܡܢܝܢܐ)	Siete
8 (ܡܢܝܢܐ)	Ocho
12	12
ܡܠܐܐ ܘܬܘܒܐ	Marea
ܫܒܘܥܐ	Semana
ܓܠܝܕܐ	Hielo
ܨܠܘܬܐ ܡܪܢܝܬܐ	Padre nuestro
ܝܡܬܐ	Lago
ܝܡܐ ܣܘܡܩܐ	Mar Rojo
13	13
ܩܛܘܬܐ (ܝܥܝܬܐ)	Cucumis sativus
ܓܙܪܬܐ	Isla
ܚܘܪܐ	Blanco (color)
ܐܘܟܡܐ	Negro (color)
6 (ܡܢܝܢܐ)	Seis
ܠܫܢܐ ܪܘܫܡܝܐ	Idioma oficial
11	11
15	15
14	14
17	17
ܣܦܪ ܡܠܐ	Diccionario
18	18
19	19
16	16
21	21
ܦܠܣܛܝܢ	Palestina (región)
10 (ܡܢܝܢܐ)	Diez
ܡܣܘܪܩܐ (ܡܐܢܐ)	Peine
ܠܝܠܐ ܕܘܢܤ	Lila Downs
ܝܡܐ ܕܡܠܚܐ	Mar Muerto
ܫܘܚܠܦܐ ܕܫܢܬܐ	Estaciones del año
ܠܝܒܪܦܘܠ	Liverpool
ܩܘܦܬܐ (ܛܝܪܐ)	Strigiformes
ܫܥܬܐ	Hora
ܢܐܘܝ ܕܘܪ ܟܪܘܠܣܟܝ	Nowy Dwór Królewski
ܐܪܙܦܬܐ	Martillo
ܝܘܢܫܘܦܝܢ	Jönköping
ܥܘܠܐ ܚܝܐ	Feto
ܐܠܦܒܝܬ ܐܪܡܝܐ	Alfabeto arameo
ܐܣܝܐ ܡܥܪܒܝܬܐ	Asia Occidental
ܙܡܪܐ	Canto
ܫܓܠܐ	Rayuela (juego)
ܡܙܬܐ	Pelo
ܠܫܢܐ ܐܪܡܝܐ	Lenguas arameas
ܨܦܪܐ (ܛܝܪܐ)	Passeridae
ܐܦܣܩܘܦܐ	Obispo
ܨܝܢ (ܐܪܥܐ)	China (región)
ܓܒܐ ܕܝܡܘܩܪܛܝܐ (ܐܘܚܕܢܐ ܡܚܝܕܐ)	Partido Demócrata (Estados Unidos)
ܒܝܐܛܪܝܟܣ ܕܒܝܬ ܗܘܠܢܕܝܐ	Beatriz de los Países Bajos
ܡܠܟܘܬܐ ܕܗܘܠܢܕܐ	Reino de los Países Bajos
ܐܒܪܝܠ ܠܐܒܝܢ	Avril Lavigne
ܪܝܫ ܩܘܛܢܝܘܬܐ	Presidente
ܐܪܒܝܐ	Arabia
ܡܪܩܘܣ ܐܘܢܓܠܣܛܐ	Marcos el Evangelista
ܥܘܠܐ	Embrión
ܠܫܢܐ ܕܗܟܐ	Chino hakka
ܫܘܫܡܢܝܬܐ (ܝܥܝܬܐ)	Elettaria cardamomum
ܠܫܢܐ ܕܓܐܢ	Chino gan
ܒܝܬ ܥܬܩܐ	Museo
ܐܠܦܒܝܬ ܥܒܪܝܐ	Alfabeto hebreo
ܠܫܢܐ ܣܘܪܝܝܐ	Idioma siríaco
ܒܪܩܐ	Rayo
ܐܝܕܐ	Mano
ܫܡܥܘܢ ܟܐܦܐ	Simón Pedro
ܬܠ ܐܒܝܒ	Tel Aviv
ܒܐܠܦܐܪܐܝܣܘ	Valparaíso
ܠܫܢܐ ܫܝܡܝܐ	Lenguas semíticas
ܚܘܣܢܝ ܡܘܒܐܪܟ	Hosni Mubarak
ܘܐܟܐܩܐ	Oaxaca
ܚܐܘܬܐ	Mantequilla
ܐܘܢܓܠܝܘܢ	Evangelio
ܠܫܢܐ ܕܘܘ	Chino wu
ܪܘܛܪܕܐܡ	Róterdam
ܩܪܛܐ	Creta
ܐܘܪܚܐ	Carretera
ܩܘܪܨܐ ܚܠܝܨܐ	Disco compacto
ܨܒܥܐ	Dedo
ܦܪܬ	Éufrates
ܩܝܘܛܘ	Kioto
ܥܣܪܐ ܦܘܩܕܢܐ	Diez Mandamientos
ܒܪܩܩܐ ܦܪܣܝܐ	Golfo Pérsico
ܚܠܐ (ܕܚܝܚܐ)	Arena
ܘܪܕܐ	Rosa
ܓܙܪܬܐ ܝܒܫܢܝܬܐ	Península
ܐܘܪܝܬܐ	Torá
ܟܘܘܝܬ (ܡܕܝܢܬܐ)	Kuwait (ciudad)
ܡܚܙܝܬܐ	Espejo
ܥܡܐ ܥܪܒܝܐ	Pueblo árabe
ܟܘܬܐ	Ventana
ܠܫܢܐ ܝܘܢܝܐ ܥܬܝܩܐ	Griego antiguo
ܠܫܢܐ ܐܟܕܝܐ	Idioma acadio
ܕܩܠܬ	Tigris
ܐܬܪܘܬܐ ܕܐܬܪܘܬܐ ܡܚܝܕܐ ܕܐܡܪܝܩܐ	Estado de los Estados Unidos
ܡܥܡܘܕܝܬܐ	Bautismo
ܩܘܢܓܘ	Congo
ܐܝܢܛܪܠܝܢܓܘܐ	Interlingua
ܐܘܪܟܐ	Longitud
ܚܠܡܐ	Ensueño
ܠܫܢܐ ܩܪܕܘܝܐ	Idioma kurdo
ܩܡܚܐ	Harina
ܕܢ ܗܐܟ	La Haya
ܠܫܢܐ ܦܘܢܝܩܝܐ	Idioma fenicio
ܣܝܢܝ (ܓܙܪܬܐ ܝܒܫܢܝܬܐ)	Península del Sinaí
ܟܪܘܙܘܬܐ ܕܝܘܚܢܢ	Evangelio de Juan
ܬܪܥܐ (ܒܒܐ)	Puerta
ܪܝܗܐܢܐ	Rihanna
ܛܦܪܐ	Uña
ܐܦܐ	Cara
ܨܨܐ (ܨܢܥܬܐ)	Clavo (objeto)
ܙܝܬܐ	Olea europaea
ܬܠܝܬܝܘܬܐ	Santísima Trinidad
ܓܠܠܐ	Onda
ܟܬܒܬܐ	Escritura
ܪܘܚܐ ܕܩܘܕܫܐ	Espíritu Santo
100 (ܡܢܝܢܐ)	Cien
ܒܘܪܟܐ	Articulación de la rodilla
ܫܘܩܐ (ܬܐܓܪܘܬܐ)	Mercado
ܠܫܢܐ ܥܪܒܝܐ ܝܗܘܕܝܐ	Judeoárabe
ܒܠܛܝ	Bălți
1000000 (ܡܢܝܢܐ)	Millón
ܛܐܒܐ	Noticia
ܐܫܬܐ (ܐܣܝܘܬܐ)	Fiebre
ܩܫܬܐ ܓܪܒܝܝܬܐ ܕܐܪܥܐ	Hemisferio norte
ܡܡܘܢܐ ܕܡܝܟܪܐ	Microeconomía
ܠܝܕܣ	Leeds
ܥܘܩܒܪܐ	Mus (animal)
ܦܘܪܬܩܠܐ	Naranja (color)
ܒܪܩܩܐ	Bahía
ܒܝܬ ܩܒܘܪܐ	Cementerio
ܐܣܝܐ (ܫܕܬܐ)	Médico
ܡܩܕܘܢܝܐ	Macedonia
ܦܢܛܝܩܘܣܛܝ	Pentecostés
ܫܓܕܬܐ	Prunus dulcis
ܟܪܘܙܘܬܐ ܕܠܘܩܐ	Evangelio de Lucas
ܩܘܢܣܦܣܝܘܢ (ܗܘܦܪܟܝܐ)	Provincia de Concepción (Chile)
ܢܗܪܐ ܕܝܘܪܕܢܢ	Río Jordán
ܣܦܪ ܝܡܐ	Playa
ܐܢܛܐܠܝܐ (ܗܘܦܪܟܝܐ)	Provincia de Antalya
ܦܪܟܣܝܣ ܕܫܠܝܚܐ	Hechos de los Apóstoles
ܥܪܘܒܬܐ ܕܚܫܐ	Viernes Santo
ܚܒܘܫܝܐ	Prisión
ܐܕܢܐ (ܗܘܦܪܟܝܐ)	Provincia de Adana
ܝܘܚܢܢ ܡܥܡܕܢܐ	Juan el Bautista
ܨܠܝܒܐ	Cruz
ܚܙܒܐܠܠܗ	Hezbolá
ܒܝܬ ܓܒܝܢܐ	Frente (anatomía)
ܡܙܡܘܪܐ	Libro de los Salmos
ܐܬܘܪ	Asiria
ܒܢܝܢܐ	Edificio
ܚܠܒ (ܡܕܝܢܬܐ)	Alepo
ܩܫܬܐ ܬܝܡܢܝܬܐ ܕܐܪܥܐ	Hemisferio sur
ܚܠܐ (ܚܡܪܐ)	Vinagre
ܒܝܬ ܕܝܢܐ	Tribunal de justicia
ܚܝܦܐ	Haifa
ܪܡܕܐܢ	Ramadán
ܫܛܪܐ ܬܐܒܝܠܝܐ ܕܓܝܢܝܣ	Libro Guinness de los récords
ܟܘܕܢܝܐ	Mula (animal)
ܒܪܩܩܐ ܕܥܕܢ	Golfo de Adén
ܓܠܝܢܐ ܕܝܘܚܢܢ	Apocalipsis
ܐܫܬܐ (ܝܘܠܦܢ ܨܪܘܝܘܬܐ)	Nalga
ܨܠܘܬܐ ܡܪܝܡܝܬܐ	Avemaría
ܝܩܕܐ	Combustible
ܝܨܝܠܐ	Articulación del codo
ܟܗܢܐ	Sacerdote
ܕܩܢܐ	Barba
ܢܒܝܐ	Profeta
ܐܘܪܟܝܣܛܪܐ	Orquesta
1000 (ܡܢܝܢܐ)	Mil
ܣܘܦܝܐ ܪܘܛܐܪܘ	Sofia Rotaru
ܬܫܢܝܬܐ	Seguro
ܛܘܟܣܐ	Organización
ܣܦܪܓܠܐ	Cydonia oblonga
ܐܢܕܪܐܘܣ ܫܠܝܚܐ	Andrés el Apóstol
ܬܪܥܣܪ ܫܠܝܚܐ	Apóstol
ܢܩܒܬܐ	Hembra
ܕܪܥܐ (ܗܕܡܐ)	Brazo
ܡܬܝ ܡܟܣܐ	Mateo el Evangelista
ܬܐܘܡܐ ܫܠܝܚܐ	Tomás el Apóstol
ܦܝܠܝܦܘܣ ܫܠܝܚܐ	Felipe el Apóstol
ܒܘܪܨܐ (ܗܘܦܪܟܝܐ)	Provincia de Bursa
ܐܝܘܐܢܢܝܣ ܦܘܡܐ ܕܕܗܒܐ	Juan Crisóstomo
ܒܢܝܡܝܢ ܢܬܢܝܗܘ	Benjamín Netanyahu
ܐܪܬܒܝܢ (ܗܘܦܪܟܝܐ)	Provincia de Artvin
ܓܒܝܢܐ	Ceja
ܫܘܪܬܐ	Ombligo
ܐܕܝܐܡܐܢ (ܗܘܦܪܟܝܐ)	Provincia de Adıyaman
ܝܗܘܕܐ ܫܠܝܚܐ	Judas Tadeo
ܒܪܬܘܠܡܝ ܫܠܝܚܐ	Bartolomé el Apóstol
ܝܥܩܘܒ ܒܪ ܙܒܕܝ	Santiago el Mayor
ܝܘܚܢܢ ܫܠܝܚܐ	Juan el Apóstol
ܡܬܝܐ ܫܠܝܚܐ	Matías el Apóstol
ܝܥܩܘܒ ܒܪ ܚܠܦܝ	Santiago el Menor
ܕܟܪܐ	Masculino
ܐܝܓܢܐܛܝܘܣ ܢܘܪܢܐ	Ignacio de Antioquía
ܪܕܝܘܗܕ	Radiohead
ܒܫܐܪ ܐܠܐܣܕ	Bashar al-Asad
ܪܚܝܐ	Molino
ܨܘܡܐ	Ayuno
ܕܝܪܐ	Monasterio
ܠܡܐܢܐ	Puerto
ܡܠܚܐ (ܢܘܛܐ)	Marino
ܐܦܝܘܢ (ܗܘܦܪܟܝܐ)	Provincia de Afyonkarahisar
ܡܝܟܐܝܠ (ܡܠܐܟܐ)	Arcángel Miguel
ܒܝܠܓܝܟ (ܗܘܦܪܟܝܐ)	Provincia de Bilecik
ܒܝܬ ܥܬܩܐ ܕܐܣܪܐܝܠ	Museo de Israel
ܒܐܠܝܟܣܝܪ (ܗܘܦܪܟܝܐ)	Provincia de Balıkesir
ܒܝܬ ܝܠܕܐ	Cumpleaños
ܬܘܠܥܐ	Gusano
ܬܘܩܢ ܓܝܕܝܐ ܩܢܛܪܘܢܝܐ	Sistema nervioso central
ܛܘܪܐ ܕܓܠܝܕܐ	Iceberg
ܢܢܥܐ	Mentha
ܩܠܒܐ:Commonscat	Plantilla:Commonscat
ܒܨܪܐ (ܡܕܝܢܬܐ)	Basora
ܐܓܪܬܐ ܕܠܘܬ ܪܗܘܡܝܐ	Epístola a los romanos
ܬܡܪܐ ܕܥܝܢܐ	Párpado
ܡܪܝ ܓܝܘܪܓܝܣ ܣܗܕܐ	Jorge de Capadocia
ܐܣܘܬܐ ܕܠܐ ܬܚܘܡܐ	Médicos Sin Fronteras
ܐܪܙܐ (ܡܫܝܚܝܘܬܐ)	Sacramento
ܐܓܪܬܐ ܕܠܘܬ ܦܝܠܝܦܣܝܐ	Epístola a los filipenses
ܐܢܛܘܠܝܐ	Anatolia
ܡܫܝܚܐ	Mesías
ܚܫܡܝܬܐ ܐܚܪܝܬܐ	La Última Cena
ܒܢܝ ܐܝܣܪܐܝܠ	Tribus de Israel
ܡܓܘܫܐ ܬܠܬܐ	Reyes Magos
ܝܘܚܢܢ ܕܪܡܣܘܩܝܐ	Juan Damasceno
ܒܒܐ (ܬܪܥܐ)	Verja
ܣܕܪܐ:ܡܠܟܐ	Categoría:Reyes
ܣܕܪܐ:ܪܘܟܒ ܫܘܠܛܢܘܬܐ	Categoría:Formas de estado
ܠܫܢܐ ܕܡܝܢ	Chino min
ܥܘܪܡܫܐ	Contaminación
ܒܒܠ (ܗܘܦܪܟܝܐ)	Gobernación de Babilonia
ܫܘܡܪܐ	Hollín
ܐܫܩܠܘܢ	Ascalón
ܕܘܢܒܐ	Cola
ܩܐܕܣܝܐ (ܗܘܦܪܟܝܐ)	Cadisia
ܡܪܝܡ ܡܓܕܠܝܬܐ	María Magdalena
ܡܪܪܬܐ	Vesícula biliar
ܥܕܬܐ ܟܠܕܝܬܐ ܩܬܘܠܝܩܝܬܐ	Iglesia católica caldea
ܥܕܬܐ ܡܪܘܢܝܬܐ	Iglesia católica maronita
ܡܪܬܐ	Bilis
ܩܘܪܒܢܐ	Eucaristía
ܐܕܡ	Adán
ܐܘܘܫܐ	Cerumen
ܕܡܥܬܐ	Lágrima
ܝܘܗܐܢ ܐܠܙܪ	Georg Elser
ܒܝܢܓܘܠ (ܗܘܦܪܟܝܐ)	Provincia de Bingöl
ܥܡܐ ܐܪܡܢܝܐ	Pueblo armenio
ܐܝܕܝܢ (ܗܘܦܪܟܝܐ)	Provincia de Aydin
ܩܛܠܥܡܐ ܐܪܡܢܝܐ	Genocidio armenio
ܐܡܐܣܝܐ (ܗܘܦܪܟܝܐ)	Provincia de Amasya
ܦܪܝܙܘܢ ܒܪܝܟ	Prison Break
ܐܓܪܝ (ܗܘܦܪܟܝܐ)	Provincia de Ağrı
ܒܘܪܕܘܪ (ܗܘܦܪܟܝܐ)	Provincia de Burdur
ܐܓܪܬܐ ܩܕܡܝܬܐ ܕܠܘܬ ܩܘܪܢܬܝܐ	Primera epístola a los corintios
ܝܗܘܕܐ ܣܟܪܝܘܛܐ	Judas Iscariote
ܐܒܪܐ	Pluma
ܚܪܛܘܡܢܐ	Cicer arietinum
ܐܬܪܘܬܐ ܕܫܐܡ	Levante mediterráneo
ܬܪܘܕܐ	Cuchara
ܓܒܪܐܝܠ (ܡܠܐܟܐ)	Arcángel Gabriel
ܓܪܡܦܝܠܐ	Marfil
ܨܘܪ	Tiro
ܒܘܠܘ (ܗܘܦܪܟܝܐ)	Provincia de Bolu
ܙܢܩܐ	Barbilla
ܨܘܡܐ ܕܐܪܒܥܝܢ	Cuaresma
ܐܓܪܐ ܕܒܢܝܢܐ	Cubierta (construcción)
ܒܝܛܠܝܣ (ܗܘܦܪܟܝܐ)	Provincia de Bitlis
ܓܠܝܠܐ	Galilea
ܪܥܡܐ	Trueno
ܡܘܨܠ	Mosul
ܟܪܬܐ	Dedo pulgar
ܥܡܐ ܛܘܪܩܝܐ	Turcos
ܦܐܦܐ ܫܢܘܕܐ ܬܠܝܬܝܐ	Shenouda III
ܒܝܬ ܓܘܣܐ	Búnker
ܒܝܥܬܐ	Huevo (alimento)
ܒܣܕܝܐ	Almohada
ܙܓܐ (ܢܩܘܫܐ)	Campana (instrumento)
ܫܒܬܐ (ܝܗܘܕܝܘܬܐ)	Sabbat
ܫܡܝܪܡ	Semíramis
ܫܝܓܪܐ	Encía
ܟܪܘܙܘܬܐ ܕܡܪܩܘܣ	Evangelio de Marcos
ܟܟܪܝܬܐ ܕܕܒܫܐ	Panal
ܐܓܪܬܐ ܕܠܘܬ ܩܘܪܢܬܝܐ ܕܬܪܬܝܢ	Segunda epístola a los corintios
ܫܥܘܬܐ (ܡܠܘܐܐ)	Cera
ܛܥܡܐ	Gusto
ܓܢܬ ܫܒܪܐ	Educación preescolar
ܝܡܬܐ ܕܓܠܝܠܐ	Mar de Galilea
ܕܝܘܬܐ	Tinta
ܡܪܝ ܝܘܣܦ	José de Nazaret
ܠܘܩܐ ܐܘܢܓܠܣܛܐ	Lucas el Evangelista
ܐܓܪܬܐ ܕܠܘܬ ܥܒܪܝܐ	Epístola a los hebreos
ܐܓܪܬܐ ܕܠܘܬ ܓܠܛܝܐ	Epístola a los gálatas
ܡܪܝ ܡܝܟܐܝܠ ܪܒܐ	Miguel el Sirio
Ϝ	Ϝ
Ϙ	Ϙ
ܥܛܡܐ	Muslo
ܬܢܢܐ	Humo
ܡܘܚܘܢܐ	Cerebelo
ܐܓܪܬܐ ܕܠܘܬ ܩܘܠܣܝܐ	Epístola a los colosenses
ܐܓܪܬܐ ܕܝܥܩܘܒ	Epístola de Santiago
ܐܓܪܬܐ ܩܕܡܝܬܐ ܕܝܘܚܢܢ	Primera epístola de Juan
ܐܓܪܬܐ ܕܠܘܬ ܦܝܠܡܘܢ	Epístola a Filemón
ܐܓܪܬܐ ܕܠܘܬ ܬܣܠܘܢܝܩܝܐ ܕܬܪܬܝܢ	Segunda epístola a los tesalonicenses
ܐܓܪܬܐ ܩܕܡܝܬܐ ܕܠܘܬ ܬܣܠܘܢܝܩܝܐ	Primera epístola a los tesalonicenses
ܐܓܪܬܐ ܩܕܡܝܬܐ ܕܦܛܪܘܣ	Primera epístola de Pedro
ܐܓܪܬܐ ܕܬܪܬܝܢ ܕܦܛܪܘܣ	Segunda epístola de Pedro
ܐܓܪܬܐ ܩܕܡܝܬܐ ܕܠܘܬ ܛܝܡܬܐܘܣ	Primera epístola a Timoteo
Ϛ	Ϛ
ܡܪܕܝܢ (ܗܘܦܪܟܝܐ)	Provincia de Mardin
ܚܡܨ (ܡܕܝܢܬܐ)	Homs
Ͳ	Ͳ
ܘܐܟܐܩܐ ܕܝ ܟܘܐܪܝܣ	Oaxaca de Juárez
ܐܓܪܬܐ ܕܬܪܬܝܢ ܕܝܘܚܢܢ	Segunda epístola de Juan
ܐܓܪܬܐ ܕܬܠܬ ܕܝܘܚܢܢ	Tercera epístola de Juan
ܐܓܪܬܐ ܕܝܗܘܕܐ	Epístola de Judas
ܐܓܪܬܐ ܕܠܘܬ ܛܝܡܬܐܘܣ ܕܬܪܬܝܢ	Segunda epístola a Timoteo
ܐܓܪܬܐ ܕܠܘܬ ܛܛܘܣ	Epístola a Tito
ܫܝܪܢܐܟ (ܡܕܝܢܬܐ)	Şırnak
Ϻ	San (letra griega)
ܩܠܝܕܐ (ܡܐܢܐ)	Llave
ܥܕܥܐܕܐ	Festival
ܐܪܒܝܠ (ܡܕܝܢܬܐ)	Erbil (ciudad)
ܪܓܠܐ	Pata
ܚܨܐ	Espalda
ܐܠܝܐ ܢܒܝܐ	Elías
ܙܚܘܪܝܬܐ (ܬܘܠܥܬܐ)	Bombyx mori
ܚܘܦܝܐ	Eclipse
ܡܚܛܐ	Aguja (costura)
ܥܠܡܐ ܥܪܒܝܐ	Mundo árabe
ܦܓܘܕܬܐ	Brida (equitación)
ܩܛܡܐ	Ceniza
ܢܘܗܕܪܐ (ܡܕܝܢܬܐ)	Duhok
ܨܒܥܐ ܕܪܓܠܐ	Dedos del pie
ܠܘܚܐ (ܚܫܘܒܬܐ)	Tableta (computadora)
ܪܒܝܬܐ	Usura
ܡܟܝܪܘܬܐ	Esponsales
ܫܘܪܡܐ	Recto
ܐܪܡܝܐ (ܢܒܝܐ)	Jeremías (profeta)
ܬܐܡܐ	Gemelos (biología)
ܬܠܝܦܐ	Pestaña
ܫܥܬܐ ܕܐܪܥܐ	La hora del planeta
ܦܪܡܝܬܐ	Botón (indumentaria)
ܟܘܟܒܐ ܕܕܘܝܕ	Estrella de David
ܡܪܝ ܐܣܛܦܢܘܣ	Esteban (mártir)
ܡܫܡܫܢܐ	Diácono
ܢܓܒ	Néguev
ܟܢܥܢ	Canaán
ܢܘܨܦܐ	Crepúsculo
ܒܝܢܐ	Tamarix
ܬܓܪܝܬ	Tikrit
ܚܠܐ (ܥܦܪܐ)	Polvo
ܬܪܥܐ ܕܕܡܐ	Hemorragia
ܥܪܒܐ ܕܫܡܫܐ	Ocaso
ܐܡܝܫܐ	Pantano
ܡܨܥܝܬܐ (ܨܒܥܐ)	Dedo medio
ز	ز
ܣܒܐ (ܒܝܬܝܘܬܐ)	Abuelo
ܩܘܪܨܠܐ	Tobillo
ܒܪ ܐܝܕܐ	Guante
ܢܫܒܐ ܕܥܝܢܐ	Retina
ܬܘܩܢ ܓܝܕܝܐ ܡܚܕܘܪܝܐ	Sistema nervioso periférico
ܛܝܢܐ	Barro
ܓܓܘܠܬܐ	Calvario
ܗܢܝܢܐ (ܡܡܫܚܘܬܐ)	Interés
ܐܫܘܪ ܒܢܐܦܠ	Asurbanipal
ܓܕܫܐ	Accidente
ܦܛܪܝܪܟܐ	Patriarca
ا	ا
ܚܟܐ	Paladar
ت	ت
ث	ث
ج	ج
ح	ح
خ	خ
د	د
ذ	ذ
ر	ر
ܪܓܫܐ	Sentido (percepción)
س	س
ܟܪܟ ܣܠܘܟ (ܡܕܝܢܬܐ)	Kirkuk
ܒܒܬܐ	Pupila
ܩܒܪܐ	Sepultura
ܠܒܘܢܬܐ	Olíbano
ܚܡܬ (ܡܕܝܢܬܐ)	Hama
ܝܫܛܐ	Esófago
ܟܝܣܐ ܕܐܫܟܐ	Escroto
ܕܒܪܐ	Medio rural
ܚܪܘܫܬܐ	Tráquea
ܓܪܡܐ ܕܥܛܡܐ	Fémur
ܒܪܐ (ܒܝܬܝܘܬܐ)	Hijo
ܫܚܘܪܐ	Carbón vegetal
ܐܘܟܡܐ ܕܥܝܢܐ	Iris
ܫܦܠܘܗܝ ܕܢܝܠܘܣ	Delta del Nilo
ܐܘܪܡܝܐ	Urmía
Ϸ	Ϸ
ܓܙܪܬܐ ܐܝܘܠܝܬܐ	Islas Eolias
ܓܒܐ ܕܒܥܬ	Partido Baaz Árabe Socialista
ܦܩܪܐ	Vértebra
ܒܪ ܩܠܐ	Eco
ܟܝܡܪܐ	Quimera (mitología)
ܠܘܓܡܐ	Maxilar
ܬܝܒܘܬܐ	Penitencia
ܡܛܘܚܬܐ	Dedo índice
ܩܒܠܘܬܐ	Matrona
ܐܪܙܝܪܐ	Sturnidae
ܣܦܪܐ (ܩܢܘܢܝܐ)	Jurista
Ͱ	Heta
ܥܡܐ ܐܪܡܝܐ	Arameos
ܟܢܘܢܬܐ (ܫܪܝܬܐ)	Muñeca (anatomía)
ܐܒܐ (ܐܠܗܐ)	Dios Padre
ܐܢܒܐܪ (ܗܘܦܪܟܝܐ)	Gobernación de Ambar
ܡܪܕܝܢ (ܡܕܝܢܬܐ)	Mardin
ܣܪܛܢܐ	Cáncer (desambiguación)
ܡܘܪܘܢ	Confirmación
ܚܠܡܬܐ	Pezón
ܢܘܠܐ ܕܓܘܓܝ	Telaraña
ܐܫܥܝܐ	Isaías (profeta)
ܒܝܬ ܟܬܒܐ ܐܬܪܝܐ ܕܐܣܪܐܝܠ	Biblioteca Nacional de Israel
ܥܪܫܐ	Diente molar
ܢܝܢܘܐ (ܗܘܦܪܟܝܐ)	Gobernación de Nínive
ܢܘܗܕܪܐ (ܗܘܦܪܟܝܐ)	Gobernación de Duhok
ܘܐܣܛ (ܗܘܦܪܟܝܐ)	Gobernación de Wasit
ܨܠܐܚ ܐܠܕܝܢ (ܗܘܦܪܟܝܐ)	Gobernación de Saladino
ܟܢܘܫܝܐ ܕܠܫܢܐ ܥܒܪܝܐ	Academia del Idioma Hebreo
ܥܘܕ	Laúd árabe
ܒܓܕܐܕ (ܗܘܦܪܟܝܐ)	Gobernación de Bagdad
ܣܪܓܐ	Silla de montar
ܒܨܪܐ (ܨܒܥܐ)	Dedo anular
ܩܛܝܣܦܘܢ	Ctesifonte
ܟܒܘܫܐ	Pesadilla
ܢܓܦ (ܗܘܦܪܟܝܐ)	Gobernación de Nayaf
ܟܪܟ ܣܠܘܟ (ܗܘܦܪܟܝܐ)	Gobernación de Kirkuk
ܕܢܚܐ ܕܫܡܫܐ	Orto
ܬܐܪܬܐ	Conciencia
ܒܨܪܐ (ܗܘܦܪܟܝܐ)	Gobernación de Basora
ܡܫܚܐ ܕܟܪܝܗܐ	Sacramento de la unción de los enfermos
ܦܠܫܬ	Filisteos
ܐܠܥܐ (ܝܘܠܦܢ ܨܪܘܝܘܬܐ)	Costilla
ܥܕܬܐ ܐܝܓܘܦܛܝܬܐ	Iglesia ortodoxa copta
ܐܦܪܝܡ ܣܘܪܝܝܐ	Efrén de Siria
ܪܝܫܘܢ ܠܬܣܝܘܢ	Rishon LeZion
ܟܢܪܐ	Lira (instrumento musical)
ܥܕܬܐ ܕܡܕܢܚܐ ܕܐܬܘܪܝܐ	Iglesia asiria del Oriente
ܬܠܐ ܕܚܕ ܐܝܠܢ	One Tree Hill (serie de televisión)
ܡܘܪܐ	Mirra
ܦܕܪܠܝܐ	Federalismo
ܐܠܝܫܥ	Eliseo
ܗܟܐܪܝ (ܡܕܝܢܬܐ)	Hakkâri
ܣܢܚܪܝܒ	Senaquerib
ܩܘܪܝܐܠܝܣܘܢ	Kyrie Eleison
ܟܢܘܫܝܐ ܕܐܣܪܐܝܠ ܕܝܘܠܦܢܐ ܘܐܢܫܝܬܐ	Academia Israelí de Ciencias y Humanidades
ܣܘܟܢܐ	Timón (dispositivo)
ܥܕܬܐ ܣܘܪܝܝܬܐ ܐܪܬܘܕܟܣܝܬܐ	Iglesia ortodoxa siria
ܟܣܬܐ	Pasto (ganadería)
ܩܡܫܠܝ	Qamishli
ܡܘܬܢܐ (ܗܘܦܪܟܝܐ)	Mutana
ܡܝܫܢ (ܗܘܦܪܟܝܐ)	Mesena
ܣܘܠܝܡܐܢܝܐ (ܗܘܦܪܟܝܐ)	Gobernación de Solimania
ܐܪܒܝܠ (ܗܘܦܪܟܝܐ)	Gobernación de Erbil
ܚܠܒ (ܗܘܦܪܟܝܐ)	Gobernación de Alepo
ܟܪܒܠܐܐ (ܗܘܦܪܟܝܐ)	Gobernación de Kerbala
ܦܪܨܘܦܐ	Persona
ܕܝ ܩܐܪ (ܗܘܦܪܟܝܐ)	Gobernación de Di Car
ܐܢܕܪܢܝܩ ܡܐܪܓܐܪܝܐܢ	Andranik Markarián
ܡܡܠܠܘܬ ܐܠܗܘܬܐ	Teología cristiana
ܓܘܙܐ	Juglandaceae
ܕܝܐܠܐ (ܗܘܦܪܟܝܐ)	Gobernación de Diala
ܟܒܒ	Jabab
ش	ش
ܩܪܫܬܐ	Techo
ص	ص
ض	ض
ظ	ظ
ع	ع
غ	غ
ف	ف
ق	ق
ܚܨܪܐ	Meñique de la mano
ܐܡܬܐ (ܝܘܠܦܢ ܨܪܘܝܘܬܐ)	Antebrazo
ܬܐܘܡܐ	Thomas
ܐܝܒܪܝܐ	Iberia (desambiguación)
ܚܡܬ (ܗܘܦܪܟܝܐ)	Gobernación de Hama
ܟܢܘܢܬܐ ܕܐܝܕܐ	Carpo
ܐܝܣܪܐܝܠ (ܬܘܚܡܐ ܐܚܪܢܐ)	Israel (desambiguación)
ܡܠܐܟܐ	Ángel
ܫܢܬܐ ܦܫܝܛܬܐ	Año común
ܡܣܘܪܩܐ ܕܐܝܕܐ	Metacarpo
ܡܠܟܘܬܐ ܕܒܝܬ ܥܣܪ ܥܝܢܐ	Osroena
ܕܪܥܐ (ܡܕܝܢܬܐ)	Daraa
ܨܕܥܐ	Sien
ܣܘܣܝܐ ܐܝܣܠܢܕܝܐ	Caballo islandés
ܩܠܐ	Nota (sonido)
ܓܪܡܐ	Hueso
ܒܪܝܐܢܝ	Biryani
ܠܒܠܒܬܐ	Úvula
ك	ك
ل	ل
م	م
ن	ن
ه	ه
و	و
ي	ي
ܥܪܒܝܐ	Árabe
ܓܝܕܐ ܕܓܢܫܝܐ	Nervio ciático
ܗܪܗܪܐ	Espejismo
ܚܣܟܗ (ܡܕܝܢܬܐ)	Hasaka
ܛܐܪܩ ܥܙܝܙ	Tarek Aziz
ܡܣܘܪܩܐ ܕܪܓܠܐ	Metatarso
ܥܪܩ	Arak (bebida)
ܫܠܦܐ	Hoja (cuchillo)
ܛܘܪ ܠܒܢܢ	Cordillera del Líbano
ܪܗܘܡܐ	Rum
ܓܐܝܘܣ	Cayo (nombre)
ܩܝܒܩ	Quebec (desambiguación)
ܩܕܠܐ	Nuca
ܥܡܐ ܐܬܘܪܝܐ/ܣܘܪܝܝܐ	Pueblo asirio
ܛܘܪܐ ܕܣܝܢܝ	Monte Sinaí
ܦܘܪܬܥܢܐ	Siphonaptera
ܟܪܘܙܘܬܐ ܕܡܬܝ	Evangelio de Mateo
ܡܕܝܢܬܐ ܡܝܬܬܐ	Aldeas antiguas del norte de Siria
ܐܓܪܬܐ ܕܠܘܬ ܐܦܣܝܐ	Epístola a los Efesios
10000 (ܡܢܝܢܐ)	Diez mil
ܒܢܦܫܐ	Violeta (color)
ܢܨܪܬ	Nazaret
ܥܕܬܐ ܥܬܝܩܬܐ ܕܡܕܢܚܐ	Antigua Iglesia del Oriente
ܟܬܒܐ ܕܡܘܪܡܘܢ	Libro de Mormón
ܐܝܓܢܐܛܝܘܣ ܡܘܫܐ ܩܕܡܝܐ ܕܐܘܕ	Ignacio Moisés I Daoud
ܒܫܐܪܐ ܦܛܪܘܣ ܐܠܪܐܥܝ	Béchara Boutros Raï
ܥܡܢܘܐܝܠ ܬܠܝܬܝܐ ܕܠܝ	Manuel III Delly
ܒܝܬ ܫܥܝܐ	Estadio
ܓܘܕ ܫܪܠܘܛ	Good Charlotte
ܒܪ ܨܘܪܐ	Cuello (indumentaria)
ܚܣܚܘܣܐ	Tejido cartilaginoso
ܛܘܪ ܥܒܕܝܢ	Tur Abdin
ܡܪܝ ܩܘܪܝܩܘܣ ܣܗܕܐ ܘܕܝܘܠܝܛܐ ܝܡܗ	Julita y Quirico
ܐܝܣܛܢܒܘܠ (ܗܘܦܪܟܝܐ)	Provincia de Estambul
ܓܗܢܐ	Gehena
ܐܓܢܛܝܘܣ ܝܘܣܦ ܬܠܝܬܝܐ ܝܘܢܢ	Ignacio José III Younan
ܡܪܝ ܕܢܚܐ ܪܒܝܥܝܐ	Dinkha IV Khanania
ܬܠܫܝܬܐ ܕܩܛܠܐ ܕܐܕܘܠܦ ܗܝܛܠܪ	Atentados contra Hitler
ܬܐܓܘܪܬܐ	Comercio
ܫܝܪܢܐܟ (ܗܘܦܪܟܝܐ)	Provincia de Şırnak
ܥܘܩܣܐ	Aguijón
ܟܗܢܘܬܐ	Sacramento del orden
ܚܒܘܪ	Río Jabur
ܗܕܡܐ ܓܘܝܐ	Órgano (biología)
ܡܥܠܘܠܐ	Malula
ܐܘܪܘܦܐ	Europa (desambiguación)
ܡܕܝܕ	Midyat
ܐܣܝܪܝܣܩܐ	Assyriska FF
ܥܕܬܐ ܣܘܪܝܝܬܐ ܩܬܘܠܝܩܝܬܐ	Iglesia católica siria
ܥܨܘܒܐ	Cirujano
ܐܘܣܛܪܠܝܐ	Australia (desambiguación)
ܡܦܩܬܐ ܦܫܝܛܬܐ	Peshitta
ܐܪܚܘܬܐ	Hospitalidad
ܫܪܓܐ ܕܢܦܛܐ	Candil
ܚܘܐ	Eva
ܗܘܦܪܟܝܣ ܕܥܝܪܐܩ	Gobernaciones de Irak
ܩܛܠܥܡܐ ܐܬܘܪܝܐ	Genocidio asirio
ܒܝܬ ܟܬܒܐ ܕܐܫܘܪ ܒܢܐܦܠ	Biblioteca de Asurbanipal
ܒܕܘܩܐ	Escultismo
ܥܘܕܪܢܐ:ܚܒܝܫܬ̈ܐ	Ayuda:Contenidos
ܓܦܬܐ	Planta de guía
ܡܝܟܐܝܠ	Michael
ܙܒܐ	Río Pequeño Zab
ܣܢܐܓܪܘܬܐ ܕܩܕܝܫܐ	Intercesión
ܐܝܓܢܐܛܝܘܣ ܙܟܝ ܩܕܡܝܐ ܥܝܘܐܨ	Ignacio Zakka I Iwas
ܐܣܛܘܡܟܐ	Estómago
ܟܢܘܢܬܐ ܕܪܓܠܐ	Tarso (anatomía)
ܓܢܬܐ	Jardín
ܕܪܓܘܫܬܐ	Moisés (bebé)
ܒܪܐ (ܐܠܗܐ)	Dios Hijo
ܚܝܠܐ ܠܒܢܝܐ	Fuerzas Libanesas
ܐܘܪܗܝ	Edesa
ܢܩܘܫܐ	Toaca
ܘܝܩܝܦܕܝܐ:ܐܝܙܓܕܘܬܐ	Wikipedia:Embajadas
ܫܠܝܬܐ	Placenta
ܒܝܬ ܛܘܣܐ	Aeropuerto
ܒܝܬ ܫܡܪܝܐ	Samaria
ܐܓܢܣ ܡܘ	Agnes Mónica
ܪܘܦܐܝܠ ܩܕܡܝܐ ܒܝܬ ܕܘܝܕ	Rafael I Bidawid
ܓܝܠܒܪܛܘ ܩܘܢܣܦܣܝܘܢ ܕܗ ܓܪܣܝܐ	Gilberto Concepción de Gracia
ܣܕܪܐ:ܓܪܡܢ	Categoría:Alemania
ܣܕܪܐ:ܐܝܛܠܝܐ	Categoría:Italia
ܣܕܪܐ:ܐܬܪܘܬܐ ܡܚܝܕܐ ܕܐܡܪܝܩܐ	Categoría:Estados Unidos
ܣܕܪܐ:ܪܘܣܝܐ	Categoría:Rusia
ܣܕܪܐ:ܩܢܕܐ	Categoría:Canadá
ܣܕܪܐ:ܐܝܣܪܐܝܠ	Categoría:Israel
ܣܕܪܐ:ܛܘܪܩܝܐ	Categoría:Turquía
ܣܕܪܐ:ܡܨܪܝܢ	Categoría:Egipto
ܣܕܪܐ:ܐܝܪܐܢ	Categoría:Irán
ܕܝܪܐ ܕܡܪܝ ܓܒܪܐܝܠ	Monasterio de Mor Gabriel
ܥܐܕܐ	Día festivo
ܣܕܪܐ:ܥܝܪܐܩ	Categoría:Irak
ܣܕܪܐ:ܗܘܠܢܕܐ	Categoría:Países Bajos
ܣܕܪܐ:ܦܘܠܢܕ	Categoría:Polonia
ܣܕܪܐ:ܛܝܪܐ	Categoría:Aves
ܣܕܪܐ:ܝܥܝܬܐ	Categoría:Plantae
ܣܕܪܐ:ܬܘܕܝܬܐ	Categoría:Religión
ܣܕܪܐ:ܝܕܥܬܐ	Categoría:Ciencia
ܩܘܠ ܬܘܪܗ	Kol Tora
ܦܪܡܬܐ ܕܣܡܠܐ	Masacre de Simele
ܨܘܒܐ	Nísibis
ܕܪܥܐ (ܗܘܦܪܟܝܐ)	Gobernación de Dar'a
ܢܩܘܕ	Niqud
ܡܪܝܡ (ܚܬܗ ܕܡܘܫܐ)	Míriam (hermana de Moisés)
ܣܕܪܐ:ܬܘܚܡܐ ܐܚܪܢܐ	Categoría:Wikipedia:Desambiguación
ܣܕܪܐ:ܡܫܝܚܝܘܬܐ	Categoría:Cristianismo
ܣܕܪܐ:ܐܣܠܐܡ	Categoría:Islam
ܣܕܪܐ:ܝܗܘܕܝܘܬܐ	Categoría:Judaísmo
ܠܩܐ ܕܣܦܝܢܬܐ	Remo (instrumento)
ܚܪܒܘܩܬܐ	Ojal
ܫܡܥܘܢ ܒܪܨܒܥܐ	Simeón Bar Sabas
ܙܚܘܪܝܬܐ (ܓܘܢܐ)	Escarlata (color)
ܐܢܩܪܐ (ܗܘܦܪܟܝܐ)	Provincia de Ankara
ܐܝܪܠܢܕ	Irlanda (desambiguación)
ܝܘܢܢ	Jonás (profeta)
ܐܨܪܐ	Condimento
ܕܝܪܝܟ	Al Malikiya
ܡܪܩܩܐ	Hipocondrio
ܥܝܒܐ	Nimbus
ܫܘܫܡܬܐ	Sesamum indicum
ܣܕܪܐ:ܘܝܩܝܦܕܝܐ	Categoría:Categorías
ܣܕܪܐ:ܝܒܫܬܐ	Categoría:Continentes
ܒܓܕܝܕܐ	Bajdida
ܝܙܦܬܐ	Deuda (Antropología)
ܟܠܕܝܐ	Cristianos caldeos
ܦܨܝܕܐ	Estanque
ܐܪܓܘܢܐ	Púrpura
ܢܘܪܢܝܐ	Pirámide (geometría)
ܘܝܩܝܦܕܝܐ:HotCat	Wikipedia:HotCat
ܒܛܐ	Pato
ܚܘܝܕܐ ܬܒܝܠܝܐ ܐܬܘܪܝܐ	Alianza Asiria Universal
ܗܝܟܠܐ ܕܫܠܝܡܘܢ	Templo de Jerusalén
ܠܘܝܣ ܪܘܦܐܝܠ ܩܕܡܝܐ ܣܟܘ	Luis Rafael I Sako
ܩܠܒܐ:ܓܕܫܐ ܗܫܝܐ	Plantilla:Portada:Actualidad
ܣܕܪܐ:ܡܟܬܒܢܘܬܐ ܕܐܬܪܘܬܐ	Categoría:Países
ܘܝܩܝܦܕܝܐ:ܡܕܒܪܢܐ	Wikipedia:Bibliotecarios
ܣܕܪܐ:ܫܕܬܐ	Categoría:Ocupaciones
ܘܝܩܝܦܕܝܐ:ܒܘܬ̈ܐ	Wikipedia:Bot
ܣܕܪܐ:ܙܒܢܐ	Categoría:Tiempo
ܣܕܪܐ:ܙܘܙܐ	Categoría:Dinero
ܣܕܪܐ:ܝܘܠܦܢ ܨܪܘܝܘܬܐ	Categoría:Anatomía
ܣܕܪܐ:ܐܣܝܘܬܐ	Categoría:Medicina
ܡܨܪܝܢ	Egipto
ܩܠܒܐ:Bot	Plantilla:Bot
ܩܢܕܐ	Canadá
ܣܕܪܐ:ܝܘܢ	Categoría:Grecia
ܣܕܪܐ:ܣܘܝܕ	Categoría:Suecia
ܐܡܪܐ	Cordero
ܩܠܒܐ:ܐܫܛܪܘܬܐ	Plantilla:Documentación
ܣܕܪܐ:User languages	Categoría:Wikipedia:Wikipedistas por idioma
ܦܘܠܚܢܐ	Negocio
ܩܠܒܐ:Softredirect	Plantilla:Redirección suave
ܩܠܒܐ:Delete	Plantilla:Destruir
ܡܓܕܠܐ (ܩܪܝܬܐ)	Magdala
ܣܕܪܐ:ܛܟܢܘܠܘܓܝܐ	Categoría:Tecnología
ܓܒܪܐܝܠ (ܫܡܐ)	Gabriel
ܣܕܪܐ:ܠܫܢܐ	Categoría:Lenguas
ܣܕܪܐ:ܩܢܘܢܐ ܕܠܥܙܐ	Categoría:Gramática
ܘܝܩܝܦܕܝܐ:General disclaimer	Wikipedia:Limitación general de responsabilidad
ܣܕܪܐ:Noindexed pages	Categoría:Wikipedia:Páginas no indexadas
ܘܝܩܝܦܕܝܐ:ܕܘܒܪܐ	Wikipedia:Manual de estilo
ܩܠܒܐ:Navbox	Plantilla:Navegación
ܐܝܓܢܐܛܝܘܣ ܐܦܪܝܡ ܬܪܝܢܐ	Ignacio Aphrem II Karim
ܩܠܒܐ:!	Plantilla:!
ܣܕܪܐ:ܩܠܒܐ ܐܬܘܬܐ ܕܐܝܣܘ	Categoría:Wikipedia:Plantillas de banderas
ܩܠܒܐ:ܡܦܐܬܐ ܩܠܒܐ	Plantilla:Navbar
ܩܠܒܐ:Clear	Plantilla:Clear
ܘܝܩܝܦܕܝܐ:ܡܟܬܒܘܬܐ ܕܡܓܠܐ ܠܟܠ ܘܝܩܝܦܕܝܐ	Wikipedia:Lista de artículos que toda Wikipedia debería tener
ܣܕܪܐ:ܐܠܝܩܛܪܘܢܝܘܬܐ	Categoría:Electrónica
ܣܕܪܐ:ܝܪܚܐ ܕܫܢܬܐ	Categoría:Meses
ܩܠܒܐ:Babel	Plantilla:Babel
ܩܠܒܐ:Commons	Plantilla:Commons
ܩܠܒܐ:Reflist	Plantilla:Listaref
ܩܠܒܐ:See also	Plantilla:VT
ܣܕܪܐ:ܐܣܝܐ	Categoría:Asia
ܣܕܪܐ:ܕܪܐ ܕܥܣܪܝܢ ܘܚܕ	Categoría:Siglo XXI
ܩܠܒܐ:Infobox language/codelist	Plantilla:Doc ISO3
ܣܕܪܐ:ܝܘܡܐ ܕܫܒܘܥܐ	Categoría:Días de la semana
ܣܕܪܐ:ܐܨܪܐ	Categoría:Condimentos
ܩܠܒܐ:ܝܗܘܝܬܐ Peru	Plantilla:Geodatos Perú
ܩܠܒܐ:ܝܗܘܝܬܐ Paraguay	Plantilla:Geodatos Paraguay
ܩܠܒܐ:Edit	Plantilla:Editar
ܩܠܒܐ:ܝܗܘܝܬܐ French Guiana	Plantilla:Geodatos Guyana
ܩܠܒܐ:ܝܗܘܝܬܐ Argentina	Plantilla:Geodatos Argentina
ܩܠܒܐ:ܡܟܬܒܢܘܬܐ ܕܝܦܬܐ	Plantilla:Lista desplegable
ܩܠܒܐ:Sidebar	Plantilla:Navegación vertical
ܩܠܒܐ:Ambox	Plantilla:Metaplantilla de avisos
ܩܠܒܐ:ܐܬܪܐ	Plantilla:Ficha de país
ܩܠܒܐ:/box-header	Plantilla:Box-header
ܣܕܪܐ:User en	Categoría:Wikipedia:Wikipedistas con conocimientos de inglés
ܣܕܪܐ:User zh	Categoría:Wikipedia:Wikipedistas con conocimientos de chino
ܣܕܪܐ:User zh-N	Categoría:Wikipedia:Wikipedistas con nivel nativo de chino
ܩܠܒܐ:ܨܢܕܘܩ ܪܡܙܐ2	Plantilla:Ficha
ܩܠܒܐ:ܐܠܦܒܝܬ ܠܐܛܝܢܝܐ	Plantilla:AZ
ܣܕܪܐ:ܦܐܦܐ	Categoría:Papas
ܣܕܪܐ:ܪܝܫܝ ܩܘܛܢܝܘܬܐ	Categoría:Presidentes
ܩܠܒܐ:IPA	Plantilla:AFI
ܣܕܪܐ:ܗܪܘܡܐ	Categoría:Especias
ܣܕܪܐ:ܦܠܫܬ	Categoría:Palestina
ܣܕܪܐ:ܡܠܐܟܐ	Categoría:Ángeles
ܣܕܪܐ:ܢܒܝܐ	Categoría:Profetas
ܩܠܒܐ:Category redirect	Plantilla:Categoría redirigida
ܩܠܒܐ:ܝܗܘܝܬܐ Venezuela	Plantilla:Geodatos Venezuela
ܩܠܒܐ:ܨܢܕܘܩ ܡܕܒܪܢܐ	Plantilla:Ficha de autoridad
ܩܠܒܐ:Sortname	Plantilla:Sortname
ܩܠܒܐ:Border	Plantilla:Borde
ܩܠܒܐ:ܡܢܝܢܐ ܕܝܪܚܐ	Plantilla:Número mes
ܩܠܒܐ:ܝܗܘܝܬܐ Chile	Plantilla:Geodatos Chile
ܩܠܒܐ:GUA	Plantilla:GTM
ܩܠܒܐ:ܡܣܦܩ ܩܐܫ	Plantilla:Purgar
ܩܠܒܐ:ܨܢܕܘܩ ܐܡܢܐ	Plantilla:Ficha de artista
ܩܠܒܐ:ܡܦܠܚܢܐ	Plantilla:U
ܣܕܪܐ:ܬܘܢܣ	Categoría:Túnez
ܩܠܒܐ:Oppose	Plantilla:En contra
ܩܠܒܐ:COL	Plantilla:COL
ܩܠܒܐ:PER	Plantilla:PER
ܩܠܒܐ:ܨܢܕܘܩ ܡܕܥܐ ܕܝܒܫܬܐ	Plantilla:Ficha de territorio
ܣܕܪܐ:ܡܕܝܢܬܐ ܒܐܘܚܕܢܐ ܡܚܝܕܐ	Categoría:Ciudades de Estados Unidos
ܩܠܒܐ:ܬ.ܐ.	Plantilla:Desambiguación
ܩܠܒܐ:No	Plantilla:No
ܣܕܪܐ:ܩܠܒܐ ܨܢܕܘܩܐ	Categoría:Wikipedia:Fichas
ܩܠܒܐ:ܝܗܘܝܬܐ Colombia	Plantilla:Geodatos Colombia
ܩܠܒܐ:ܐܠܦܒܝܬ ܥܒܪܝܐ	Plantilla:Ficha de alfabeto hebreo
ܣܕܪܐ:User yue	Categoría:Wikipedia:Wikipedistas con conocimientos de Cantonese
ܣܕܪܐ:User az	Categoría:Wikipedia:Wikipedistas con conocimientos de azerí
ܣܕܪܐ:User sk	Categoría:Wikipedia:Wikipedistas con conocimientos de eslovaco
ܣܕܪܐ:User fr	Categoría:Wikipedia:Wikipedistas con conocimientos de francés
ܣܕܪܐ:User ja	Categoría:Wikipedia:Wikipedistas con conocimientos de japonés
ܣܕܪܐ:User la	Categoría:Wikipedia:Wikipedistas con conocimientos de latín
ܣܕܪܐ:User pt	Categoría:Wikipedia:Wikipedistas con conocimientos de portugués
ܣܕܪܐ:User ro	Categoría:Wikipedia:Wikipedistas con conocimientos de rumano
ܣܕܪܐ:User sv	Categoría:Wikipedia:Wikipedistas con conocimientos de sueco
ܣܕܪܐ:User ko-N	Categoría:Wikipedia:Wikipedistas con nivel nativo de coreano
ܣܕܪܐ:ܗܘܦܪܟܝܣ ܕܥܝܪܐܩ	Categoría:Gobernaciones de Irak
ܣܕܪܐ:User ar	Categoría:Wikipedia:Wikipedistas con conocimientos de árabe
ܣܕܪܐ:User arc	Categoría:Wikipedia:Wikipedistas con conocimientos de arameo
ܣܕܪܐ:User da	Categoría:Wikipedia:Wikipedistas con conocimientos de danés
ܣܕܪܐ:User sk-N	Categoría:Wikipedia:Wikipedistas con nivel nativo de eslovaco
ܣܕܪܐ:User de	Categoría:Wikipedia:Wikipedistas con conocimientos de alemán
ܣܕܪܐ:User el	Categoría:Wikipedia:Wikipedistas con conocimientos de griego antiguo
ܣܕܪܐ:User en-N	Categoría:Wikipedia:Wikipedistas con nivel nativo de inglés
ܣܕܪܐ:User es	Categoría:Wikipedia:Wikipedistas con conocimientos de español
ܩܠܒܐ:N/a	Plantilla:No anunciado
ܣܕܪܐ:User hy	Categoría:Wikipedia:Wikipedistas con conocimientos de armenio
ܣܕܪܐ:ܠܫܢܐ ܥܒܪܝܐ	Categoría:Idioma hebreo
ܣܕܪܐ:ܡܕܝܢܬܐ ܒܐܝܣܪܐܝܠ	Categoría:Localidades de Israel
ܣܕܪܐ:User it	Categoría:Wikipedia:Wikipedistas con conocimientos de italiano
ܣܕܪܐ:User ko	Categoría:Wikipedia:Wikipedistas con conocimientos de coreano
ܣܕܪܐ:ܒܬܫܪܝܢ ܐܚܪܝ	Categoría:Noviembre
ܣܕܪܐ:ܝܡܡܐ	Categoría:Mares
ܩܠܒܐ:ܐܠܦܒܝܬ ܝܘܢܝܐ	Plantilla:Letras griegas
ܩܠܒܐ:ܡܢܝܢܐ ܕܡܡܪܐ ܦܪܝܫܐ	Plantilla:DESTACADOS
ܩܠܒܐ:ܣܡܘܩܐ	Plantilla:Rojo
ܩܠܒܐ:ܝܗܘܝܬܐ Brazil	Plantilla:Geodatos Brasil
ܬܪܥܐ:ܬܘܕܝܬܐ	Portal:Religión
ܣܕܪܐ:ܪܝܫܝ ܩܘܛܢܝܘܬܐ ܥܠ ܐܬܪܐ	Categoría:Presidentes por país
ܣܕܪܐ:User ru	Categoría:Wikipedia:Wikipedistas con conocimientos de ruso
ܣܕܪܐ:User ru-3	Categoría:Wikipedia:Wikipedistas con nivel avanzado de ruso
ܣܕܪܐ:User tl	Categoría:Wikipedia:Wikipedistas con conocimientos de tagalo
ܣܕܪܐ:User tr	Categoría:Wikipedia:Wikipedistas con conocimientos de turco
ܣܕܪܐ:ܙܡܪܐ	Categoría:Músicos
ܩܠܒܐ:Lang	Plantilla:Lang
ܣܕܪܐ:ܪܫܘܡܐ	Categoría:Pintores
ܩܠܒܐ:CHI	Plantilla:CHL
ܣܕܪܐ:ܢܝܓܪ	Categoría:Níger
ܣܕܪܐ:ܝܘܠܦܢ ܩܢܘܢܝܐ	Categoría:Jurisprudencia
ܩܠܒܐ:Infobox language/family-color	Plantilla:Ficha de idioma/colores
ܣܕܪܐ:ܣܥܪܐ	Categoría:Peinados
ܣܕܪܐ:ܢܗܪܘܬܐ	Categoría:Ríos
ܣܕܪܐ:User nl	Categoría:Wikipedia:Wikipedistas con conocimientos de neerlandés
ܣܕܪܐ:User no	Categoría:Wikipedia:Wikipedistas con conocimientos de noruego
ܣܕܪܐ:ܣܘܪܝܐ	Categoría:Siria
ܣܕܪܐ:ܕܪܐ ܩܕܡܝܐ	Categoría:Siglo I
ܣܕܪܐ:ܓܙܪܬܐ ܝܒܫܢܝܬܐ	Categoría:Penínsulas
ܣܕܪܐ:ܗܘܦܪܟܝܣ ܕܗܘܠܢܕܐ	Categoría:Provincias de los Países Bajos
ܣܕܪܐ:ܡܢܝܢܐ	Categoría:Números enteros
ܣܕܪܐ:ܡܕܝܢܬܐ ܕܥܝܪܐܩ	Categoría:Localidades de Irak
ܣܕܪܐ:ܥܝܢܐ (ܨܪܘܝܘܬܐ)	Categoría:Ojo
ܣܕܪܐ:ܓܘܪܓܝܐ	Categoría:Georgia
ܣܕܪܐ:ܟܘܘܝܬ	Categoría:Kuwait
ܣܕܪܐ:ܠܒܢܢ	Categoría:Líbano
ܣܕܪܐ:ܪܝܫܝ ܩܘܛܢܝܘܬܐ ܕܐܬܪܘܬܐ ܡܚܝܕܐ ܕܐܡܪܝܩܐ	Categoría:Presidentes de Estados Unidos
ܣܕܪܐ:ܝܘܪܕܢܢ	Categoría:Jordania
ܣܕܪܐ:ܦܐܪܐ	Categoría:Frutas
ܣܕܪܐ:ܝܘܠܦܢ ܟܘܪܗܢܐ	Categoría:Patología
ܣܕܪܐ:ܓܒܐ	Categoría:Partidos políticos
ܣܕܪܐ:ܕܝܬܝܩܝ ܚܕܬܐ	Categoría:Nuevo Testamento
ܣܕܪܐ:ܕܝܬܝܩܝ ܥܬܝܩܬܐ	Categoría:Antiguo Testamento
ܣܕܪܐ:ܐܘܩܝܢܘ	Categoría:Océanos
ܣܕܪܐ:ܓܪܡܐ	Categoría:Sistema esquelético
ܣܕܪܐ:ܗܘܦܪܟܝܣ ܘܐܘܚܕܢܐ ܕܩܢܕܐ	Categoría:Provincias y territorios de Canadá
ܣܕܪܐ:ܚܝܘܬܐ	Categoría:Animales
ܣܕܪܐ:ܛܘܪܐ	Categoría:Cordilleras
ܣܕܪܐ:ܣܘܥܪܢܐ	Categoría:Eventos
ܣܕܪܐ:ܟܘܪܗܢܐ	Categoría:Enfermedades
ܣܕܪܐ:User pl	Categoría:Wikipedia:Wikipedistas con conocimientos de polaco
ܣܕܪܐ:ܩܣܪ	Categoría:Emperadores
ܣܕܪܐ:ܡܕܒܪܐ	Categoría:Desiertos
ܣܕܪܐ:ܝܡܡܬܐ	Categoría:Lagos
ܩܠܒܐ:ܨܢܕܘܩ ܡܚܡܝܬܐ ܡܨܥܝܐ	Plantilla:Ficha de medio de almacenamiento
ܩܠܒܐ:ܨܢܕܘܩ ܪܡܙܐ ܕܠܫܢܐ	Plantilla:Ficha de idioma
ܣܕܪܐ:ܩܛܠܥܡܐ	Categoría:Masacres
ܨܝܢ	China (desambiguación)
ܛܪܘܝܐܢܝ	Trojany
ܫܩܐ	Pierna
ܩܠܒܐ:ܝܗܘܝܬܐ Falkland Islands	Plantilla:Geodatos Islas Malvinas
ܣܕܪܐ:ܦܛܪܝܪܟܘ	Categoría:Patriarcado
ط	ط
ܣܕܪܐ:ܒܝܬ ܟܬܒܐ	Categoría:Bibliotecas
ܣܕܪܐ:ܫܢܬܐ ܥܕܬܢܝܬܐ	Categoría:Año litúrgico
ܣܕܪܐ:ܐܪܙܐ	Categoría:Sacramentos
ܣܕܪܐ:ܒܝܬ ܢܗܪܝܢ	Categoría:Mesopotamia
ܣܕܪܐ:ܕܝܪ̈ܬܐ ܣܘܪ̈ܝܝܬܐ	Categoría:Monasterios ortodoxos siríacos
ܣܕܪܐ:ܓܘܢܐ	Categoría:Color
ܩܠܒܐ:ܝܗܘܝܬܐ South Georgia and the South Sandwich Islands	Plantilla:Geodatos Islas Georgias del Sur y Sandwich del Sur
ܣܕܪܐ:ܦܣܩܐ ܕܝܘܡܐ	Categoría:Partes del día
ܣܕܪܐ:ܛܪܘܢܐ	Categoría:Dictadores
ܝܘܕ	𐤉
ܣܕܪܐ:ܦܛܪܝܪܟܘ ܕܥܕܬܐ ܣܘܪܝܝܬܐ ܐܪܬܘܕܟܣܝܬܐ	Categoría:Patriarcas de Antioquía de los sirios ortodoxos
ܕܒܘܪܐ (ܪܚܫܐ)	Avispa
ܩܠܒܐ:ܣܘܪܓܕܐ ܚܘܫܒܢܐ	Plantilla:Calendarios del mundo
ܣܕܪܐ:ܩܕܝܫܐ	Categoría:Santos
ܩܪܕܐ (ܪܚܫܐ)	Ixodida
ܩܠܒܐ:ܣܝܩܘܡ ܫܘܪܝܐ	Plantilla:Fecha
ܬܪܥܐ:ܐܘܩܝܢܘܣܝܐ	Portal:Oceanía
ܟܘܕܐ	Loquios
ܕܝܠܢܝܐ:ܫܘܚܠܦ̈ܐ ܚܕ̈ܬܐ	Especial:CambiosRecientes
ܘܙܐ	Ganso
