Hĭ-ciŭ	África
Nĭk-buōng	Japón
Nàng Mī-ciŭ	América del Sur
Nò̤-ŭi	Noruega
Ĭng-gáik-làng	Inglaterra
Sŭ-gáik-làng	Escocia
Ŭi-ī-sê̤ṳ	Gales
Báe̤k Ái-ī-làng	Irlanda del Norte
Ái-ī-làng	Irlanda
Hungary	Hungría
Să̤-băng-ngà	España
Mī-guók	Estados Unidos
Bī-lé-sì	Bélgica
Luxembourg	Luxemburgo
Ṳ̄-dêu	Universo
Dê-giù	Tierra
Sĕng-mêng	Vida
Sī	Muerte
Nè̤ng	Homo sapiens
Huăng-hī	Felicidad
George Washington	George Washington
Wikidata	Wikidata
Hŭng-làng	Finlandia
Sôi-diēng	Suecia
Dăng-măk	Dinamarca
Pŏ̤-làng	Polonia
Lithuania	Lituania
É-dâi-lé	Italia
Sô̤i-sê̤ṳ	Suiza
Ó̤-dê-lé	Austria
Hĭ-lé-nà̤	Grecia
Tū-ī-gì	Turquía
Bì-ciū	Cerveza
Può-dò̤-ngà	Portugal
Ĕu-ciŭ	Europa
Ā-ciŭ	Asia
Báe̤k Mī-ciŭ	América del Norte
Nàng-gĭk-ciŭ	Antártida
Wikipedia	Wikipedia
Hò̤-làng	Países Bajos
Ĭng-gĕng	Pene
PHP	PHP
Niū-iók-chê	Nueva York
Washington, D.C.	Washington D. C.
Gô-gĭng-săng	San Francisco (California)
Báik-lìng	Berlín
Los Angeles	Los Ángeles
Diêng-nō̤	Computadora
Sŭ-là̤-sié	Zúrich
Barack Obama	Barack Obama
Uruguay	Uruguay
MediaWiki	MediaWiki
Lùng-dŭng	Londres
Bìng-guō	Manzana
Bă-là̤	París
Mĕ̤k-să̤-gŏ̤	México
Dâi-să̤-iòng	Océano Atlántico
Tái-bìng-iòng	Océano Pacífico
California	California
Boston	Boston
Lā̤-bái-ék	Lunes
Huōi-sĭng	Marte (planeta)
Kenya	Kenia
Ethiopia	Etiopía
Gŭng-ciō (nguòng-siū)	Monarca
Ghana	Ghana
Lā̤-bái-nê	Martes
Lā̤-bái-săng	Miércoles
Lā̤-bái-sé	Jueves
Lā̤-bái-ngô	Viernes
Lā̤-bái-lĕ̤k	Sábado
Lā̤-bái-nĭk	Domingo
Săi (mà-kuŏ dông-ŭk)	Panthera leo
Huák-guók	Francia
Kēng	Canis lupus familiaris
Ĭng-guók	Reino Unido
Mà	Felis silvestris catus
Dṳ̆ng-huà Ìng-mìng Gê̤ṳng-huò-guók	República Popular China
Huák-ngṳ̄	Idioma francés
Wiktionary	Wikcionario
Ngṳ̀	Pisces
Ciū	Bebida alcohólica
Bă-să̤	Brasil
Ngò̤-lò̤-sṳ̆	Rusia
Hāi	Mar
Alabama	Alabama
Wikimedia	Fundación Wikimedia
Jimmy Wales	Jimmy Wales
Dáik-guók	Alemania
Belarus	Bielorrusia
Dáik-ngṳ̄	Idioma alemán
Bĭng-dō̤	Islandia
Estonia	Estonia
Tū-sĭng	Saturno (planeta)
Hĭ-gĭ	Avión
Ciéng-cĕng	Guerra
1	Uno
2	Dos
3	Tres
4	Cuatro
5	Cinco
0	Cero
George W. Bush	George W. Bush
Latvia	Letonia
Ukraine	Ucrania
Ciék-káik	República Checa
Slovakia	Eslovaquia
Slovenia	Eslovenia
Moldova	Moldavia
Romania	Rumania
Bulgaria	Bulgaria
Lò̤-mā	Roma
Macedonia Gê̤ṳng-huò-guók	República de Macedonia
Albania	Albania
Croatia	Croacia
Bosnia gâe̤ng Herzegovina	Bosnia y Herzegovina
Azerbaijan	Azerbaiyán
Andorra	Andorra
Cyprus	Chipre
Georgia (guók-gă)	Georgia
Kazakhstan	Kazajistán
Malta	Malta
Monaco	Mónaco
Montenegro	Montenegro
Vaticano	Ciudad del Vaticano
San Marino	San Marino
Gū-bă	Cuba
Belize	Belice
Barbados	Barbados
Java	Java (lenguaje de programación)
Éng-dô-nà̤-să̤-ā	Indonesia
Tū-ī-gì-ngṳ̄	Idioma turco
Nàng-hĭ	Sudáfrica
Algeria	Argelia
Wiki Dù-cṳ̆-guāng	Wikisource
Uzbekistan	Uzbekistán
Huà-să	Varsovia
Può-dò̤-ciū	Vino
Cūi	Agua
Chà	Madera
Diêng-sê	Televisión
Chile	Chile
Ià-sŭ	Jesús de Nazaret
Galileo Galilei	Galileo Galilei
Cūi-sĭng	Mercurio (planeta)
Lĭk-sṳ̄	Historia
Gĭng-sĭng	Venus (planeta)
Ngṳ̄-ngiòng	Lenguaje
Ái	Amor
Mŭk-sĭng	Júpiter (planeta)
Ngṳ̀ng-ò̤	Vía Láctea
Tiĕng-uòng-sĭng	Urano (planeta)
Hāi-uòng-sĭng	Neptuno (planeta)
Tiĕng-ùng	Astronomía
Sĭng-gă-pŏ̤	Singapur
Kuŏ-hŏk	Ciencia
Mìng-uòng-sĭng	Plutón (planeta enano)
Ciŏng-lài	Futuro
Séng-mū Mā-lé-ā	María (madre de Jesús)
Liechtenstein	Liechtenstein
Adolf Hitler	Adolf Hitler
Dâ̤-nê-ché̤ṳ Sié-gái Dâi-ciéng	Segunda Guerra Mundial
Wiki Gáu-kuŏ-cṳ̆	Wikilibros
Wiki Ngṳ̄-liŏh	Wikiquote
Wiki Dâi-hŏk	Wikiversidad
Cṳ̆ng	Reloj
Ubuntu	Ubuntu
Só-hŏk	Matemáticas
Lá-dĭng-ngṳ̄	Latín
Bahrain	Baréin
Armenia	Armenia
Serbia	Serbia
Nguŏk-giù	Luna
Istanbul	Estambul
Ó̤-ciŭ	Australia
Ŭk-lī	Física
Argentina	Argentina
Peru	Perú
Dièu-siēng Mìng-ciō-ciō-ngiê Ìng-mìng Gê̤ṳng-huò-guók	Corea del Norte
Gāng-puŏ-câi	Camboya
Gū-làng-gĭng	Corán
Kṳ̄ng-lṳ̀ng	Dinosauria
Ĭ-sṳ̆-làng-gáu	Islam
Lì	Pyrus
Lùng-lùng	Rueda
Huò-bìng	Paz
Nṳ̄-gái	Mujer
Gū-chiŏng-kĕ̤ng	Ano
Nìng-mùng	Citrus × limon
Huă	Flor
Napoléon Bonaparte	Napoleón Bonaparte
Sĕng-lī	Fisiología
Hèng-sĭng	Estrella
Nĭk-tàu	Sol
Victor Hugo	Victor Hugo
Dâi-iòng-ciŭ	Oceanía
Tái-iòng-hiê	Sistema Solar
Kĭng	Hidrógeno
Wiki Gê̤ṳng-hiōng	Wikimedia Commons
Cṳ̆	Libro
Nĭk	Día
Dĕ̤ng Timor	Timor Oriental
Màng-buŏ	Noche
Nièng	Año
Ó̤-sṳ̆-lṳ̆k	Oslo
Lī-sṳ̆-buōng	Lisboa
Táng	Carbono
Dâng	Nitrógeno
Iōng	Oxígeno
Giàng-sĭng	Planeta
Kleopatra 7-sié	Cleopatra VII
Ĭng-ngŏk	Música
É-dâi-lé-ngṳ̄	Idioma italiano
Séng Peterburg	San Petersburgo
Chad	Chad
Lé̤ṳ	Aluminio
Sĭng-să̤-làng	Nueva Zelanda
Éng-dô	India
Tuvalu	Tuvalu
Tiék	Hierro
Tonga	Tonga
Samoa	Samoa
Solomon Gùng-dō̤	Islas Salomón
Vanuatu	Vanuatu
Papua New Guinea	Papúa Nueva Guinea
William Shakespeare	William Shakespeare
Palau	Palaos
Nauru	Nauru
Micronesia Lièng-băng	Estados Federados de Micronesia
Iòng (gĭng-sṳ̆k)	Plomo
Marshall Gùng-dō̤	Islas Marshall
Kiribati	Kiribati
Mūng-gū	Mongolia
Fiji	Fiyi
Venezuela	Venezuela
Guók-cié chiông-gì	Ajedrez
Genghis Khan	Gengis Kan
Maine	Maine
Mā	Equus ferus caballus
Ū-ké	Arma
Dông-ŭk	Animalia
Suriname	Surinam
Paraguay	Paraguay
Guyana	Guyana
Ecuador	Ecuador
Colombia	Colombia
Hŭk-gáu	Budismo
Bolivia	Bolivia
Dè̤ng	Cobre
Trinidad gâe̤ng Tobago	Trinidad y Tobago
Sĭk-ŭk	Plantae
Séng Vincent gâe̤ng Grenadines	San Vicente y las Granadinas
New Hampshire	Nuevo Hampshire
Séng Lucia	Santa Lucía
Séng Kitts gâe̤ng Nevis	San Cristóbal y Nieves
Cĭng-kṳ̄ng	Fungi
Jamaica	Jamaica
Grenada	Granada (país)
Massachusetts	Massachusetts
Guatemala	Guatemala
Bahamas	Bahamas
Connecticut	Connecticut
Giĕ	Gallus gallus domesticus
Antigua gâe̤ng Barbuda	Antigua y Barbuda
Hawaii	Hawái
Honduras	Honduras
Dominica	Dominica
Dominica Gê̤ṳng-huò-guók	República Dominicana
Dṳ̆	Sus scrofa domestica
Báe̤k-bĭng-iòng	Océano Ártico
Haiti	Haití
El Salvador	El Salvador
Ĭ-lāng	Irán
Iraq	Irak
Alaska	Alaska
Costa Rica	Costa Rica
Ī-sáik-liĕk	Israel
Panama	Panamá
Yemen	Yemen
Bâng-dŭk	Virus
Pŏ̤-làng-ngṳ̄	Idioma polaco
Jordan	Jordania
Nicaragua	Nicaragua
Florida	Florida
Kyrgyzstan	Kirguistán
Arizona	Arizona
Kuwait	Kuwait
Lō̤-kuŏ	Laos
Lebanon	Líbano
Oregon	Oregón
Maldives	Maldivas
Mī-ciŭ	América
Utah	Utah
Ngù	Bos primigenius taurus
Mā-lài-să̤-ā	Malasia
Miēng-diêng	Birmania
Nepal	Nepal
Oman	Omán
Pakistan	Pakistán
Qatar	Catar
Saudi Ā-lá-báik	Arabia Saudita
Sri Lanka	Sri Lanka
Joseph Stalin	Iósif Stalin
Syria	Siria
Platon	Platón
Tajikistan	Tayikistán
Dṳ̆ng-huà Mìng-guók	República de China
Aristoteles	Aristóteles
Tái-guók	Tailandia
Huōi-chiă	Tren
Turkmenistan	Turkmenistán
Ā-lá-báik Lièng-hăk Dâi-gŭng-guók	Emiratos Árabes Unidos
Băh-gĭng	Platino
Uŏk-nàng	Vietnam
Dâi-hàng Mìng-guók	Corea del Sur
Afghanistan	Afganistán
Gĭng	Oro
Suez Ông-ò̤	Canal de Suez
Bangladesh	Bangladés
Mali	Malí
Sokrates	Sócrates
Angola	Angola
Bhutan	Bután
Ùng-lài	Brunéi
Tanzania	Tanzania
Cūi-ngṳ̀ng	Mercurio (elemento)
Hĭ-lĭ-pĭng	Filipinas
Dṳ̆ng-hĭ Gê̤ṳng-huò-guók	República Centroafricana
Isaac Newton	Isaac Newton
Albert Einstein	Albert Einstein
Uòng-sáik	Amarillo
Togo	Togo
Tunisia	Túnez
Zambia	Zambia
Zimbabwe	Zimbabue
Báe̤k-gĭng	Pekín
Nàng Sudan	Sudán del Sur
Benin	Benín
Botswana	Botsuana
Wiki Sĭng-ùng	Wikinoticias
Burkina Faso	Burkina Faso
Burundi	Burundi
Comoros	Comoras
Congo Gê̤ṳng-huò-guók	República del Congo
Congo Mìng-ciō Gê̤ṳng-huò-guók	República Democrática del Congo
Djibouti	Yibuti
Chiáh-dô̤ Guinea	Guinea Ecuatorial
Eritrea	Eritrea
Gabon	Gabón
Gambia	Gambia
Guinea	Guinea
Guinea-Bissau	Guinea-Bisáu
Côte d'Ivoire	Costa de Marfil
Cameroon	Camerún
Cabo Verde	Cabo Verde
Lesotho	Lesoto
Liberia	Liberia
Libya	Libia
Madagascar	Madagascar
Malawi	Malaui
Mauritania	Mauritania
Mauritius	Mauricio
Morocco	Marruecos
Mozambique	Mozambique
Namibia	Namibia
Niger	Níger
Nigeria	Nigeria
Charles Darwin	Charles Darwin
Uganda	Uganda
Rwanda	Ruanda
Séng Tomé gâe̤ng Príncipe	Santo Tomé y Príncipe
Senegal	Senegal
Seychelles	Seychelles
Carl Linnaeus	Carlos Linneo
Sierra Leone	Sierra Leona
Somalia	Somalia
Julius Caesar	Julio César
Sudan	Sudán
Swaziland	Suazilandia
Kê̤ṳng	Arco iris
Lièng-hăk-guók	Organización de las Naciones Unidas
Dê-cék	Geología
Dê-lī	Geografía
Sĭng-câung	Corazón
Puòi-hŭ	Piel
Ngàng-sáik	Color
Làng-sáik	Azul
Ngṳ̀ng	Plata
Sék	Estaño
Michigan	Míchigan
Illinois	Illinois
North Dakota	Dakota del Norte
South Dakota	Dakota del Sur
Montana	Montana
Wyoming	Wyoming
Idaho	Idaho
Washington	Washington (estado)
Nevada	Nevada
Éng-dô-iòng	Océano Índico
Kosovo	Kosovo
Colorado	Colorado
分類:Hŭng-lôi	Categoría:Índice de categorías
Chicago	Chicago
Dĕ̤ng-tiĕng	Invierno
Chŭng-tiĕng	Primavera
Hâ-tiĕng	Verano
Chiŭ-tiĕng	Otoño
Saddam Hussein	Sadam Husein
Osama bin Laden	Osama bin Laden
Să̤-băng-ngà-ngṳ̄	Idioma español
Philadelphia	Filadelfia
Tĭ-tṳ̆	Araneae
Guō-sĭk	Fruto
Gàu	Mono
Cièng	Dinero
Virginia	Virginia
West Virginia	Virginia Occidental
Huăng-ciĕu	Capsicum annuum
Niū-iók-ciŭ	Nueva York (estado)
Rhode Island	Rhode Island
Kŏng-tṳ̀ng	Insecta
Maryland	Maryland
Delaware	Delaware
Vladimir Lenin	Lenin
Ohio	Ohio
Pennsylvania	Pensilvania
Augustus	César Augusto
Microsoft Windows	Microsoft Windows
New Jersey	Nueva Jersey
Hŭng-làng-ngṳ̄	Idioma finés
Indiana	Indiana
Ké-chiă	Automóvil
Georgia	Georgia (Estados Unidos)
Texas	Texas
North Carolina	Carolina del Norte
South Carolina	Carolina del Sur
Manila	Manila
Dĕ̤ng-gĭng	Tokio
Uòng-lì	Ananas comosus
Mississippi	Misisipi
Tennessee	Tennessee
New Mexico	Nuevo México
Ngà-diēng	Atenas
Minnesota	Minnesota
Baghdad	Bagdad
Wisconsin	Wisconsin
Iowa	Iowa
Nebraska	Nebraska
Kansas	Kansas
Hŏng-giāng	Cigarrillo
Missouri	Misuri
Louisiana	Luisiana
Kentucky	Kentucky
Arkansas	Arkansas
Oklahoma	Oklahoma
Madonna	Madonna
Aceh	Aceh
Séng-gĭng	Biblia
Phnom Penh	Nom Pen
Hù Cé-mìng Chê	Ciudad Ho Chi Minh
Ò̤-nô̤i	Hanói
Cĭng Ià-sŭ Gáu-huôi	Verdadera Iglesia de Jesús
Ĭng-ngṳ̄	Idioma inglés
Màng-gók	Bangkok
Kuala Lumpur	Kuala Lumpur
Bangka Belitung Gùng-dō̤	Bangka-Belitung
Dài-báe̤k	Taipéi
Concepción	Concepción (Chile)
Bengkulu	Bengkulu
Końskowola	Końskowola
Nê-iōng-huá-táng	Dióxido de carbono
Jambi	Jambi (provincia)
Siè	Serpentes
Lampung	Lampung
Guŏng-sók	Velocidad de la luz
Riau	Riau
Nàng Sumatra	Sumatra Meridional
Lò̤-mā Dá̤-guók	Imperio romano
Mì-niōng	Microsoft
Kó-lū-hŭ	Kurów
Huá-hŏk	Química
Sièng-sŏng	Ácido clorhídrico
Ôi-sĭng	Satélite natural
Kă-giù	Fútbol
Să̤ Sumatra	Sumatra Occidental
Mā-dáik-lī	Madrid
Michael Jackson	Michael Jackson
Cê̤ṳ-iù	Libertad
Sék-nà̤	Sídney
Liŏh-sáik	Verde
È̤ng-sáik	Rojo
Huōi	Fuego
Sĭng Nàng Wales	Nueva Gales del Sur
Nile Ò̤	Nilo
Banten	Bantén (provincia)
Dṳ̆ng Jawa	Java Central
Chēng-chiū-sĭng	Cometa
Dĕ̤ng Jawa	Java Oriental
Jakarta	Yakarta
Ăng-kā-lá	Ankara
Să̤ Jawa	Java Occidental
Yogyakarta	Yogyakarta
Dṳ̆ng Kalimantan	Borneo Central
Dĕ̤ng Kalimantan	Kalimantan Oriental
Nàng Kalimantan	Borneo Meridional
Hŏk-hâu	Escuela
Să̤ Kalimantan	Borneo Occidental
Dâi-hŏk	Universidad
Wikipedia:Să-buàng	Wikipedia:Zona de pruebas
Chió	Casa
Dê-dù	Mapa
Ò̤	Río
Osasco	Osasco
Chiĕng-lī-giáng	Telescopio
分類:Dài-uăng lĭk-sṳ̄	Categoría:Historia de Taiwán
Curitiba	Curitiba
Sĕng-lìng	Bosque
分類:Uŏk-nàng lĭk-sṳ̄	Categoría:Historia de Vietnam
Iók-báik-cṳ̆	Libro de Job
Cĭng-ngiòng	Proverbios
Kūng-cṳ̄	Confucio
Hà	Decapoda
分類:Só-hŏk	Categoría:Matemáticas
Bali	Bali
Ĕu-nguòng	Euro
Mī-gĭng	Dólar estadounidense
Dâi-lièu	Dinastía Liao
Hòng-ciŭ	Hangzhou
Gĭ-dók-gáu	Cristianismo
Dĕ̤ng Nusa Tenggara	Islas menores de la Sonda orientales
Să̤ Nusa Tenggara	Islas menores de la Sonda occidentales
Dṳ̆ng Sulawesi	Célebes Central
Gĭng-guók	Dinastía Jin (1115-1234)
Gorontalo	Gorontalo
Báe̤k Sulawesi	Célebes Septentrional
Dĕ̤ng-nàng Sulawesi	Célebes Suroriental
Nàng Sulawesi	Célebes Meridional
Să̤ Sulawesi	Célebes Occidental
Seattle	Seattle
Dêu	Arroz
Maluku	Molucas (provincia)
Báe̤k Maluku	Molucas septentrionales
Papua	Papúa (provincia)
Să̤ Papua	Provincia de Papúa Occidental
Cēu	Aves
Siū-dŭ	Capital (política)
Può-dò̤-ngà-ngṳ̄	Idioma portugués
Nguŏk	Mes
Uòng Hiêng-huàng	Huang Xianfan
Cōng	Diamante
Nĭk-buōng-ngṳ̄	Idioma japonés
Báik-kuŏ-ciòng-cṳ̆	Enciclopedia
Tàu Hiĕk	Wikipedia:Portada
模板:Ô-lī-kó̤	Plantilla:Artículo bueno
Saratov	Sarátov
Làng-giù	Baloncesto
Olympic Ông-dông-huôi	Juegos olímpicos
Diòng-gĕ̤ng	Yangtsé
Che Guevara	Ernesto Guevara
Mò̤ Dĕk-dŭng	Mao Zedong
Să̤-ăng	Xi'an
Lá-sák	Lhasa
Séng-gău	Relación sexual
Ĭng-dô̤	Vagina
Diék-hŏk	Filosofía
分類:Ché̤ṳk-káik chēng-dṳ̀	Categoría:Wikipedia:Borrar (definitivo)
Gáung-kìng	Piano
Dà	Té
Marco Polo	Marco Polo
Hebe Camargo	Hebe Camargo
Gê̤ṳng-sāng-ciō-ngiê	Comunismo
Cṳ̆-buōng-ciō-ngiê	Capitalismo
Guók-gă	País
Mìng-cŭk	Nación
Carthago	Cartago
Uōng-hiĕk liù-lāng-ké	Navegador web
Siù-cūi	Natación
分類:Tiĕng-ùng	Categoría:Astronomía
Hŭk	Buda (concepto)
Lī Bĕk	Li Bai
Dù-cṳ̆-guāng	Biblioteca
Sĕng-tái	Ecología
Céng-dê	Política
Mìng-ciō	Democracia
Cìng-dièu	Dinastía Qin
Nobel Ciōng	Premio Nobel
Cìng Sṳ̄-huòng	Qin Shi Huang
Dṳ̆ng-dĕ̤ng	Oriente Medio
Háng-dièu	Dinastía Han
Làu Băng	Liu Bang
Háng Ū-dá̤	Emperador Wu
Sĕng-ŭk	Ser vivo
Rabindranath Tagore	Rabindranath Tagore
Háng Guŏng-ū-dá̤	Liu Xiu
Gŭng-ciō-cié-dô	Monarquía
Siâ-huôi-ciō-ngiê	Socialismo
Cṳ̆ng-chói	Beso
Nguòng-dièu	Dinastía Yuan
Nazi Dáik-guók	Alemania nazi
Christopher Columbus	Cristóbal Colón
Dâng Huò	Zheng He
Panama Ông-ò̤	Canal de Panamá
Céng-dièu	Dinastía Jin (265-420)
Nàng-bĭng-iòng	Océano Antártico
Uòng-ò̤	Río Amarillo
Ngê	Oído
Pé	Nariz
Mĕ̤k-ciŭ	Ojo
Hŭng-muòng	Culicidae
Săi-ngṳ̀	Selachimorpha
Lŏk-dò̤	Camelus
Mā-ngiê	Formicidae
Sùi-dièu	Dinastía Sui
Hò̤-làng-ngṳ̄	Idioma neerlandés
Sùi Ùng-dá̤	Yang Jian
Să̤-hâ	Imperio tangut
Sóng-dièu	Dinastía Song
Diêu Kuŏng-êng	Song Taizu
Sóng Tái-cŭng	Song Taizong
Sóng Cĭng-cŭng	Song Zhenzong
Sóng Ìng-cŭng	Song Renzong
Sóng Sìng-cŭng	Song Shenzong
Sóng Hŭi-cŭng	Song Huizong
Sóng Gŏ̤-cŭng	Song Gaozong
Sóng Lī-cŭng	Lizong
Ögedei	Ogodei
Güyük	Guyuk Kan
Möngke	Möngke
Kublai	Kublai Kan
Huă-chái	Brassica oleracea var. botrytis
Giò (sĭk-ŭk)	Solanum melongena
Siók	Nieve
Niè-giāng	Niño
Cā-tàu	Mañana
Hŭng-cṳ̆ng	Minuto
Ngò̤-lò̤-sṳ̆-ngṳ̄	Idioma ruso
Huák-lŭk	Derecho
Hièng-huák	Constitución
Háng-ngṳ̄	Idioma chino
Sá̤-bàu	Célula
Háik	Sangre
Hié (ké-guăng)	Pulmones
Romania-ngṳ̄	Idioma rumano
Bulgaria-ngṳ̄	Idioma búlgaro
Ṳ̄	Lluvia
Dê-cīng	Terremoto
Cūi-căi	Inundación
Hāi-lâung	Tsunami
Hùng	Nube
Hŭng-tăi	Ciclón tropical
Hŭng	Viento
Georgia-ngṳ̄	Idioma georgiano
Háng-cê	Sinograma
Dièu-siēng-cê	Hangul
Lá-dĭng cê-mō̤	Alfabeto latino
Ùng-hŏk	Literatura
分類:Ĭng-ngŏk	Categoría:Música
分類:Ùng-hŏk	Categoría:Literatura
È̤ng-làu-máe̤ng	Sueño en el pabellón rojo
Harry Potter	Harry Potter
Chiū-ìng	Masturbación
Siâ-huôi	Sociedad
Gáu-ṳ̆k	Educación
Nàng-gái	Varón
Ìng-guòng	Derechos humanos
Temür	Timur Kan
Gŭng-sê̤ṳ	Militar
Gă-pĭ	Café
Săng	Montaña
Sŏng Dṳ̆ng-săng	Sun Yat-sen
Hiŏng-gē̤ng	Hong Kong
Miami	Miami
Hàng Ciéng	Guerra de Corea
Rinchinbal	Emperador Ningzong de Yuan
Siū-ék	Seúl
Siông-hāi	Shanghái
Ùng-huá Dâi-gáik-mêng	Revolución Cultural
Chĭng-dièu	Dinastía Qing
Uŏk-nàng Ciéng-cĕng	Guerra de Vietnam
Thomas Edison	Thomas Alva Edison
Armenia-ngṳ̄	Idioma armenio
Ukraine-ngṳ̄	Idioma ucraniano
HTML	HTML
Steven Spielberg	Steven Spielberg
Mŏ̤h-ngiòng	Mo Yan
Sôi-diēng-ngṳ̄	Idioma sueco
Dăng-măk-ngṳ̄	Idioma danés
Nò̤-ŭi-ngṳ̄	Idioma noruego
Luxembourg-ngṳ̄	Idioma luxemburgués
Ciék-káik-ngṳ̄	Idioma checo
Karl Marx	Karl Marx
Nĕng-nĕng	Mama
Guŏng	Luz
Hĭ-lé-nà̤-ngṳ̄	Idioma griego
Ái-ī-làng-ngṳ̄	Idioma irlandés
Kié-ngò̤	Spheniscidae
Pŏ̤-sṳ̆-ngṳ̄	Idioma persa
Cŭng-gáu	Religión
Hàng-guók-ngṳ̄	Idioma coreano
Cháung-sié-gé	Génesis
Chók-Ăi-gĭk-gé	Éxodo
Háng-ngṳ̄ Guăng-uâ	Chino mandarín
Uŏk-nàng-ngṳ̄	Idioma vietnamita
Sigmund Freud	Sigmund Freud
Tái-guók-ngṳ̄	Idioma tailandés
Mā-lài-ngṳ̄	Idioma malayo
Mūng-gū-ngṳ̄	Idioma mongol
Bandar Seri Begawan	Bandar Seri Begawan
Hĭ-báik-lài-ngṳ̄	Idioma hebreo
Ŭi-ī-sê̤ṳ-ngṳ̄	Idioma galés
Sŭ-gáik-làng-ngṳ̄	Gaélico escocés
Vientiane	Vientián
Lō̤-cṳ̄	Lao-Tsé
Găng-câung	Hígado
Sṳ̆-mā Chiĕng	Sima Qian
Ciŏ Hĭ	Zhu Xi
Cìng-gāng	Emoción
Dâi-iòng	Océano
Victoria Nṳ̄-uòng	Victoria del Reino Unido
Sék-giă-mèu-nà̤	Buda Gautama
Mŭk-hâng-mĕk-dáik	Mahoma
Hŭ-ngék	Respiración
Ṳ̀-gă	Confucianismo
Bók-lō̤	Abdomen
Dô̤-gáu	Taoísmo
Chói-siĕk	Lengua (anatomía)
Dâiu-gáuk	Cuello
Chói	Boca
Elizabeth 2-sié	Isabel II del Reino Unido
Dòng-dièu	Dinastía Tang
Dòng Tái-cŭng	Li Shimin
Ū Cáik-tiĕng	Wu Zetian
Dòng Hièng-cŭng	Emperador Xuanzong de Tang
Dòng Sé̤ṳk-cŭng	Emperador Suzong
Cê-mō̤	Letra
Mìng-dièu	Dinastía Ming
Ciŏ Nguòng-ciŏng	Zhū Yuánzhāng
Ronald Reagan	Ronald Reagan
Gióng-ùng Huòng-dá̤	Jianwen
Īng-lŏk Huòng-dá̤	Yongle
Hùng-hĭ Huòng-dá̤	Hongxi
Sŏng-dáik Huòng-dá̤	Xuande
Mìng Ĭng-cŭng	Zhu Qizhen
Gīng-tái Huòng-dá̤	Jingtai
Sìng-huá Huòng-dá̤	Chenghua
Hùng-dé Huòng-dá̤	Hongzhi
Céng-dáik Huòng-dá̤	Zhengde
Gă-cêng Huòng-dá̤	Jiajing
Lè̤ng-kéng Huòng-dá̤	Longqing
Uâng-lĭk Huòng-dá̤	Emperador Wanli
Tái-chiŏng Huòng-dá̤	Taichang
Tiĕng-kiē Huòng-dá̤	Tianqi
Sùng-dĭng Huòng-dá̤	Chongzhen
Gĭng Céng-nĭk	Kim Jong-il
Nguòng-só ciŭ-gĭ-biēu	Tabla periódica de los elementos
Chăng-màng	Ceguera
Sá̤-kṳ̄ng	Bacteria
Chéu	Árbol
Può-dò̤	Uva
Huăng-giāng-sṳ̀	Solanum tuberosum
Tòng	Azúcar
Uòng-dâu	Glycine max
Séng-sék	Información
Bó̤-cāi	Prensa escrita
Diêng-uâ	Teléfono
Ùng-huá	Cultura
Huáng-ngṳ̄	Sánscrito
Dâi-diòng	Intestino grueso
Siēu-diòng	Intestino delgado
Ĭ-hŏk	Medicina
Sièng	Sal
Huá-hŏk nguòng-só	Elemento químico
Unix	Unix
Ùi-gì	Go
Káh-dièu-nó̤h	Juguete
Diêng-īng	Película
Gĭng-sṳ̆k	Metal
Kă-dăk-chiă	Bicicleta
Sók-dô	Velocidad
Sì-găng	Tiempo
Cāi	Papel
Só-lâiu	Plástico
Miêng-cék	Área
Gŭng-chióh	Metro
Iù-diĕng-bău	Zea mays
Duâi-măk	Hordeum vulgare
Dĕ̤ng-nàng-ā	Sudeste Asiático
Sīng-iòng	Shenyang
Tṳ̀ng-kéng	Chongqing
Tiĕng-cĭng	Tianjín
Ū-háng	Wuhan
Gū Ăi-gĭk	Antiguo Egipto
Gū Hĭ-lé-nà̤	Antigua Grecia
Hṳ̀ng	Ursidae
Britney Spears	Britney Spears
Ngàng	Cáncer
Măk	Triticum
Cié-sē̤	Sorghum
Pó̤-sióng	Discapacidad
Lĭk-huák	Calendario
Sìng-gĭng-bâng	Enfermedad mental
Gregorius Lĭk-huák	Calendario gregoriano
Tutankhamun	Tutankamón
Nguŏk-gĭng	Menstruación
Mà-chiók	Mahjong
Ông-ò̤	Canal de navegación
Detroit	Detroit
Diòng-siàng	Gran Muralla China
Gĭng-cê-ták	Pirámide (arquitectura)
Osman Dá̤-guók	Imperio otomano
Guók-nô̤i sĕng-sāng cūng-dĭk	Producto interno bruto
Diêng	Electricidad
Ché̤ṳng	Arma de fuego
Lòng-gĭ-ché̤ṳng	Ametralladora
Sáung-buàng	Ábaco
Tāng-káik	Tanque (desambiguación)
Chāu-muòi	Fragaria × ananassa
Liĕk-chiĕ	Litchi chinensis
Ià-cī	Cocos nucifera
Tò̤	Prunus persica
Cáung-ngṳ̄	Idioma chuang
Siŏng-ngṳ̄	Chino xiang
Mì-ngù-ī-ngṳ̄	Idioma uigur
Lâung-gŏ̤	Pastel
Wiki Ŭk-cṳ̄ng	Wikispecies
Nĕng-dáe̤k	Sostén (prenda de vestir)
Ā-lá-báik-ngṳ̄	Idioma árabe
Cūng-lī	Primer ministro
Lù Ū-hièng	Roh Moo-Hyun
Páuk Céng-hĭ	Park Chung-hee
Siĕng-ìng-ciōng	Cactaceae
Siŏh-tàu-lâung	Canto rodado
Iòng-bék	Lápiz
Gă-sĭ	Mobiliario
Dó̤h	Mesa
Ó̤-muòng	Macao
Liòng Cīng-ĭng	Leung Chun-ying
Iē-giāng	Silla
Hù Gīng-dò̤	Hu Jintao
Sĭk Gê̤ṳng-bìng	Xi Jinping
Dòng-gêng-lĕ̤k	Giraffa camelopardalis
Chĭng-dáung	Shenzhen
Guōng-dĕ̤ng	Provincia de Cantón
Guōng-să̤	Guangxi
Sŭ-lièng	Unión Soviética
Kiák-sióng-gĭ	Cámara fotográfica
Kagoshima-gâing	Prefectura de Kagoshima
C ngṳ̄-ngiòng	C (lenguaje de programación)
Kă	Pie
Ciēng	Gekkonidae
Dô-dâing	Lacertilia
Giĕng-tàu	Hombro
Wikipedia:Bō̤-ciéng hō̤ ùng	Wikipedia:Artículos destacados
模板:Link FA	Plantilla:Destacado
Sié-gái	Mundo
Wikipedia:Duâi chéu â	Wikipedia:Café
Busan	Busan
Lèng-huă	Nelumbo nucifera
Vermont	Vermont
Denver	Denver
Guōng-ciŭ	Cantón (China)
Ciōng Gái-sĭk	Chiang Kai-shek
Gŏng Dĕk-mìng	Jiang Zemin
Ŭng Gă-bō̤	Wen Jiabao
Nàng-gĭng	Nankín
Làu Dáik-huà	Andy Lau
Diŏng Hŏk-iū	Jacky Cheung
Báe̤k-gĭng Dâi-hŏk	Universidad de Pekín
Chĭng-huà Dâi-hŏk	Universidad Tsinghua
Ŭ-lū-mŭk-cà̤	Urumchi
Gŏng-sŭ	Jiangsu
Ciék-gŏng	Zhejiang
Dâing Siēu-bìng	Deng Xiaoping
Lò̤-mā Gê̤ṳng-huò-guók	República romana
Să̤-câung	Tíbet
Ciŭ Ŏng-lài	Zhou Enlai
Dṳ̆ng-guók Gê̤ṳng-sāng-dōng	Partido Comunista de China
Dò̤-nēu	Struthio camelus
Kŏng-hĭ Huòng-dá̤	Emperador Kangxi
Dièu-siēng	Corea
Lī Káik-giòng	Li Keqiang
Gŏ̤ Hèng-giông	Gao Xingjian
Ciŏ Ṳ̀ng-gĭ	Zhu Rongji
Lī Bèng	Li Peng
Lòng	Canis lupus
Bìng-iōng	Pionyang
Sĭng-iók Séng-gĭng	Nuevo Testamento
9	Nueve
Kiék	Scorpiones
Gièng-lè̤ng Huòng-dá̤	Emperador Qianlong
Dṳ̆ng-guók Dâi-lṳ̆k	China continental
Háik-lṳ̀ng-gĕ̤ng-sēng	Heilongjiang
Mā Ĭng-gāu	Ma Ying-jeou
Lè̤	Equus africanus asinus
Wikipedia:Cék-liông ô-lī-kó̤ gì ùng-ciŏng	Wikipedia:Artículos buenos
Sé-chiŏng	Sichuan
Gô-iók Séng-gĭng	Antiguo Testamento
Séng-dáng-cáik	Navidad
Săng-gáe̤k-hìng	Triángulo
Muammar Gaddafi	Muamar el Gadafi
Lâu-hū	Panthera tigris
Daejeon	Daejeon
Daegu	Daegu
Sié-cŭng Dĕk-biék Cê̤ṳ-dé-chê	Ciudad de Sejong
Incheon	Incheon
Gyeonggi Dô̤	Gyeonggi
Bô-uăk-cáik	Pascua
Ò̤-báe̤k	Hebei
Bŏk Hĭ-lài	Bo Xilai
GNU Cê̤ṳ-iù Ùng-dáung Hṳ̄-kō̤-céng	Licencia de documentación libre de GNU
Uŏng Cĭng-ôi	Wang Jingwei
Dìng Cūi-biēng	Chen Shui-bian
Dài-uăng	Isla de Taiwán
À̤	Zapato
Ngṳ̀ng-hòng	Banco
Lū Séng	Lu Xun
7	Siete
8	Ocho
Lĕ̤k	Cervidae
Hù	Lago
Sáung-tàu	Allium sativum
Chái-guă	Cucumis sativus
Dō̤	Isla
Băh-sáik	Blanco (color)
Ŭ-sáik	Negro (color)
6	Seis
Moshchena	Moshchena
Huăng-kê	Solanum lycopersicum
George H. W. Bush	George H. W. Bush
Paltoga	Paltoga
Quảng Bình	Quảng Bình
Atlanta	Atlanta
Benito Mussolini	Benito Mussolini
Sṳ̀-diēng	Diccionario
Tàu	Cabeza
Hiê-lìng-dóng	Wellington (Nueva Zelanda)
Dâi Bók-liĕk-diĕng Dō̤	Gran Bretaña
Las Vegas	Las Vegas
10	Diez
Alfred Nobel	Alfred Nobel
Tàu-sĕ̤	Peine
Guòng-lĭk	Poder (sociología)
Mà-hùng-cēu	Strigiformes
Dēng-cṳ̆ng	Hora
Ké-chiông	Meteorología
Đà Nẵng	Đà Nẵng
Káh-chiók	Pica pica
Làng-huă	Orchidaceae
Gă-săk	Blattodea
Ngáuk-ngṳ̀	Crocodilia
Lā-lì	Manis
Nàng-muōi-sĭng	Lampyridae
Holocene	Holoceno
Hāi-báu	Phocidae
Bà̤-bá-cēu	Troglodytes troglodytes
Ciáh-giāng	Passer montanus
Niccolò Cusano Dâi-hŏk	Universidad Nicolás de Cusa
Long An	Long An
Thái Nguyên	Thái Nguyên
Herodotus	Heródoto
Othello	Otelo
Nĭk-buōng-hāi	Mar del Japón
Dĕ̤ng-ā	Asia Oriental
Dĕ̤ng-ĕu	Europa Oriental
Vĩnh Phúc	Vĩnh Phúc
Chĕ̤ng	Allium fistulosum
Liù-giù-guók	Reino de Ryūkyū
Dièu-siēng uòng-dièu	Dinastía Joseon
Gŏ̤-là̤	Goryeo
Dâi-hàng Dá̤-guók	Imperio de Corea
Buŏk-hāi-guók	Balhae
Gŏ̤-gău-là̤	Goguryeo
Bì-bà-dâu-giék	Chiroptera
Báik-cá̤	Baekje
Sĭng-lò̤	Silla (Corea)
Tàu-huók	Pelo
Hàng Hĭ	Han Feizi
Uòng-dá̤	Emperador amarillo
Diéu-ngṳ̀-dài Liĕk-dō̤	Islas Senkaku
Gê̤ṳng-huò-dōng (Mī-guók)	Partido Republicano (Estados Unidos)
Dṳ̆ng-guók	China (región)
Mìng-ciō-dōng (Mī-guók)	Partido Demócrata (Estados Unidos)
Cūi-tiák	Lutra lutra
Sìng-dŭ	Chengdú
Buò-gŭng-ĭng	Taraxacum
Tá	Medusa (animal)
Dâng-ciŭ	Zhengzhou
Cūng-tūng	Presidente
Muāng-ciŭ-guók	Manchukuo
Gù-cŭi	Streptopelia
Só̤h	Cuerda
Dṳ̆ng-guók Guók-mìng-dōng	Kuomintang
Ngâng	Anser cygnoides
Ĕng-gŏ̤	Psittaciformes
Gă-huák	Suma
Dài-uăng-sēng	Provincia de Taiwán
Dŏ̤	Cuchillo
Băng-mā	Cebra
Guók-cié biĕu-cūng cṳ̆-hô̤	ISBN
Đồng Nai	Đồng Nai
Sóc Trăng	Sóc Trăng
Quảng Ngãi	Quảng Ngãi
Hà Tĩnh	Hà Tĩnh
Cà Mau	Cà Mau (provincia)
Quảng Nam	Quảng Nam
Bến Tre	Bến Tre
Khánh Hòa	Khánh Hòa
Káh-gă-ngṳ̄	Chino hakka
Sơn La	Sơn La
Huŏng-ngiòng	Dialecto
Lev Trotsky	León Trotski
Quảng Ninh	Quảng Ninh
Lạng Sơn	Lạng Sơn
Bắc Ninh	Bắc Ninh
Gáng-ngṳ̄	Chino gan
Sṳ̆-mā Guŏng	Sima Guang
Mà-hṳ̀ng	Ailuropoda melanoleuca
Muāng-ngṳ̄	Idioma manchú
Chiū	Mano
Dô Hū	Du Fu
Gùng-dō̤	Archipiélago
Niŏh-niŏh	Hoja
Bŭk-buó	Cascada
Yasser Arafat	Yasir Arafat
Chṳ̆ng-sìng-ngṳ̄	Idioma okinawense
Câung-ngṳ̄	Idioma tibetano
Ngù-ngṳ̄	Chino wu
Tasmania	Tasmania
Ì-cô̤	Jabón
Hŭk-săng	Foshan
Ciĕu-huò Tiĕng-huòng	Hirohito
Al-Qaeda	Al Qaeda
Mò̤-táuk-chiă	Motocicleta
Ò̤-mā	Hippopotamus amphibius
Anastacia	Anastacia
Sĕk Gái	Diez Mandamientos
Huă-báu	Panthera pardus
Să̤-ngiù	Rhinocerotidae
Lò̤-buàng	Brújula
Buáng-dō̤	Península
Sĭng-giŏng	Sinkiang
Mŭk-guă	Carica papaya
Mì-sĕng-só	Vitamina
Gái-làng-chái	Brassica oleracea var. capitata
Giáng	Espejo
Ciŭ-dièu	Dinastía Zhou
Kāng-muòng-giāng	Ventana
Băh Gṳ̆ng	Casa Blanca
Gīng-chák	Policía
Hók-ciŭ-uâ	Dialecto fuzhou
Báe̤k-hāi-dô̤	Hokkaidō
Giŏng	Zingiber officinale
Nobel Huò-bìng Ciōng	Premio Nobel de la Paz
Sáu	Tos
Hák-chê	Estornudo
Káung-mìng	Sueño
Gèng-hāi	Mar de Aral
Dé̤ṳk	Bambuseae
Hù Cé-mìng	Hồ Chí Minh
Hòa Bình	Hòa Bình
Sŭ Sék	Su Shi
Queensland	Queensland
Tù	Suelo
Ù-huă-guō	Ficus carica
Hưng Yên	Hưng Yên
Dòng-dô	Longitud
Kon Tum	Kon Tum
Hậu Giang	Hậu Giang
Máe̤ng	Ensueño
Yên Bái	Yên Bái
Bắc Giang	Bắc Giang
Thừa Thiên-Huế	Thừa Thiên-Huế
Bắc Kạn	Bắc Kạn
Lai Châu	Lai Châu
Hà Nam	Hà Nam
Lào Cai	Provincia de Lào Cai
Mìng-dĕ̤ng-ngṳ̄	Min Dong
Hannibal	Aníbal
Mìng-báe̤k-ngṳ̄	Chino min bei
Mìng-nàng-ngṳ̄	Chino min nan
Thanh Hóa	Provincia de Thanh Hóa
Kiên Giang	Kiên Giang
Quảng Trị	Quảng Trị
Nghệ An	Nghệ An
An Giang	An Giang
Tây Ninh	Tay Ninh
Phú Thọ	Phú Thọ
Duâi-sĭng-sĭng	Gorilla
Trà Vinh	Trà Vinh
Bạc Liêu	Bạc Liêu
Gia Lai	Gia Lai
Tiền Giang	Tiền Giang
Bình Phước	Bình Phước
Đồng Tháp	Đồng Tháp
Thái Bình	Thái Bình
Hà Giang	Hà Giang
Đắk Lắk	Đắk Lắk
Cáung-cŭk	Etnia zhuang
Bình Định	Bình Định
Lâm Đồng	Lâm Đồng
Đắk Nông	Đăk Nông
Phú Yên	Phú Yên
Hải Dương	Hải Dương
Iók-hâng Hók Ĭng	Evangelio de Juan
Dài-uăng-uâ	Idioma taiwanés
Muòng	Puerta
Chiēng-gák	Uña
Cao Bằng	Cao Bằng
Bình Dương	Bình Dương
Bình Thuận	Bình Thuận
Bà Rịa-Vũng Tàu	Bà Rịa-Vũng Tàu
Ninh Bình	Ninh Binh
Ninh Thuận	Ninh Thuận
Nam Định	Nam Định
Điện Biên	Điện Biên
Sìng-lṳ̀ng	Jackie Chan
Méng	Cara
Ùng-ngiòng-ùng	Chino clásico
Gāng-lāng	Olea europaea
Săng-ôi-ék-tā̤	Santísima Trinidad
Sŏng-cṳ̄	Sun Tzu
Sĭng-săng	Maestro
Cleveland	Cleveland
Dăk-lâi Lā-mà	Dalái Lama
Huă-sĕng	Arachis hypogaea
100	Cien
Kă-kók-tàu	Articulación de la rodilla
Hâing	Prunus armeniaca
Ngāng-giáng	Gafas
Cê̤ṳ-lài-huōi	Fósforo (utensilio)
Chê-diòng	Mercado
Nàng Dṳ̆ng-guók Hāi	Mar de la China Meridional
Dièu-siēng Sié-cŭng	Sejong el Grande
Hăk-gĭng	Aleación
Bĭng-siŏng	Refrigerador
Nobel Ùng-hŏk Ciōng	Premio Nobel de Literatura
Huăng-sṳ̀	Ipomoea batatas
Uòng-hāi	Mar Amarillo
Akihito	Akihito
Newton ông-dông-hŏk dêng-lŭk	Leyes de Newton
Să̤-guă	Citrullus lanatus
Biobío Dâi-hŏk	Universidad del Bío-Bío
Huòng-dá̤	Emperador
Ìng-mìng-bê	Yuan chino
Cèng-sáik	Naranja (color)
Gă-sĭ-huă	Herramienta
Ĭ-sĕng	Médico
Iéng (cēu)	Hirundinidae
Kó	Pantalón
Lô-gă Hók Ĭng	Evangelio de Lucas
Mìng-ciō-dōng	Partido Demócrata
Ciŏng-tàu	Ladrillo
Tiō-uòng	Elipse
Sìng-huák	Multiplicación
Sé̤ṳ-dù Hèng-diông	Hechos de los Apóstoles
Uòng-dô̤ Sĕk-nê Sĭng-cô̤	Zodiaco
Huá-siŏh	Fósil
Gēng-huák	Resta
Cī-cī	Semilla
Chiĕk	Brachyura
Gă-dŏ̤	Tijera
Niêu	Orina
Ăng-hŭi	Anhui
Ngiăh	Frente (anatomía)
Sĭ-piĕng	Libro de los Salmos
Chungcheong Báe̤k-dô̤	Chungcheong del Norte
Chungcheong Nàng-dô̤	Chungcheong del Sur
Gangwon Dô̤ (Dâi-hàng Mìng-guók)	Gangwon
Nô̤i Mūng-gū	Mongolia Interior
Gĭng Nĭk-sìng	Kim Il-sung
Gyeongsang Nàng-dô̤	Gyeongsang del Sur
Gyeongsang Báe̤k-dô̤	Gyeongsang del Norte
Jeolla Báe̤k-dô̤	Jeolla del Norte
Jeolla Nàng-dô̤	Jeolla del Sur
Jeju Dĕk-biék Cê̤ṳ-dé-dô̤	Jeju
Huăng-cièng-giāng	Moneda
Bă-biĕk-ták	Torre de Babel
Ulsan	Ulsan
Gwangju	Gwangju
Chó	Vinagre
Kangwŏn Dô̤ (Dièu-siēng Mìng-ciō-ciō-ngiê Ìng-mìng Gê̤ṳng-huò-guók)	Kangwon
Michael Jordan	Michael Jordan
Lé-ê-gé	Levítico
Gṳ̆ng-gṳ̆ng	Raíz (botánica)
Bì-bà (cūi-guō)	Eriobotrya japonica
Hamlet	Hamlet
Huà Guók-hŭng	Hua Guofeng
Sāng	Paraguas
Làu Hiēu-pŏ̤	Liu Xiaobo
Hók-gióng	Fujian
Mūng-gū-cŭk	Mongol (etnia)
Mĕk-sê Liŏh	Apocalipsis
Hièng-câung	Xuanzang
Gū-chiŏng	Nalga
Mìng-chòng	Cama
Hāi-nàng	Hainan
Háng-ngṳ̄ Pĭng-ĭng	Pinyin
Uōng-dĕ̤ng	Extremo Oriente
Băh-gák	Columba livia
Găng-sé̤ṳk	Gansu
Taliban	Talibán
Huŏi-sáik	Gris
Sĭng-mêng-gé	Deuteronomio
Sŭ-ciŭ	Suzhou
Ŭng-ciŭ	Wenzhou
Háng-cŭk	Etnia han
Nìng-pŏ̤	Ningbo
Chói-chiŭ	Barba
Cāi-iêu	Cometa (juego)
Hăk-ī-bĭng	Harbin
Mā-kì	Hirudinea
1000	Mil
Mìng-só-gé	Números
Cáu-sèng	Cocina (habitación)
Hùng-nàng	Yunnan
Lō̤-uă	Corvus
Săng-dĕ̤ng	Shandong
È̤ng-ĕ̤ng	Chilopoda
Ò̤-nàng	Henan
Mì-mò̤	Ceja
Bók-sài	Ombligo
Lièu-nìng	Liaoning
Hióng-liông	Vector
Cretaceous	Cretácico
Tochigi-gâing	Prefectura de Tochigi
Chói-mò̤-cēu	Alcedines
Dàu	Dado
Cūi-nà̤	Cemento
Gék-lìng	Jilin
Dĕ̤ng Dṳ̆ng-guók Hāi	Mar de China Oriental
Hāi-chĕk	Piratería
Gūi	Fantasma
Lè̤ng-ū Huòng-dá̤	Longwu
Bóng-dó̤	Basura
Hù-nàng	Hunan
Jurassic	Jurásico
Chĭng-hāi	Qinghai
Mì-ngù-ī-cŭk	Etnia uigur
Ă-piéng	Opio
Chiū-cī	Anillo
Hù-báe̤k	Hubei
Săng-să̤	Shanxi
Cĕ̤ng-sáik	Marrón
Giòng-găng	Violación
Gói-ciŭ	Guizhou
Triassic	Triásico
Sék-sáuk	Gryllidae
Cāi-piéu	Papel moneda
SQL	SQL
Hù Sék	Hu Shih
Iók-cṳ̆-ā-gé	Libro de Josué
Cŏng-cṳ̄	Zhuangzi
Cṳ̀-hĭ Tái-hâiu	Cixí
Kan Naoto	Naoto Kan
Miyagi-gâing	Prefectura de Miyagi
模板:Commons category	Plantilla:Commonscat
Lò̤-mā Cṳ̆	Epístola a los romanos
Pău-ŭk-siáng	Parábola (matemática)
Dô̤-dáik	Moral
Iwate-gâing	Prefectura de Iwate
Ĭ-siòng-chiă	Máquina de coser
Dièu-siēng Lò̤-dông-dōng	Partido del Trabajo de Corea
Nàng-báe̤k-dièu	Dinastías Meridionales y Septentrionales
Chái Ĭ-lìng	Jolin Tsai
Pì-lĭk-bī Cṳ̆	Epístola a los filipenses
Ngā-gŏ-cṳ̆	Cantar de los Cantares
Mā-lăk-gĭ-cṳ̆	Libro de Malaquías
模板:Taxobox	Plantilla:Ficha de taxón
分類:Guók-uòng	Categoría:Reyes
分類:Gŭng-ciō	Categoría:Monarcas
Diŏng Ngiê-mèu	Zhang Yimou
Gĭng Céng-ŏng	Kim Jong-un
Liù-giù-ngṳ̄	Lenguas ryukyuenses
Céng-ngṳ̄	Chino jin
Mìng-ngṳ̄	Chino min
Gŏng-să̤	Jiangxi
Dài-uăng-sēng (Dṳ̆ng-huà Ìng-mìng Gê̤ṳng-huò-guók)	Provincia de Taiwán (República Popular China)
Nìng-hâ	Ningxia
Lùng-sùng	Barco-dragón
Noda Yoshihiko	Yoshihiko Noda
Yingluck Shinawatra	Yingluck Shinawatra
Siŏh-gă-cŏng	Shijiazhuang
Chṳ̄	Muroidea
Ciŏ-hāi	Zhuhai
Sáng-tàu	Shantou
Dâng-gŏng	Zhanjiang
Mùi-ciŭ	Meizhou
Chĭng-uōng	Qingyuan
Dĕ̤ng-uāng	Dongguan
Dṳ̆ng-săng-chê	Zhongshan
Dièu-ciŭ	Chaozhou
Tàng-táik	Siluriformes
Gé̤ṳk-huă	Chrysanthemum
Mĕ̤k-lê-huă-dà	Té de jazmín
Sofie gì Sié-gái	El mundo de Sofía
Ordovician	Ordovícico
Silurian	Silúrico
Hók-gióng-sēng (Dṳ̆ng-huà Mìng-guók)	Provincia de Fujian
Dāng-nòng	Vesícula biliar
Devonian	Devónico
Hók-ciŭ	Fuzhou
Nàng-bìng	Nanping
Buò-dièng	Putian
Săng-mìng	Sanming
Ciòng-ciŭ	Quanzhou
Â-muòng	Xiamen
Ciŏng-ciŭ	Zhangzhou
Lṳ̀ng-ngàng	Longyan
Nìng-dáik	Ningde
Să̤-nìng	Xining
Să̤-iù-gé	Viaje al Oeste
Săng-guók Iēng-ngiê	Romance de los Tres Reinos
Cūi-hū	A la orilla del agua
Ā-dŏng	Adán
Aomori-gâing	Prefectura de Aomori
Fukushima-gâing	Prefectura de Fukushima
Tái-nguòng	Taiyuan
Hải Phòng	Hải Phòng
Sĭng-dé̤ṳk (gâing)	Condado de Hsinchu
Dâi-lièng	Dalian
Hĭ-Pŏ̤ Ciéng-cĕng	Guerras Médicas
Permian	Pérmico
Cambrian	Cámbrico
Iòng-ciók	Vela (iluminación)
Chiba-gâing	Prefectura de Chiba
Pău	Citrus maxima
Lô-dáik-gé	Libro de Rut
Mà-hù	Anisoptera
Dáng-ī-lī	Libro de Daniel
Páuk-káik	Póquer
Mô̤	Sombrero
Gŏ̤-lìng-dŏ̤ Cièng Cṳ̆	Primera epístola a los corintios
Aichi-gâing	Prefectura de Aichi
Lī-ngṳ̀	Cyprinus carpio
Muāng-ciŭ	Manchuria
Sê̤ṳ-sṳ-gé	Libro de los Jueces
Pŏ̤-lìng-chái	Spinacia oleracea
Akita-gâing	Prefectura de Akita
Pièu-gĕng	Cuchara
Dê̤ṳ	Palillos
Mĕ̤k-lê	Jasminum
Gié-tiàng-chiă	Taxi
Â-hài	Barbilla
Gŭ	Seta
Ibaraki-gâing	Prefectura de Ibaraki
Lài-gŭng	Trueno
Siĕu-sŏng	Ácido nítrico
Ngù-giāng-kó	Pantalón vaquero
Bō̤-siŏh	Gema
Gáu-kuŏ-cṳ̆	Libro de texto
Chāu-māng	Caelifera
Diòng-chŭng	Changchun
Milan Kundera	Milan Kundera
Lâung	Huevo (alimento)
Ū-ì-săng-chê	Ciudad de Wuyishan
Lĕ̤k-sé Sê̤ṳ-giông	Protestas de la Plaza de Tiananmén de 1989
Diêu Ciē-iòng	Zhao Ziyang
Hù Iêu-băng	Hu Yaobang
Fukuda Yasuo	Yasuo Fukuda
Sṳ̀ng-chéu (Sṳ̀ng-báh)	Pinaceae
Gī-hò̤-chiă	Compás (instrumento)
Táng-sŏng	Ácido carbónico
Liòng-chióh	Regla graduada
Chăng-màng-chṳ̄	Talpidae
Dṳ̆ng-hâ Iâ cĭ Máe̤ng	El sueño de una noche de verano
Tié-tàu-să-hô	Barbero
Mā-kō̤ Hók Ĭng	Evangelio de Marcos
Kaesŏng	Kaesong
Hwanghae Báe̤k-dô̤	Hwanghae del Norte
P'yŏng'an Báe̤k-dô̤	P'yŏngan del Norte
Hamgyŏng Báe̤k-dô̤	Hamgyŏng del Norte
Hamgyŏng Nàng-dô̤	Hamgyŏng del Sur
P'yŏng'an Nàng-dô̤	P'yŏngan del Sur
Namp'o	Namp'o
Ryanggang Dô̤	Ryanggang
Tò̤-huòng	Taoyuan
Sŭk-mī	Arroz glutinoso
Nguòng-siĕu-uòng	Tangyuan
Gĭng-dŭ	Prefectura de Kioto
Ōsaka-hū	Prefectura de Osaka
Cék-ngṳ̀	Carassius auratus
Fukuoka-gâing	Prefectura de Fukuoka
Ehime-gâing	Prefectura de Ehime
Gŏ̤-lìng-dŏ̤, Hâiu Cṳ̆	Segunda epístola a los corintios
Sā̤-ĭ-gĭ	Lavadora
Gék	Citrus reticulata
Gé̤ṳ	Sierra (herramienta)
Yamagata-gâing	Prefectura de Yamagata
Éu-dê-huòng	Educación preescolar
Dài-uăng Hāi-hiĕk	Estrecho de Taiwán
Lù-guói	Aloe
Yamaguchi-gâing	Prefectura de Yamaguchi
Kanagawa-gâing	Prefectura de Kanagawa
Nagano-gâing	Prefectura de Nagano
Mì-pŏ̤-lù	Horno de microondas
Saitama-gâing	Prefectura de Saitama
Mie-gâing	Prefectura de Mie
Hĭ-báik-lài Cṳ̆	Epístola a los hebreos
Gă-lăk-tái Cṳ̆	Epístola a los gálatas
Muàng-ngṳ̀	Anguilliformes
Siŏng-dièu	Dinastía Shang
Gunma-gâing	Prefectura de Gunma
Hyōgo-gâing	Prefectura de Hyōgo
Miyazaki-gâing	Prefectura de Miyazaki
Kumamoto-gâing	Prefectura de Kumamoto
Ă-cì	Cicadidae
Koizumi Jun'ichirō	Jun'ichirō Koizumi
Liĕk-uòng-gé-liŏk Siông	I Reyes
Ī-sê̤ṳ-táik-cṳ̆	Libro de Ester
Diòng-dô-cṳ̆	Libro del Eclesiastés
Hatoyama Yukio	Yukio Hatoyama
Gŏ̤-lò̤-să̤ Cṳ̆	Epístola a los colosenses
Ngā-gáuk Cṳ̆	Epístola de Santiago
Iók-hâng Ék Cṳ̆	Primera epístola de Juan
Pì-lé-muòng Cṳ̆	Epístola a Filemón
Táik-sák-lò̤-nà̤-giă, Hâiu Cṳ̆	Segunda epístola a los tesalonicenses
Táik-sák-lò̤-nà̤-giă Cièng Cṳ̆	Primera epístola a los tesalonicenses
Bī-dáik Cièng Cṳ̆	Primera epístola de Pedro
Bī-dáik Hâiu Cṳ̆	Segunda epístola de Pedro
Tì-mò̤-tái Cièng Cṳ̆	Primera epístola a Timoteo
Dòng-lòng	Mantodea
Gifu-gâing	Prefectura de Gifu
Ishikawa-gâing	Prefectura de Ishikawa
Nara-gâing	Prefectura de Nara
Wakayama-gâing	Prefectura de Wakayama
Shizuoka-gâing	Prefectura de Shizuoka
Shiga-gâing	Prefectura de Shiga
Iók-hâng Nê Cṳ̆	Segunda epístola de Juan
Ī-suói-ā-cṳ̆	Libro de Isaías
Iók-hâng Săng Cṳ̆	Tercera epístola de Juan
Iù-dâi Cṳ̆	Epístola de Judas
Tì-mò̤-tái Hâiu Cṳ̆	Segunda epístola a Timoteo
Tì-dŏ̤ Cṳ̆	Epístola a Tito
Ià-lé-mī-cṳ̆	Libro de Jeremías
Ī-sê̤ṳ-lá-cṳ̆	Libro de Esdras
Nà̤-hĭ-mī-cṳ̆	Libro de Nehemías
Iók-ngī-cṳ̆	Libro de Joel
Băh-lô	Egretta garzetta
Chŭng-cáik	Año Nuevo chino
Sō-siè	Llave
Abe Shinzō	Shinzō Abe
Asō Tarō	Tarō Asō
Séng-cṳ̆-tā̤	Jeroglíficos egipcios
Niigata-gâing	Prefectura de Niigata
Yamanashi-gâing	Prefectura de Yamanashi
Shimane-gâing	Prefectura de Shimane
Toyama-gâing	Prefectura de Toyama
Okayama-gâing	Prefectura de Okayama
Kă-tōi	Pata
Piăng	Espalda
Piĕ	Carta
Sáik-màng	Daltonismo
Carboniferous	Carbonífero
Fukui-gâing	Prefectura de Fukui
Ōita-gâing	Prefectura de Ōita
Tottori-gâing	Prefectura de Tottori
Nùng-lĭk	Calendario chino
Kōchi-gâing	Prefectura de Kōchi
Uâng-iū īng-lĭk dêng-lŭk	Ley de gravitación universal
Chèng-gēng	Bombyx mori
Dài-uăng Nĭk-buōng Sì-dâi	Ocupación japonesa de Taiwán
Páuk Gê̤ṳng-hiê	Park Geun-hye
Dài-nàng	Tainan
Cĕng	Aguja (costura)
Muāng-cŭk	Manchú
Kìng-giāng	Alicate
Anna Karenina	Ana Karenina
Tài-nè̤ng	Homicidio
Gáung-gṳ̆ng	Acero corrugado
Tiè-mà	Llanto
Swadesh hŏk-sĭng-sṳ̀ liĕk-biēu	Lista Swadesh
Dŭng-nìng-guók	Reino de Tungning
Hùng-lìng	Condado de Yunlin
Diāng	Cazuela (recipiente)
Kă-cāi	Dedos del pie
Lāng	Saliva
Diò-să-hô	Cocinero
Bĭng-lòng	Areca catechu
Dâi-céng Tiĕng-huòng	Emperador Taishō
Băng-sièng Lā-mà	Panchen Lama
Mŭk-gê̤ṳng	Hibiscus syriacus
Muòi-huă	Prunus mume
Cĕ̤ng-chéu	Trachycarpus fortunei
Muòi-kṳ̄ng	Moho
Sĕ̤ng-săng-giāng	Gemelos (biología)
Mĕ̤k-tiák	Pestaña
Nguòng-cṳ̄-bék	Bolígrafo
Norodom Sihanouk	Norodom Sihanouk
Saga-gâing	Prefectura de Saga
Tokushima-gâing	Prefectura de Tokushima
Lòng-dâung	Hyoscyamus niger
Lòi-sĭ-gā	Destornillador
Kēng-muōi-dăi	Setaria italica
Kagawa-gâing	Prefectura de Kagawa
Mū-dăng	Paeonia suffruticosa
Thaksin Shinawatra	Thaksin Shinawatra
Uòng-dăi	Panicum miliaceum
Kê	Diospyros
Săng-guók (Dièu-siēng)	Tres Reinos de Corea
Bék	Pluma (escritura)
Ŭng-dìng	Polvo
Huăng-siŏh-liù	Psidium guajava
Duâi-tàu-giáng	Lupa
Ĭ-gŭng	Abuelo
Puái-dáu	Mediodía
Huōi-căi	Incendio
Chiū-ló̤h	Guante
Nagasaki-gâing	Prefectura de Nagasaki
Hâ-dièu	Dinastía Xia
Cá̤-nàng	Jinan
Dṳ̆ng-guók Káung-nĭk Ciéng-cĕng	Segunda guerra sino-japonesa
Sarawak	Sarawak
Hŭng-cūi	Feng shui
Chiéu	Risa
Ngô̤-mâng gâe̤ng Piĕng-giéng	Orgullo y prejuicio (novela)
Oda Nobunaga	Oda Nobunaga
Dăng-hù	Coral
Lī Sìng-uāng	Syngman Rhee
Iòng-bék-chó̤	Goma de borrar
Nàng-chiŏng	Nanchang
Tokugawa Ieyasu	Tokugawa Ieyasu
Bók-séu-gáung	Acero inoxidable
Sáu-chiū	Escoba
Dŭk-cài	Autocracia
Kŭng-dièu	Acondicionamiento de aire
Diòng-să	Changsha
Pèng	Pintura (material)
Mìng-dê Tiĕng-huòng	Emperador Meiji
Kă-âu-dăng	Talón
Ā-mò̤-sê̤ṳ-cṳ̆	Libro de Amós
Ŏ̤-bă-dī-ā-cṳ̆	Libro de Abdías
Itō Hirobumi	Itō Hirobumi
Nguŏh	Jade
Só-gé̤ṳ-kó guāng-lī hiê-tūng	Sistema de gestión de bases de datos
Dâu-hô	Tofu
Mì-hèu	Macaca
Mī-giă-cṳ̆	Libro de Miqueas
Bù-sák	Bodhisattva
Hăk-gĭ-cṳ̆	Libro de Hageo
Ī-să̤-giék	Libro de Ezequiel
Chiū-biēu	Reloj de pulsera
ASP.NET	ASP.NET
Iók-nā-cṳ̆	Libro de Jonás
Sabah	Sabah
Ià-lé-mī-ăi-gŏ̤	Libro de las Lamentaciones
Tái-gáng	Eunuco
Nàng-nìng	Nanning
Ê-só	Glutamato monosódico
Nā-ŭng-cṳ̆	Libro de Nahum
Hăk-bă-gók-cṳ̆	Libro de Habacuc
Sák-gā-lé-ă-cṳ̆	Libro de Zacarías
Guók-gê̤ṳng Nô̤i-ciéng	Guerra Civil China
Uŏk-nàng Gê̤ṳng-huò-guók	Vietnam del Sur
Chiĕu-chê	Supermercado
Ciŏng Cṳ̄-ì	Zhang Ziyi
Lák-tàu	Alopecia
Gulliver Lṳ̄-hèng-gé	Los viajes de Gulliver
Gŏ̤-hṳ̀ng	Kaohsiung
Naha-chê	Naha
Buŏk-hāi	Mar de Bohai
Báh-chói	Bostezo
Hâung Ṳ̄	Xiang Yu
Putrajaya	Putrajaya
Kŏng-mìng	Kunming
Nĭk-guŏng-dĕng	Luminaria fluorescente
Jane Eyre	Jane Eyre
Johor	Johor
Ngâung	Discapacidad intelectual
Huòi-cŭk	Etnia hui
Làng-ciŭ	Lanzhou
Hŏ̤-să̤-cṳ̆	Libro de Oseas
Dĕ̤ng-kiĕ	Sepiida
Lìng Cáik-sṳ̀	Lin Hse Tsu
Săng-guók	Tres Reinos
Chŭng-chiŭ Sì-dâi	Primaveras y Otoños
Ciéng-guók Sì-dâi	Reinos Combatientes
Puō-ngì	Puyi
Mā-lăk-gă	Malaca
Oracle	Oracle Database
Hăk-bùi	Heféi
Huák-lùng-gŭng	Falun Gong
Kelantan	Kelantan
Lŏk-iòng	Luoyang
Toyotomi Hideyoshi	Toyotomi Hideyoshi
Kana	Kana
Câung-cŭk	Etnia tibetana
Pulau Pinang	Penang
Hamasaki Ayumi	Ayumi Hamasaki
Să̤-huăng-ngā-cṳ̆	Libro de Sofonías
Dâi-nĭk-buōng Dá̤-guók	Imperio del Japón
Hṳ̆ng-nù	Xiongnu
Mâing-cṳ̄	Mencio
Kedah	Kedah
Perak	Perak
Hŏk-ôi	Grado académico
Gié-lìng	Guilin
Terengganu	Terengganu
Selangor	Selangor
Iòng (dông-ŭk)	Caprinae
Hāi-kāu	Haikou
Chāu-buōng sĭk-ŭk	Hierba
Pahang	Pahang
Bă-là̤ Séng-mū-iêng (Siēu-siók)	Nuestra Señora de París
Chiông-gì	Ajedrez chino
Yun Chi-ho	Yun Chi-ho
Gói-iòng	Guiyang
Gáung-bék	Pluma estilográfica
Ngù Dìng-iēng	Ngô Đình Diệm
Gô-dā̤	Pasado
Dĭng-hiŏng-kó̤	Engraulidae
Miêng	Fideo
Hiêng-câi	Presente (tiempo)
Lèng-gēng	Dimocarpus longan
Mì-lĕk-hŭk	Buda Maitreya
Guăng-ĭng	Avalokiteshvara
Bìng-dĕ̤ng	Condado de Pingtung
Gēu-gī	Lycium barbarum
Lĕ̤k-dèu-gáuk	Costilla
Dâng Sìng-gŭng	Koxinga
Nguŏk-biāng	Pastel de luna
Ciŭ Īng-kŏng	Zhou Yongkang
Cṳ̆-gák Liông	Zhuge Liang
Ció-ĭng Hù-hô̤	Zhuyin
Dṳ̆ng-guók Ìng-mìng Gāi-huóng-gŭng	Ejército Popular de Liberación
Sìng-ū Tiĕng-huòng	Emperador Jinmu
Ciē-chái	Nori
Dennis Rodman	Dennis Rodman
È̤ng-dà	Té negro
Cò̤ Chó̤	Cao Cao
Tài-tàu	Decapitación
Cūi-ngù	Cerambycidae
Buŏi	Vuelo
Ŭi-nà̤-sṳ̆ Sĕng-lī-nè̤ng	El mercader de Venecia
Ū-ì-săng	Monte Wuyi
Ŭ-sŭ-lī-gĕ̤ng	Río Ussuri
Dĕ̤ng-cé	Solsticio de invierno
Tiĕng-huòng	Emperador de Japón
Kăi-hŭng	Kaifeng
Sĭng-dài-bê	Nuevo dólar taiwanés
Sák-mū-ngī-gé-hâiu-cṳ̆	II Samuel
Lăk-dâi-cé-liŏk Hâ	II Crónicas
Liĕk-uòng-gé-liŏk Hâ	II Reyes
Mièu-cŭk	Miao
Nguòng Sié-kāi	Yuan Shikai
John Wesley	John Wesley
Siăh	Alimentación
Perlis	Perlis
Negeri Sembilan	Negeri Sembilan
Labuan	Labuan
Lṳ̀ng	Dragón chino
Iòng-iù-gàu	Lámpara de queroseno
Cần Thơ	Cần Thơ
Ciĕng-bò̤	Champa
Diòng-gáu-sê̤ṳ	Misionero
Uōng-dâi Cièng-tiàng	Grandes esperanzas
Niōng-bēng	Techo
Rasŏn	Rasŏn
Guăng Ṳ̄	Guan Yu
Ŭ-gŭi	Testudines
Tá̤	Cajón
Gê̤ṳng-huò-dōng	Partido Republicano
Bō̤-dâi Huòng-dá̤	Bảo Đại
Siê-iù	Salsa de soya
Ŭ-lṳ̀ng-dà	Té oolong
Huōi-lṳ̀ng-guō	Pitahaya
Gê̤ṳng-sāng-dōng	Partido comunista
Chái Ĭng-ùng	Tsai Ing-wen
Băh-cṳ̄ng-nè̤ng	Blanco (persona)
Ŏ̤-mì-tò̤-hŭk	Amitābha
Ngiè-làng	Condado de Yilan (Taiwán)
Ciŭ Giĕk-lùng	Jay Chou
Orhan Pamuk	Orhan Pamuk
Carpineto Romano	Carpineto Romano
Ngū-dâi Sĕk-guók	Cinco Dinastías
Cō̤	Ziziphus zizyphus
Tā̤-ṳ̆k	Educación física
Sĭng-báe̤k	Nuevo Taipéi
Dài-dṳ̆ng	Taichung
Làu Bê	Liu Bei
Gĭng-muòng	Kinmen
Gă-ngiê (chê)	Chiayi
Giĕ-lè̤ng	Keelung
Săi	Sai
Jun Ji-hyun	Ji-hyun Jun
Dièu-siēng Gŏ̤-cŭng	Emperador Gojong
Gáuk-gáuk	Hueso
Amuro Namie	Namie Amuro
Diêng-tù	Batería eléctrica
Gê̤ṳ-gê̤ṳ	Muleta (bastón)
Nakashima Mika	Mika Nakashima
Hù-lì-mà	Mustela sibirica
Gŏ̤-ák-guŏ	Olla a presión
Chagang Dô̤	Chagang
Óng-chái	Ipomoea aquatica
Ké̤ṳk-siăh	Mendicidad
Sŏng-ngù	Wu (reino)
Băh-cŭk	Bai
Siông Cĭng	Shō Shin
Â-dáu	Tarde
Huòng Tái-gĭk	Hung Taiji
Guŏng-sê̤ṳ Huòng-dá̤	Emperador Guangxu
Alan Dawa Dolma	Alan (cantante)
Ngù-mō̤-ngù-giāng	Caracol
Takeshi Kaneshiro	Takeshi Kaneshiro
Sông-dê Huòng-dá̤	Emperador Shunzhi
Nū-ī-hăk-cà̤	Nurhaci
Iòng-muòi	Myrica rubra
Sŏng Guòng	Sun Quan (emperador Da de Wu)
Cò̤ Pī	Cao Pi
Ciōng Gĭng-guók	Chiang Ching-kuo
Uòng Mì	Wang Wei
Lī Dĕng-hŭi	Lee Teng-hui
Ṳ̆ng-céng Huòng-dá̤	Emperador Yongzheng
Dùng-dê Huòng-dá̤	Emperador Tongzhi
Dŭng-huòng	Dunhuang
Să-mŏk	Erg
Hiŏng-iòng-guă	Sechium edule
Uòng Ăng-sĭk	Wang Anshi
Tokugawa Yoshimune	Tokugawa Yoshimune
Săng-ā	Sanya
Dài-uăng Mìng-ciō-guók	República de Taiwán (1895)
Seo Jae-pil	Seo Jae-pil
Sṳ̆k-háng	Shu (reino)
Cò̤-ngôi	Wei (reino)
Hiŏng-gŭ	Lentinula edodes
Mŭk-ngī	Auricularia auricula-judae
Gă-kéng Huòng-dá̤	Emperador Jiaqing
Páuk Hièng-īng	Pak Heon-yeong
Dô̤-guŏng Huòng-dá̤	Emperador Daoguang
Hièng-hŭng Huòng-dá̤	Emperador Xianfeng
Hùng Séu-ciòng	Hong Xiuquan
Gĭng-kiŏk	Ópera de Pekín
Báik-guá	Pa kua
Sṳ̆-mā Hé	Sima Yi
Áng-pŭng	Ampulex compressa
Hŭng-sṳ̆k	Convención (norma)
Ièu-cŭk	Yao
Bĭng-sĭng	Bing Xin
Biék	Trionychidae
Dièu-siēng Tái-cū	Taejo de Joseon
Báik-nguŏk-cáik	Fiesta del Medio Otoño
Guŏng-Dṳ̆ng Huòng-dá̤	Nguyễn Huệ
Ngà̤ Táuk-sĭng	Watchman Nee
Liŏh-chiông-gĭ	Videograbadora
Dâng-chái	Mytilidae
Gā-cō̤	Siphonaptera
Dài-uăng Muāng-chĭng Sì-dâi	Taiwán bajo la dinastía Qing
Mā-tái Hók Ĭng	Evangelio de Mateo
Sĕk-cê-gá	Cruz cristiana
Ī-hók-sū Cṳ̆	Epístola a los Efesios
Sìng	Sing
Mā-cū (Sìng)	Matsu (mitología)
Uŏk-nàng Gê̤ṳng-sāng-dōng	Partido Comunista de Vietnam
10000	Diez mil
Kū-guă	Momordica charantia
Chék Gié-guŏng	Qi Jiguang
Dĭk Ìng-giĕk	Di Renji
Dṳ̆ng-huà Mìng-guók Guók-gŭng	Fuerzas Armadas de la República de China
Ì-cŭk	Yi
Dâing Lâ̤-gŭng	Teresa Teng
Mìng-sìng Huòng-hâiu	Myeonseong de Joseon
Lṳ̄ Séu-lièng	Annette Lu
Sṳ̀ng-chéu (Hók-ciŭ chê-chéu)	Baniano
Cṳ̀-ciŏng	Baldosa
Ngù Săng-gié	Wu Sangui
Dêu-uòng	Di Xin
Hàng Hàng	Han Han
Huăng-giāng	Extranjero
Tiăng-dŏng	Cuarto de estar
Ók-dāu	Plancha de ropa
Liŏh-dà	Té verde
Liŏh-dâu	Vigna radiata
Dièu-siēng-cŭk	Etnia coreana
Yu Kil-chun	Yu Gil-jun
Mò̤-bék	Pincel de tinta
Páuk Hông-ciŏ	Pak Pong-ju
Hŭk-dáng Dâi-hŏk	Universidad Fudan
Kŭmgang-săng Guăng-guŏng Dê-kṳ̆	Región Turística de Kŭmgangsan
Páuk Dṳ̀ng-iòng	Park Jung-yang
Hòng-ciŭ Să̤-hù	Lago del Oeste
Gă-săk-giāng	Segmento A
Gái-chái	Brassica juncea
Siông-hāi Gău-tŭng Dâi-hŏk	Universidad de Shanghái Jiao Tong
Bù-sìng	Muscidae
Ciū-ciòng	Jiuquan
Hŭ-huò-hô̤-dĕk	Hohhot
Ngù Chĭng-nguòng	Go Seigen
Hà-iù	Salsa de pescado
Băh-ngiê	Isoptera
Băh-uâ-cê	Peh-oe-ji
Ngièng Hók	Yan Fu
Páu-diông	Petardo
Mā-cū (Dō̤)	Islas Matsu
Să̤-cŏng	Traje
Ìng-cṳ̄	Hijo del Hombre
Hiroshima-gâing	Prefectura de Hiroshima
Chiēng-cāi	Dedos de la mano
Hwanghae Nàng-dô̤	Hwanghae del Sur
Siĕu-ciū	Vino chino
Dùng-cé	Camarada
Hŭng-tiŭ	Bomba de bicicleta
Guōng-guă	Benincasa hispida
Káh-gă	Hakka
Bâng-ā	Mudez
Nàng-gĭng Dâi-hŏk	Universidad de Nankín
Chék-nguŏk-buáng	Festival de los fantasmas
Uòng Sĭng-lìng	Cyndi Wang
Hù-siŭ	Misgurnus anguillicaudatus
Ciŭ Ùng-uòng	Rey Wen de Zhou
Huò-sĭng	Heshen
Siĕ Lòng	Shi Lang
Lī Siòng-sêu	Witness Lee
Ngṳ̀-uòng	Bola de pescado
Chái-tàu-guōi	Pastel de nabo
Buò-gì	Livistona chinensis
Dièu-siēng Buáng-dō̤ lĭk-sṳ̄	Historia de Corea
Cáe̤ng	Zongzi
Iù-cák-guōi	Youtiao
Sinŭiju Dĕk-biék Hèng-céng-kṳ̆	Región Administrativa Especial de Sinŭiju
Guók-lĭk Dṳ̆ng-iŏng Dâi-hŏk	Universidad Nacional Central
ISO 639-1	ISO 639-1
Lìng Chṳ̆	Lin Shu
Huá-huá	Acridotheres cristatellus
Mī-hūng	Vermicelli de arroz
Háng-cê Ùng-huá-kuŏng	Mundo chino
Hók-gióng tū-làu	Fujian Tulou
Dṳ̆ng-huà Dâi-hŏk	Universidad Chung Hua
Nê-hù	Erhu
Pū-tŭng-uâ	Mandarín estándar
Siă-cŭk	She
Mē̤ng-giāng	Psychodidae
Mĭk-pŭng	Apidae
Okinawa-gâing	Prefectura de Okinawa
Nàng-ā	Asia del Sur
Báh-uŏk	Baiyue
Guòng-lé	Derechos
Gŭng-sĭ	Empresa
Tŏng-diè-dáing	Baños públicos
Tì-kŭ	Scomber japonicus
Ŭ-cṳ̄ng-nè̤ng	Negro (persona)
Nàng-uŏk-guók	Nanyue
Hâ-uă	Eva
Chèng-chṳ̄	Arvicolinae
Kiŏng-cŭk	Qiang
Uòng-lièng	Coptis chinensis
Chèng	Gleba
Wiki Bô-lâung-diòng	Incubadora de Wikimedia
Guŏng-biāng	Kompyang
Bĭng-dê̤ṳ	Paleta (helado)
Wikipedia:Sū-iū ngṳ̄-ngiòng bēng-buōng gì Wikipedia	Wikipedia:Lista completa de Wikipedias
Ngṳ̆k-huòng-dâi-dá̤	Emperador de Jade
Ngù-sāi-gŭi	Escarabajo pelotero
À̤-liák	Pantufla
Cé̤ṳk	Arroz congee
Pàng-hù Gùng-dō̤	Islas Pescadores
Hāi-chŏng	Haicang
Cĭk-mī	Jimei
Mìng-gĕ̤ng	Río Min (Fujian)
Dùng-ăng	Tong'an
Siòng-ăng	Xiang'an
Ôi	Estómago
Hāi-gēu	Arctocephalinae
Sibu	Sibu
Ciŭ Ū-uòng	Rey Wu de Zhou
Diòng-tĭng	Changting
Cṳ̆-dó̤h	Escritorio
Ĕ̤ng-ngiê	Tetramorium
Aragaki Yui	Yui Aragaki
Siĕu	Dizi
Gák-lì	Almeja
Là̤ Lé	Lê Lợi
Găng-chō̤	Glycyrrhiza uralensis
Gāi-gáik Kăi-huóng	Reforma económica china
Nàng-ăng	Nan'an
Dṳ̀-huák	División (matemática)
Hù-lù	Lagenaria siceraria
Diêng-dĕng	Lámpara eléctrica
Tiék-guăng-ĭng	Tie Guan Yin
Hù-lī	Huli
Īng-dêng	Yongding
Sṳ̀ Cài-hâiu	Xu Caihou
Hŭng-dĕk	Fengze
Lè̤ng-ê̤ṳ Tái-hâiu	Emperatriz viuda Longyu
Siông Bă-cé	Shō Hashi
Siông Tái	Shō Tai
Sṳ̆-mìng	Siming
Ùng-dé̤ṳk	Asparagus setaceus
分類:Dáik-guók	Categoría:Alemania
分類:É-dâi-lé	Categoría:Italia
分類:Mī-guók	Categoría:Estados Unidos
分類:Ngò̤-lò̤-sṳ̆	Categoría:Rusia
分類:Dṳ̆ng-guók	Categoría:China
分類:Nĭk-buōng	Categoría:Japón
分類:Ó̤-ciŭ	Categoría:Australia
Iĕk-cūi-ké	Calentador de agua
分類:Éng-nà̤	Categoría:Indonesia
分類:Hàng-guók	Categoría:Corea del Sur
分類:Tái-guók	Categoría:Tailandia
分類:Uŏk-nàng	Categoría:Vietnam
分類:Buô-ṳ̄ dông-ŭk	Categoría:Mammalia
分類:Bà-hèng dông-ŭk	Categoría:Reptiles
分類:Cēu	Categoría:Aves
分類:Cĭng-kṳ̄ng	Categoría:Fungi
分類:Sĭk-ŭk	Categoría:Plantae
分類:Ŭk-lī	Categoría:Física
分類:Huá-hŏk	Categoría:Química
分類:Lĭk-sṳ̄	Categoría:Historia
分類:Dê-lī	Categoría:Geografía
分類:Siâ-huôi	Categoría:Sociedad
分類:Mī-sŭk	Categoría:Bellas artes
分類:Cŭng-gáu	Categoría:Religión
分類:Tā̤-ṳ̆k	Categoría:Deporte
分類:Kuŏ-hŏk	Categoría:Ciencia
分類:Gióng-dé̤ṳk-ŭk	Categoría:Edificios y estructuras
Gū Lò̤-mā	Antigua Roma
Liù-giāng	Corbiculidae
Regina Duarte	Regina Duarte
Cūi-kì	Babosa
分類:Sĕng-tái	Categoría:Ecología
Sák-mū-ngī-gé-cièng-cṳ̆	I Samuel
分類:Disambig	Categoría:Wikipedia:Desambiguación
分類:Diék-hŏk	Categoría:Filosofía
分類:Sĭng-lī	Categoría:Psicología
分類:Hŭk-gáu	Categoría:Budismo
分類:Gĭ-dók-gáu	Categoría:Cristianismo
分類:Ĭ-sṳ̆-làng-gáu	Categoría:Islam
分類:Iù-tái-gáu	Categoría:Judaísmo
Mā-cū	Matsu
Dĭ-dă	Suona
Hô-dê̤ṳ	Yuba (alimento)
Gùng	Falda
Cháe̤	Luffa aegyptiaca
Tuyên Quang	Tuyên Quang
Iraq gâe̤ng Levant Ĭ-sṳ̆-làng-guók	Estado Islámico (organización terrorista)
Pàng-kì	Sesarmidae
Dâu-mò̤-chái	Brotes de soja
Ì-ngṳ̄	Lenguas yi
Tău-dò̤-nó̤h	Hurto
Ciĕ-muài	Sesamum indicum
Abu Bakr al-Baghdadi	Abu Bakr al-Baghdadi
Nṳ̆k-ṳ̀ng	Rousong
分類:Ùng-huá	Categoría:Cultura
分類:Dê-cék	Categoría:Geología
Wikipedia:Dŏng-nièng gĭng-dáng	Wikipedia:Efemérides
模板:Tái-iòng-hiê	Plantilla:Sistema Solar
Gì-chái	Amaranthus tricolor
Kō̤-cṳ̆	Test estandarizado
Ciē-sáik	Púrpura
Kī-mā-sŭ	Sachima
Tái-bìng-tiĕng-guók	Reino Celestial Taiping
Gâng	Sudor
Ià-huò-huà	Jehová
Sók-lŭk	Rapidez
Ák	Pato
Huăng-siông	Mangifera indica
分類:Dáik-guók ìng-ŭk	Categoría:Alemanes
分類:Mī-guók ìng-ŭk	Categoría:Estadounidenses
分類:Iēng-uòng	Categoría:Actores
分類:Ĭng-guók ìng-ŭk	Categoría:Británicos
分類:Huák-guók ìng-ŭk	Categoría:Franceses
模板:Chess diagram	Plantilla:Diagrama de ajedrez
模板:Tl	Plantilla:Ep
分類:Guók-gă	Categoría:Países
Wikipedia:Hèng-céng Ìng-uòng	Wikipedia:Bibliotecarios
分類:Dṳ̆ng-guók mìng-cŭk	Categoría:Etnias de China
分類:Ìng-ŭk	Categoría:Personas
分類:Cék-ngiĕk	Categoría:Ocupaciones
Wikipedia:Gĭ-ké-nè̤ng	Wikipedia:Bot
分類:Sì-găng	Categoría:Tiempo
分類:Gĕ̤ng-tiàng	Categoría:Ingeniería
分類:Cài-lâiu	Categoría:Materiales
分類:Ĭ-hŏk	Categoría:Medicina
分類:Céng-dê	Categoría:Política
分類:Gáu-ṳ̆k	Categoría:Educación
Ăi-gĭk	Egipto
模板:Bot	Plantilla:Bot
Gă-nā-dâi	Canadá
分類:Iù-hié	Categoría:Juegos
分類:Ĕu-ciŭ guók-gă	Categoría:Países de Europa
分類:Ĕu-ciŭ	Categoría:Europa
模板:Documentation	Plantilla:Documentación
分類:Ê̤ṳng-hô	Categoría:Wikipedia:Wikipedistas por idioma
Sìng Câi-gĭ	Sung Jae-ki
模板:Softredirect	Plantilla:Redirección suave
Wikipedia:維基數據	Wikipedia:Wikidata
模板:Chēng	Plantilla:Destruir
分類:Ngṳ̄-ngiòng	Categoría:Lenguas
分類:Lĭk-huák	Categoría:Calendarios
分類:Wikipedia	Categoría:Wikipedia
Wikipedia:Mò̤ hô-cáik sĭng-mìng	Wikipedia:Limitación general de responsabilidad
分類:未索引其頁面	Categoría:Wikipedia:Páginas no indexadas
Dâi-chṳ̄	Canguro
模板:!	Plantilla:!
模板:!-	Plantilla:!-
模板:Smallcaps	Plantilla:Versalita
模板:Nowrap	Plantilla:Nowrap
Wikipedia:Ék-chiék Wikipedia dŭ găi-dŏng ô gì ùng	Wikipedia:Lista de artículos que toda Wikipedia debería tener
分類:Hĭ-ciŭ	Categoría:África
模板:Wikisource	Plantilla:Wikisource
模板:Babel	Plantilla:Babel
模板:Commons	Plantilla:Commons
模板:Reflist	Plantilla:Listaref
Wikipedia:列明來源	Wikipedia:Verificabilidad (propuesta)
模板:Stub	Plantilla:Esbozo
分類:Ā-ciŭ	Categoría:Asia
分類:Nàng Mī-ciŭ	Categoría:América del Sur
分類:Mā-lài-să̤-ā	Categoría:Malasia
模板:SIL	Plantilla:Doc ISO3
分類:Dièu-lâiu	Categoría:Condimentos
分類:User fr-1	Categoría:Wikipedia:Wikipedistas con nivel básico de francés
模板:Image label	Plantilla:Etiqueta imagen
模板:Steady	Plantilla:Estable
模板:Guók-gă	Plantilla:Ficha de país
模板:Cite journal	Plantilla:Cita publicación
模板:Wikibooks	Plantilla:Wikilibros
模板:Hō̤ gì ùng-ciŏng	Plantilla:Artículo destacado
分類:User en-4	Categoría:Wikipedia:Wikipedistas con nivel experto de inglés
分類:User en	Categoría:Wikipedia:Wikipedistas con conocimientos de inglés
分類:User zh	Categoría:Wikipedia:Wikipedistas con conocimientos de chino
分類:User zh-M	Categoría:Wikipedia:Wikipedistas con nivel nativo de chino
分類:User en-2	Categoría:Wikipedia:Wikipedistas con nivel intermedio de inglés
模板:Infobox	Plantilla:Ficha
分類:Gáuk-guók gì lĭk-sṳ̄	Categoría:Historia por país
Wikipedia:Dŏng-nièng gĭng-dáng/09 nguŏk 23 hô̤	Plantilla:Efemérides - 23 de septiembre
Wikipedia:Dŏng-nièng gĭng-dáng/09 nguŏk 22 hô̤	Plantilla:Efemérides - 22 de septiembre
模板:Legend	Plantilla:Leyenda
Wikipedia:Dŏng-nièng gĭng-dáng/09 nguŏk 17 hô̤	Plantilla:Efemérides - 17 de septiembre
Wikipedia:Dŏng-nièng gĭng-dáng/10 nguŏk 15 hô̤	Plantilla:Efemérides - 15 de octubre
模板:Cite web	Plantilla:Cita web
Wikipedia:Dŏng-nièng gĭng-dáng/09 nguŏk 28 hô̤	Plantilla:Efemérides - 28 de septiembre
Wikipedia:Dŏng-nièng gĭng-dáng/10 nguŏk 22 hô̤	Plantilla:Efemérides - 22 de octubre
Wikipedia:Dŏng-nièng gĭng-dáng/11 nguŏk 2 hô̤	Plantilla:Efemérides - 2 de noviembre
Wikipedia:Dŏng-nièng gĭng-dáng/11 nguŏk 9 hô̤	Plantilla:Efemérides - 9 de noviembre
模板:Country data	Plantilla:Geodatos
Wikipedia:Dŏng-nièng gĭng-dáng/10 nguŏk 1 hô̤	Plantilla:Efemérides - 1 de octubre
Wikipedia:Dŏng-nièng gĭng-dáng/10 nguŏk 5 hô̤	Plantilla:Efemérides - 5 de octubre
Wikipedia:Dŏng-nièng gĭng-dáng/10 nguŏk 8 hô̤	Plantilla:Efemérides - 8 de octubre
分類:Īng-sĭk	Categoría:Comida y bebida
Wikipedia:Dŏng-nièng gĭng-dáng/10 nguŏk 6 hô̤	Plantilla:Efemérides - 6 de octubre
Wikipedia:Dŏng-nièng gĭng-dáng/10 nguŏk 17 hô̤	Plantilla:Efemérides - 17 de octubre
Wikipedia:Dŏng-nièng gĭng-dáng/10 nguŏk 2 hô̤	Plantilla:Efemérides - 2 de octubre
Wikipedia:Dŏng-nièng gĭng-dáng/09 nguŏk 16 hô̤	Plantilla:Efemérides - 16 de septiembre
Wikipedia:Dŏng-nièng gĭng-dáng/09 nguŏk 19 hô̤	Plantilla:Efemérides - 19 de septiembre
Wikipedia:Dŏng-nièng gĭng-dáng/10 nguŏk 25 hô̤	Plantilla:Efemérides - 25 de octubre
Wikipedia:Dŏng-nièng gĭng-dáng/11 nguŏk 10 hô̤	Plantilla:Efemérides - 10 de noviembre
Wikipedia:Dŏng-nièng gĭng-dáng/10 nguŏk 21 hô̤	Plantilla:Efemérides - 21 de octubre
Wikipedia:Dŏng-nièng gĭng-dáng/09 nguŏk 15 hô̤	Plantilla:Efemérides - 15 de septiembre
Wikipedia:Dŏng-nièng gĭng-dáng/09 nguŏk 4 hô̤	Plantilla:Efemérides - 4 de septiembre
Wikipedia:Dŏng-nièng gĭng-dáng/09 nguŏk 8 hô̤	Plantilla:Efemérides - 8 de septiembre
Wikipedia:Dŏng-nièng gĭng-dáng/10 nguŏk 4 hô̤	Plantilla:Efemérides - 4 de octubre
Wikipedia:Dŏng-nièng gĭng-dáng/09 nguŏk 1 hô̤	Plantilla:Efemérides - 1 de septiembre
Wikipedia:Dŏng-nièng gĭng-dáng/09 nguŏk 6 hô̤	Plantilla:Efemérides - 6 de septiembre
Wikipedia:Dŏng-nièng gĭng-dáng/09 nguŏk 25 hô̤	Plantilla:Efemérides - 25 de septiembre
Wikipedia:Dŏng-nièng gĭng-dáng/09 nguŏk 10 hô̤	Plantilla:Efemérides - 10 de septiembre
Wikipedia:Dŏng-nièng gĭng-dáng/09 nguŏk 26 hô̤	Plantilla:Efemérides - 26 de septiembre
Wikipedia:Dŏng-nièng gĭng-dáng/09 nguŏk 20 hô̤	Plantilla:Efemérides - 20 de septiembre
Wikipedia:Dŏng-nièng gĭng-dáng/11 nguŏk 4 hô̤	Plantilla:Efemérides - 4 de noviembre
Wikipedia:Dŏng-nièng gĭng-dáng/09 nguŏk 30 hô̤	Plantilla:Efemérides - 30 de septiembre
Wikipedia:Dŏng-nièng gĭng-dáng/10 nguŏk 7 hô̤	Plantilla:Efemérides - 7 de octubre
Wikipedia:Dŏng-nièng gĭng-dáng/10 nguŏk 19 hô̤	Plantilla:Efemérides - 19 de octubre
Wikipedia:Dŏng-nièng gĭng-dáng/09 nguŏk 27 hô̤	Plantilla:Efemérides - 27 de septiembre
Wikipedia:Dŏng-nièng gĭng-dáng/09 nguŏk 11 hô̤	Plantilla:Efemérides - 11 de septiembre
Wikipedia:Dŏng-nièng gĭng-dáng/11 nguŏk 8 hô̤	Plantilla:Efemérides - 8 de noviembre
Wikipedia:Dŏng-nièng gĭng-dáng/11 nguŏk 1 hô̤	Plantilla:Efemérides - 1 de noviembre
Wikipedia:Dŏng-nièng gĭng-dáng/11 nguŏk 7 hô̤	Plantilla:Efemérides - 7 de noviembre
Wikipedia:Dŏng-nièng gĭng-dáng/10 nguŏk 11 hô̤	Plantilla:Efemérides - 11 de octubre
Wikipedia:Dŏng-nièng gĭng-dáng/11 nguŏk 3 hô̤	Plantilla:Efemérides - 3 de noviembre
Wikipedia:Dŏng-nièng gĭng-dáng/10 nguŏk 20 hô̤	Plantilla:Efemérides - 20 de octubre
Wikipedia:Dŏng-nièng gĭng-dáng/10 nguŏk 16 hô̤	Plantilla:Efemérides - 16 de octubre
Wikipedia:Dŏng-nièng gĭng-dáng/10 nguŏk 14 hô̤	Plantilla:Efemérides - 14 de octubre
Wikipedia:Dŏng-nièng gĭng-dáng/10 nguŏk 18 hô̤	Plantilla:Efemérides - 18 de octubre
Wikipedia:Dŏng-nièng gĭng-dáng/10 nguŏk 24 hô̤	Plantilla:Efemérides - 24 de octubre
Wikipedia:Dŏng-nièng gĭng-dáng/10 nguŏk 3 hô̤	Plantilla:Efemérides - 3 de octubre
Wikipedia:Dŏng-nièng gĭng-dáng/09 nguŏk 7 hô̤	Plantilla:Efemérides - 7 de septiembre
分類:Săng	Categoría:Montañas
模板:IPA	Plantilla:AFI
分類:Céng-dê-gă	Categoría:Políticos
分類:Mī-ciŭ	Categoría:América
Tàng	Flema
分類:Gáuk-guók gì ìng-ŭk	Categoría:Personas por nacionalidad
模板:Wiki-huá	Plantilla:Wikificar
分類:Gŭng-sê̤ṳ	Categoría:Fuerzas armadas
模板:Increase	Plantilla:Creciente
模板:Infobox 網站	Plantilla:Ficha de sitio web
Wikipedia:Dŏng-nièng gĭng-dáng/10 nguŏk 12 hô̤	Plantilla:Efemérides - 12 de octubre
模板:Decrease	Plantilla:Decreciente
模板:Image label end	Plantilla:Etiqueta imagen fin
模板:Documentation subpage	Plantilla:Subpágina de documentación
Wikipedia:Dŏng-nièng gĭng-dáng/11 nguŏk 5 hô̤	Plantilla:Efemérides - 5 de noviembre
Wikipedia:Dŏng-nièng gĭng-dáng/10 nguŏk 13 hô̤	Plantilla:Efemérides - 13 de octubre
Wikipedia:Dŏng-nièng gĭng-dáng/09 nguŏk 3 hô̤	Plantilla:Efemérides - 3 de septiembre
Wikipedia:Dŏng-nièng gĭng-dáng/09 nguŏk 24 hô̤	Plantilla:Efemérides - 24 de septiembre
模板:Purge	Plantilla:Purgar
模板:Lang-la	Plantilla:Lang-la
分類:Cìng-gāng	Categoría:Emociones
模板:Userpage	Plantilla:Página usuario
模板:User	Plantilla:U
Wikipedia:Dŏng-nièng gĭng-dáng/09 nguŏk 12 hô̤	Plantilla:Efemérides - 12 de septiembre
Wikipedia:Dŏng-nièng gĭng-dáng/09 nguŏk 2 hô̤	Plantilla:Efemérides - 2 de septiembre
Wikipedia:Dŏng-nièng gĭng-dáng/11 nguŏk 6 hô̤	Plantilla:Efemérides - 6 de noviembre
Wikipedia:Dŏng-nièng gĭng-dáng/09 nguŏk 18 hô̤	Plantilla:Efemérides - 18 de septiembre
Wikipedia:Dŏng-nièng gĭng-dáng/10 nguŏk 10 hô̤	Plantilla:Efemérides - 10 de octubre
Wikipedia:Dŏng-nièng gĭng-dáng/10 nguŏk 9 hô̤	Plantilla:Efemérides - 9 de octubre
Wikipedia:Dŏng-nièng gĭng-dáng/10 nguŏk 23 hô̤	Plantilla:Efemérides - 23 de octubre
模板:Image label small	Plantilla:Etiqueta imagen pequeña
模板:Gô-dā̤ gì guók-gă	Plantilla:Ficha de estado desaparecido
Wikipedia:Tiăng-dŏng	Wikipedia:Embajada Local
分類:User ja-M	Categoría:Wikipedia:Wikipedistas con nivel nativo de japonés
模板:Gì-ngiê	Plantilla:Desambiguación
分類:Dièu-siēng lĭk-sṳ̄	Categoría:Historia de Corea
模板:Lang-grc	Plantilla:Lang-grc
模板:AUS	Plantilla:AUS
模板:Lifetime	Plantilla:NF
模板:Lang-en	Plantilla:Lang-en
分類:Sĕng-ŭk	Categoría:Organismos
Wikipedia:Dŏng-nièng gĭng-dáng/9 nguŏk	Wikipedia:Efemérides/Septiembre
Wikipedia:Dŏng-nièng gĭng-dáng/09 nguŏk 14 hô̤	Plantilla:Efemérides - 14 de septiembre
Wikipedia:Dŏng-nièng gĭng-dáng/09 nguŏk 9 hô̤	Plantilla:Efemérides - 9 de septiembre
Wikipedia:Dŏng-nièng gĭng-dáng/09 nguŏk 13 hô̤	Plantilla:Efemérides - 13 de septiembre
Wikipedia:Dŏng-nièng gĭng-dáng/10 nguŏk	Wikipedia:Efemérides/Octubre
分類:User wuu	Categoría:Wikipedia:Wikipedistas con conocimientos de Wu
分類:User fr	Categoría:Wikipedia:Wikipedistas con conocimientos de francés
分類:User ja	Categoría:Wikipedia:Wikipedistas con conocimientos de japonés
分類:User la	Categoría:Wikipedia:Wikipedistas con conocimientos de latín
分類:User fr-3	Categoría:Wikipedia:Wikipedistas con nivel avanzado de francés
分類:User it-3	Categoría:Wikipedia:Wikipedistas con nivel avanzado de italiano
分類:User ja-3	Categoría:Wikipedia:Wikipedistas con nivel avanzado de japonés
分類:User fr-2	Categoría:Wikipedia:Wikipedistas con nivel intermedio de francés
分類:User it-2	Categoría:Wikipedia:Wikipedistas con nivel intermedio de italiano
分類:User ja-2	Categoría:Wikipedia:Wikipedistas con nivel intermedio de japonés
分類:User la-2	Categoría:Wikipedia:Wikipedistas con nivel intermedio de latín
分類:User wuu-M	Categoría:Wikipedia:Wikipedistas con nivel nativo de Wu
分類:User ko-M	Categoría:Wikipedia:Wikipedistas con nivel nativo de coreano
分類:User fr-M	Categoría:Wikipedia:Wikipedistas con nivel nativo de francés
分類:User it-M	Categoría:Wikipedia:Wikipedistas con nivel nativo de italiano
分類:User nl-M	Categoría:Wikipedia:Wikipedistas con nivel nativo de neerlandés
分類:Ùng-cê	Categoría:Sistemas de escritura
分類:Dô̤-gáu	Categoría:Taoísmo
分類:User de	Categoría:Wikipedia:Wikipedistas con conocimientos de alemán
分類:User de-2	Categoría:Wikipedia:Wikipedistas con nivel intermedio de alemán
分類:User de-3	Categoría:Wikipedia:Wikipedistas con nivel avanzado de alemán
分類:User de-M	Categoría:Wikipedia:Wikipedistas con nivel nativo de alemán
分類:User en-3	Categoría:Wikipedia:Wikipedistas con nivel avanzado de inglés
分類:User en-M	Categoría:Wikipedia:Wikipedistas con nivel nativo de inglés
分類:User es	Categoría:Wikipedia:Wikipedistas con conocimientos de español
分類:User es-1	Categoría:Wikipedia:Wikipedistas con nivel básico de español
分類:User es-2	Categoría:Wikipedia:Wikipedistas con nivel intermedio de español
分類:User es-3	Categoría:Wikipedia:Wikipedistas con nivel avanzado de español
分類:User es-M	Categoría:Wikipedia:Wikipedistas con nivel nativo de español
分類:Chió	Categoría:Vivienda
分類:User it	Categoría:Wikipedia:Wikipedistas con conocimientos de italiano
分類:User it-1	Categoría:Wikipedia:Wikipedistas con nivel básico de italiano
分類:User ja-1	Categoría:Wikipedia:Wikipedistas con nivel básico de japonés
分類:User ko	Categoría:Wikipedia:Wikipedistas con conocimientos de coreano
分類:Mī-guók gì ciŭ	Categoría:Estados de Estados Unidos
分類:User la-1	Categoría:Wikipedia:Wikipedistas con nivel básico de latín
Wikipedia:Dŏng-nièng gĭng-dáng/09 nguŏk 29 hô̤	Plantilla:Efemérides - 29 de septiembre
Wikipedia:Dŏng-nièng gĭng-dáng/09 nguŏk 5 hô̤	Plantilla:Efemérides - 5 de septiembre
模板:Distinguish	Plantilla:Distinguir
分類:Huâng-cô̤i	Categoría:Criminalidad
Sáik-mō̤	Phthiraptera
分類:Séng-sék	Categoría:Ciencias de la información
分類:Hāi	Categoría:Mares
Hŭng-siéng	Ventilador
分類:Guōng-dĕ̤ng	Categoría:Provincia de Cantón
分類:Hók-gióng	Categoría:Fujian
分類:Ciék-ciĕ dông-ŭk	Categoría:Arthropoda
分類:Hĭ-ciŭ guók-gă	Categoría:Países de África
分類:Gáuk-guók gì gáu-ṳ̆k	Categoría:Educación por país
Wikipedia:Dŏng-nièng gĭng-dáng/11 nguŏk	Wikipedia:Efemérides/Noviembre
分類:Ciék-gŏng	Categoría:Zhejiang
分類:Ĭng-ngŏk-gă	Categoría:Músicos
模板:Lang	Plantilla:Lang
Wikipedia:Dŏng-nièng gĭng-dáng/09 nguŏk 21 hô̤	Plantilla:Efemérides - 21 de septiembre
分類:Hŏk-sŭk	Categoría:Academia
Bì-bà (ngŏk-ké)	Pipa (instrumento)
分類:Wikimedia gĕ̤ng-tiàng	Categoría:Proyectos Wikimedia
分類:Gì-lôi	Categoría:Juegos abstractos
模板:Infobox Language/family-color	Plantilla:Ficha de idioma/colores
分類:Ò̤	Categoría:Ríos
Cūi-siĕng	Narcissus tazetta
分類:Dâi-hàng Mìng-guók ìng-ŭk	Categoría:Surcoreanos
分類:Sôi-diēng ìng-ŭk	Categoría:Suecos
分類:Nĭk-buōng ìng-ŭk	Categoría:Japoneses
分類:Dài-uăng ìng-ŭk	Categoría:Taiwaneses
分類:User nl	Categoría:Wikipedia:Wikipedistas con conocimientos de neerlandés
分類:User zh-1	Categoría:Wikipedia:Wikipedistas con nivel básico de chino
分類:Cāi	Categoría:Papel
分類:Ông-ò̤	Categoría:Canales
分類:Uŏk-nàng ìng-ŭk	Categoría:Vietnamitas
分類:Sóng-dièu huòng-dá̤	Categoría:Emperadores de la dinastía Song
分類:Ngò̤-lò̤-sṳ̆ ìng-ŭk	Categoría:Rusos
分類:Hiŏng-gē̤ng ìng-ŭk	Categoría:Hongkoneses
分類:Ciĕk-káik ìng-ŭk	Categoría:Checos
分類:Tái-guók ìng-ŭk	Categoría:Tailandeses
Uŏk-ngṳ̄	Chino cantonés
分類:Sáng	Categoría:Apellidos
分類:Dièu-siēng Mìng-ciō-ciō-ngiê Ìng-mìng Gê̤ṳng-huò-guók	Categoría:Corea del Norte
分類:Dṳ̆ng-guók ìng-ŭk	Categoría:Chinos
分類:Dièu-siēng	Categoría:Corea
分類:Dài-uăng	Categoría:Taiwán
分類:Dièu-siēng Mìng-ciō-ciō-ngiê Ìng-mìng Gê̤ṳng-huò-guók ìng-ŭk	Categoría:Norcoreanos
分類:Dâi-iòng-ciŭ guók-gă	Categoría:Países de Oceanía
分類:Báe̤k Mī-ciŭ guók-gă	Categoría:Países de América del Norte
分類:Ngṳ̀	Categoría:Peces
分類:Cūi-guō	Categoría:Frutas
分類:Niōng-tā̤ dông-ŭk	Categoría:Mollusca
分類:Só-cê	Categoría:Sistemas de numeración
分類:Gióng-dé̤ṳk cài-lâiu	Categoría:Materiales de construcción
分類:Dông-ŭk	Categoría:Animales
分類:Ciáh-tùi dông-ŭk	Categoría:Vertebrata
分類:Guòng-lé	Categoría:Derechos
分類:Ìng-guòng	Categoría:Derechos humanos
分類:Ū-ké	Categoría:Armas
分類:Nàng Mī-ciŭ guók-gă	Categoría:Países de América del Sur
分類:Gă-sĭ	Categoría:Mobiliario
分類:Ké-chiông	Categoría:Meteorología
分類:Dṳ̆ng Mī-ciŭ	Categoría:América Central
分類:Hiŏng-gē̤ng	Categoría:Hong Kong
分類:Ĭ-siòng	Categoría:Indumentaria
分類:Cáik-nĭk	Categoría:Festivales
分類:Kuàng-ciék dông-ŭk	Categoría:Annelida
分類:Bâng	Categoría:Enfermedades
分類:Kiŏng-diòng dông-ŭk	Categoría:Cnidaria
分類:Ciŭ-dièu guók-uòng	Categoría:Reyes de la dinastía Zhou
分類:Káh-dièu-nó̤h	Categoría:Juguetes
分類:Gă-dìng	Categoría:Familia
分類:Dṳ̆ng-guók huòng-dá̤	Categoría:Emperadores de China
分類:Huòng-dá̤	Categoría:Emperadores
分類:Báe̤k Mī-ciŭ	Categoría:América del Norte
分類:Gŏ̤-chiū	Categoría:Cantantes
分類:Hù	Categoría:Lagos
分類:Só-hŏk-gă	Categoría:Matemáticos
模板:Infobox ngṳ̄-ngiòng	Plantilla:Ficha de idioma
分類:Dâi-iòng-ciŭ	Categoría:Oceanía
分類:Tiĕng-căi	Categoría:Desastres naturales
分類:Gô-dā̤ gì guók-gă	Categoría:Estados desaparecidos
Vĩnh Long	Vĩnh Long
分類:Dṳ̆ng-huà Ìng-mìng Gê̤ṳng-huò-guók	Categoría:República Popular China
Cāi-puŏi	Cartón ondulado
分類:Giông-kŏng	Categoría:Salud
Hâ-cé	Solsticio de verano
分類:Sĕng-lī	Categoría:Fisiología
分類:Â-muòng	Categoría:Xiamen
Trojany	Trojany
模板:Infobox color	Plantilla:Ficha de color
分類:Ā-ciŭ guók-gă	Categoría:Países de Asia
分類:Mī-ciŭ guók-gă	Categoría:Países de América
分類:Huák-lŭk	Categoría:Leyes
分類:Dṳ̆ng Mī-ciŭ guók-gă	Categoría:Países de América Central
分類:Bēng-guòng	Categoría:Derecho de autor
分類:Biēu-cìng	Categoría:Expresiones faciales
分類:Hók-ciŭ	Categoría:Fuzhou
分類:Ôi-sĕng	Categoría:Higiene
分類:Dṳ̆ng-huà Mìng-guók	Categoría:República de China
模板:Image label begin	Plantilla:Etiqueta imagen inicio
分類:Sĕng-uăk	Categoría:Vida personal
Uòng-pŭng	Avispa
分類:User en-1	Categoría:Wikipedia:Wikipedistas con nivel básico de inglés
分類:User de-1	Categoría:Wikipedia:Wikipedistas con nivel básico de alemán
分類:Gă-sĭ-huă	Categoría:Herramientas
Lăk-dâi-cé-liŏk Siông	I Crónicas
分類:Mìng-cŭk	Categoría:Etnicidad
Wikipedia:失效鏈接	Ayuda:Cómo recuperar un enlace roto
Liù-giù	Islas Ryūkyū
模板:Sèng nièng	Plantilla:AC
模組:Citation/CS1/Whitelist	Módulo:Citas/Whitelist
Gŭng-ô-nguòng	Función pública
Chái-tàu	Raphanus sativus
模板:Ping	Plantilla:Respuesta a
Yun Hyon-seok	Yun Hyon-seok
模組:Arguments	Módulo:Argumentos
特殊:最近其改變	Especial:CambiosRecientes
模組:Citation/CS1	Módulo:Citas
模組:Citation/CS1/Configuration	Módulo:Citas/Configuración
模組:HtmlBuilder	Módulo:HtmlBuilder
模組:Coordinates	Módulo:Coordenadas
模組:Math	Módulo:Math
模組:Infobox	Módulo:Ficha
Ciá	Saccharum
