非洲	África
日本	Japón
南美洲	América del Sur
Nò-vî	Noruega
Sû-kak-làn	Escocia
Vî-ngì-sṳ̂	Gales
Pet Oi-ngì-làn	Irlanda del Norte
Hiûng-ngà-li	Hungría
Sî-pân-ngà	España
Mî-koet	Estados Unidos
Pí-li-sṳ̀	Bélgica
Lù-sêm-pó	Luxemburgo
Yî-chhiu	Universo
Thi-khiù	Tierra
Sâng-miang	Vida
Ngìn-lui	Homo sapiens
George Washington	George Washington
Fûn-làn	Finlandia
Shuì-tién	Suecia
Tan-ma̍k	Dinamarca
Pô-làn	Polonia
Li̍p-thâu-vón	Lituania
Yi-thai-li	Italia
Shuì-sṳ	Suiza
O-thi-li	Austria
Hî-lia̍p	Grecia
Thú-ngí-khì	Turquía
Phù-thò-ngà	Portugal
歐洲	Europa
亞洲	Asia
北美洲	América del Norte
南極洲	Antártida
Vì-kî Pak-khô	Wikipedia
Hò-làn	Países Bajos
Néu-yok-sṳ	Nueva York
Fà-sṳ̀n-tun Kô-lùn-pí-â Thi̍t-khî	Washington D. C.
Khiu-kîm-sân	San Francisco (California)
Pak-lìm	Berlín
Lo̍k-chhám-kî	Los Ángeles
Thien-nó	Computadora
Mióng-chi-mióng-lu	Internet
Barack Obama	Barack Obama
Vû-lâ-kûi	Uruguay
Lùn-tûn	Londres
Phìn-kó	Manzana
Pâ-lì-sṳ	París
Â-pak-lâ-hón Lìm-khén	Abraham Lincoln
Google	Google
Me̍t-sî-kô	México
Thai-sî-yòng	Océano Atlántico
Thai-phìn-yòng	Océano Pacífico
Kâ-li-fuk-nì-â	California
Pô-sṳ-tun	Boston
Fó-sên	Marte (planeta)
Âi-set-ngò-pí-â	Etiopía
Sṳ̂-é	Panthera leo
Fap-koet	Francia
Sṳ-kie-ngî	Esperanto
Kiéu-è	Canis lupus familiaris
Yîn-koet	Reino Unido
Meu-é	Felis silvestris catus
中華人民共和國	República Popular China
Fap-ngî	Idioma francés
Ǹg-è	Pisces
Pâ-sî	Brasil
François Hollande	François Hollande
Ngò-lò-sṳ̂	Rusia
Kîn-ǹg	Cetacea
Chang-fông-hìn	Cuadrado
Tô-lùn-tô	Toronto
Â-lâ-pâ-mâ	Alabama
Québec-sén	Quebec
Boeing 747	Boeing 747
Jimmy Wales	Jimmy Wales
Tet-koet	Alemania
Pha̍k-ngò-lò-sṳ̂	Bielorrusia
Tet-ngî	Idioma alemán
Pên-tó	Islandia
Song-ti	Dios
Oi-sâ-nì-â	Estonia
David Cameron	David Cameron
Thú-sên	Saturno (planeta)
Ku-thin-yi̍t Fî-kî	Avión
1	Uno
2	Dos
3	Tres
4	Cuatro
5	Cinco
George W. Bush	George W. Bush
Lâ-thot-vì-â	Letonia
Vû-khiet-làn	Ucrania
Tshia̍p-khiet	República Checa
Sṳ̂-lo̍k-vì-nì-â	Eslovenia
Lò-mâ-nì-â	Rumania
Pó-kâ-li-â	Bulgaria
Lò-mâ	Roma
Mâ-khì-tun	República de Macedonia
Â-ngì-pâ-nì-â	Albania
Khiet-lò-âi-sî-â	Croacia
Pô-sṳ-nì-â lâu Het-set-kô-vì-ná	Bosnia y Herzegovina
Â-set-pai-kiông	Azerbaiyán
Set-phû-lu-sṳ̂	Chipre
Kak-lû-kit-â	Georgia
Hâ-sat-khiet-sṳ̂-thán	Kazajistán
Mí-li-thai	Malta
Mô-na̍p-kô	Mónaco
Mùng-thi̍t-nui-kô-lò	Montenegro
Sṳn Mâ-li-nok	San Marino
Kú-pâ	Cuba
Eiffel Thiet-thap	Torre Eiffel
Yin-thu-nì-sî-â	Indonesia
Wolfgang Amadeus Mozart	Wolfgang Amadeus Mozart
Pi-tô-fûn	Ludwig van Beethoven
Thú-ngí-khì-ngî	Idioma turco
Nàm-fî	Sudáfrica
Vû-tsṳ̂-phe̍t-khiet-sṳ̂-thán	Uzbekistán
Pô-tsṳ-nàm	Poznań
Fà-sâ	Varsovia
Súi	Agua
Thien-sṳ	Televisión
Chṳ-li	Chile
Yâ-sû	Jesús de Nazaret
Súi-sên	Mercurio (planeta)
Li̍t-sṳ́	Historia
Phìn-kó Kûng-sṳ̂	Apple
Kîm-sên	Venus (planeta)
Ngî-ngièn	Lenguaje
Muk-sên	Júpiter (planeta)
Thiên-vòng-sên	Urano (planeta)
Hói-vòng-sên	Neptuno (planeta)
Thiên-vùn-ho̍k	Astronomía
Sîn-kâ-po	Singapur
Khô-ho̍k	Ciencia
Montréal	Montreal
Lie̍t-kî-tûn-sṳ-tên	Liechtenstein
Kiam-khiâu	Cambridge
Thi-ngi-chhṳ Sṳ-kie Thai-chan	Segunda Guerra Mundial
Cologne	Colonia (Alemania)
Kak-tên-nì-â	Gdynia
Sṳ̍p-chhiet-chhiâng	Szczecin
Sṳ-ho̍k	Matemáticas
Lâ-tên-ngî	Latín
Pâ-lìm	Baréin
Â-mî-nì-â	Armenia
Set-ngì-vì-â	Serbia
Ngie̍t-khiù	Luna
Àu-thai-li-â	Australia
Vu̍t-lî-ho̍k	Física
Â-kîn-thìn	Argentina
Pi-lû	Perú
Sâng-vu̍t-ho̍k	Biología
Tsêu-siên Mìn-tsú Tsú-ngi Ngìn-mìn Khiung-fò-koet	Corea del Norte
Kán-pu-chhài	Camboya
Khiúng-liùng	Dinosauria
Yî-sṳ̂-làn-kau	Islam
Lech Wałęsa	Lech Wałęsa
Lin-é	Rueda
Lyon	Lyon
Êu-chû Lièn-mèn	Unión Europea
Rhône-Alpes	Ródano-Alpes
Chhiòn-khiù Chṳ̂-sín Mióng	World Wide Web
Ńg-ngìn	Mujer
Fâ	Flor
Mâ-lî-â-na̍p-hói	Fosa de las Marianas
Chû-mu̍k-lòng-mâ-fûng	Monte Everest
Sàng-sṳ	Ciudad
Nâ-pho-lùn yit-sṳ	Napoleón Bonaparte
Ngit-tèu	Sol
Pâ-sṳ-tet	Louis Pasteur
大洋洲	Oceanía
Thai-yòng Hì	Sistema Solar
Pô-lò-tit-hói	Mar Báltico
Khîn	Hidrógeno
Hoi (氦)	Helio
Angela Merkel	Angela Merkel
Lî	Litio
Phì	Berilio
Si	Libro
Ngit	Día
Ngièn	Año
Sṳ-ki	Siglo
Lò-tsṳ (Pô-làn)	Łódź
Khà-thok-vì-chṳ	Katowice
Ngie̍t-sû-fû	Rzeszów
Phìn	Boro
Thàn	Carbono
Tham	Nitrógeno
Yòng	Oxígeno
Hàng-sên	Planeta
Yîm-ngo̍k	Música
Rennes	Rennes
Mo̍k-sṳ̂-khô	Moscú
Fuk	Flúor
Yi-thai-li-ngî	Idioma italiano
Nái	Neón
Sṳn Pí-tet-páu	San Petersburgo
Na̍p	Sodio
北	Norte
Mî	Magnesio
Lî (鋁)	Aluminio
Néu Sî-làn	Nueva Zelanda
南	Sur
Yin-thu	India
Si̍t	Silicio
Fap	Francio
Lìn	Fósforo
Thiet	Hierro
Tûng-kâ	Tonga
西	Oeste
Liù-vòng	Azufre
東	Este
Liu̍k	Cloro
Pâ-pu-â Néu-kí-nui-â	Papúa Nueva Guinea
Vî-lièn Sâ-sṳ-pí-â	William Shakespeare
Â (氬)	Argón
Kap	Potasio
Koi	Calcio
Yèn	Plomo
Mùng-kú-koet	Mongolia
Khong (鈧)	Escandio
Thai	Titanio
Genghis Khan	Gengis Kan
Fàm	Vanadio
Mien-yîn	Maine
Kok	Cromo
Mâ	Equus ferus caballus
Thûng-vu̍t	Animalia
Sû-li-nàm	Surinam
Màng	Manganeso
Pâ-lâ-kûi	Paraguay
Koi-â-nâ	Guyana
Ngi-su̍t	Arte
Lòi	Renio
Kô-lùn-pí-â	Colombia
Kû	Cobalto
Vû	Wolframio
Ngiap (鎳)	Níquel
Fu̍t-kau	Budismo
Pô-li-vì-â	Bolivia
Tshṳ̀-nì-tha̍t lâu Tô-pâ-kô	Trinidad y Tobago
Chhṳ̍t-vu̍t	Plantae
Sîn	Cinc
Néu Hàn-pu-ha	Nuevo Hampshire
Pí-â-vùi-sṳ̂-thok-khiet	Białystok
Ngà-mâi-kâ	Jamaica
Mà-sat-chû-set	Massachusetts
Drenthe-sén	Drente
Overijssel-sén	Overijssel
Kûa-thi-mâ-là	Guatemala
Gelderland-sén	Güeldres
Pâ-hâ-mâ	Bahamas
Không-nái-tí-khiet-chû	Connecticut
Kiê-é	Gallus gallus domesticus
Ha-vî-yî	Hawái
Fùng-tû-lâ-sṳ̂	Honduras
Tô-mí-nì-kâ	Dominica
Tô-mí-nì-kâ Khiung-fò-koet	República Dominicana
Kâ-chû (Thung-vu̍t)	Sus scrofa domestica
Hói-thi	Haití
Sat-ngì-ngá-tô	El Salvador
Yî-lóng	Irán
Yî-là-khiet	Irak
Â-lâ-sṳ̂-kâ	Alaska
Kô-sṳ̂-tha̍t Lì-kâ	Costa Rica
Yî-set-lie̍t	Israel
Pâ-nâ-mâ	Panamá
Ya̍p-mùn	Yemen
Phiang-thu̍k	Virus
Pô-làn-ngî	Idioma polaco
Yok-tan	Jordania
Nì-kâ-lâ-kûa	Nicaragua
Fu-lò-lî-tha̍t	Florida
Kit-ngí-kit-sṳ̂-thán	Kirguistán
Â-li-sông-ná	Arizona
Khô-vî-thi̍t	Kuwait
Liàu-koet	Laos
Lì-pâ-nun	Líbano
O-le̍t-kông	Oregón
Gi-tuk-gaau zung geh sin	Dios en el cristianismo
Mâ-ngì-thoi-fû	Maldivas
Yù-thâ	Utah
Mâ-lòi-sî-â	Malasia
Mién-thien	Birmania
Nì-pok	Nepal
Â-man	Omán
Pâ-kî-sṳ̂-thán	Pakistán
Khà-tha̍t	Catar
Mióng-khiù	Tenis
Sâ-vû-thi Â-lâ-pak	Arabia Saudita
Sṳ̂-lî-làn-khà	Sri Lanka
Si-li-â	Siria
Kâ	Galio
Thap-kit-khiet-sṳ̂-thán	Tayikistán
中華民國	República de China
YouTube	YouTube
Châ	Germanio
Thai-koet	Tailandia
Sṳ̂n	Arsénico
Thú-khû-man-sṳ̂-thán	Turkmenistán
Abakan	Abakán
Sî	Selenio
Yî	Iridio
Â-lâ-pak Lièn-ha̍p Thai-kûng-koet	Emiratos Árabes Unidos
Tshiù (溴)	Bromo
Pha̍k (鉑)	Platino
Ye̍t-nàm	Vietnam
Thai-hòn Mìn-koet	Corea del Sur
Khiet	Kriptón
Â-fu-hon	Afganistán
J. R. R. Tolkien	J. R. R. Tolkien
Lù	Rubidio
Kîm	Oro
Men-kâ-lâ-koet	Bangladés
Ufa	Ufá
Ôn-kô-lâ	Angola
Vùn-lòi	Brunéi
Kúng	Mercurio (elemento)
Fî-li̍t-pîn	Filipinas
Thò	Talio
Ngie-sat-khiet Ngiù-tun	Isaac Newton
Albert Einstein	Albert Einstein
Sṳ̂	Estroncio
Yet	Itrio
Pit	Bismuto
Vòng-set	Amarillo
Tsan-pí-â	Zambia
Sîn-pâ-pu-vî	Zimbabue
北京	Pekín
Tuva Khiung-fò-koet	Tuvá
Pok-tshṳ-ngá-na̍p	Botsuana
Pho (釙)	Polonio
Bayern	Baviera
Baden-Württemberg	Baden-Wurtemberg
Ngo (砈)	Ástato
Lòi-sò-thok	Lesoto
Mâ-tha̍t-kâ-sṳ̂-kâ	Madagascar
Mâ-là-vî	Malaui
Stuttgart	Stuttgart
Màu-li-thap-nì-â	Mauritania
Pô-làn-ngìn	Pueblo polaco
Mo̍k-sông-pí-khiet	Mozambique
Na̍p-mí-pí-â	Namibia
Nai-khi̍p-li-â	Nigeria
Ko	Circonio
Nì	Niobio
Yû-li-vû-sṳ̂ Khái-sat	Julio César
Sṳ̂-vî-sṳ-làn	Suazilandia
Muk	Molibdeno
Thap	Tecnecio
Hamburg	Hamburgo
Thoi-chhia	Metabolismo
Miên-yi̍t Hì-thúng	Sistema inmunitario
Lièn-ha̍p-koet	Organización de las Naciones Unidas
Sîm-chhong	Corazón
Thèu-nó	Cerebro
Phì-fû	Piel
Ló	Rodio
Làm-set	Azul
Pâ	Paladio
Ngiùn	Plata
Kak	Cadmio
Yîn	Indio (elemento)
Siak	Estaño
Yu	Uranio
Thi (銻)	Antimonio
Ti	Telurio
Pu	Plutonio
Tièn	Yodo
Nai	Neptunio
Set	Cesio
Phù	Protactinio
Pi	Bario
Thú	Torio
Kap (鉿)	Hafnio
Than (鉭)	Tantalio
Luì	Radio (elemento)
Tûng	Radón
Alsace	Alsacia
Auvergne	Auvernia
Ôn-tet-là-pâng	Andhra Pradesh
Me̍t-hiet-kîn	Míchigan
Burgundy	Borgoña
Aquitaine	Aquitania
Schleswig-Holstein	Schleswig-Holstein
Hâ Saxony	Baja Sajonia
Pet Rhine-Westphalia	Renania del Norte-Westfalia
Saxony	Sajonia
Yî-li-nò	Illinois
Thuringia	Turingia
Saxony-Anhalt	Sajonia-Anhalt
Pet Tha̍t-khô-thâ	Dakota del Norte
Brandenburg	Brandeburgo
Bremen-chû	Bremen (estado)
Nàm Tha̍t-khô-thâ	Dakota del Sur
Mùng-thai-nâ	Montana
Fài-ngò-mìn	Wyoming
Yâ-lu-sat-lâng	Jerusalén
Oi-tha̍t-hòt	Idaho
Fà-sṳn-tun	Washington (estado)
Lù (鑪)	Rutherfordio
Nui-fà-tha̍t	Nevada
Hàn (𨧀)	Dubnio
Hí (𨭎)	Seaborgio
Yin-thu-yòng	Océano Índico
Khô-sò-vok	Kosovo
Kâ-le̍t-pí-hói	Mar Caribe
Pô (𨨏)	Bohrio
Het (𨭆)	Hassio
Phan Kî-vùn	Ban Ki-moon
Ma̍k (䥑)	Meitnerio
Khô-lò-là-tô	Colorado
Tha̍t	Darmstadio
Siau-pâng	Frédéric Chopin
Lùn	Roentgenio
Kô (鎶)	Copernicio
分類:Chú-yeu fûn-lui	Categoría:Índice de categorías
Chi-kâ-kô	Chicago
Arnhem	Arnhem
Tûng-kui	Invierno
Sî-pân-ngà-ngî	Idioma español
Fî-là-thiet-fî	Filadelfia
Tî-tû	Araneae
Hèu-è	Mono
Kîm-tshièn	Dinero
Vì-kit-nì-â	Virginia
Sî Vì-kit-nì-â	Virginia Occidental
Tshiâng-tséu	Capsicum annuum
Néu-yok-chû	Nueva York (estado)
Sṳ (鈰)	Cerio
Phú	Praseodimio
Lò-tet-tó	Rhode Island
Ńg	Neodimio
Khûn-chhùng	Insecta
Mâ-lî-làn	Maryland
Thi̍t-lâ-ngá	Delaware
Yû (銪)	Europio
Ngò-hài-ngò	Ohio
Vì-kit-ngì	Virgilio
Machiavelli	Nicolás Maquiavelo
Pîn-sé-fap-nì-â	Pensilvania
Uetersen	Uetersen
O-kú-sṳ̂-tû	César Augusto
Néu Chhe̍t-sî-chû	Nueva Jersey
Fûn-làn-ngî	Idioma finés
Yin-thi-ôn-na̍p	Indiana
Vì-sṳ̂-pha-siên	Tito Flavio Vespasiano
Thù-là-chṳ̂n	Trajano
Hâ-tet-liòng	Adriano
Khièu-tshṳ-â	Georgia (Estados Unidos)
Mâ-khù-sṳ̂ O-lie̍t-lî-vû-sṳ̂	Marco Aurelio
Zagreb	Zagreb
Tet-khiet-sat-sṳ̂	Texas
Thai-mí-ngì-na̍p-tet-pâng	Tamil Nadu
Pet Khà-lò-lòi-na̍p	Carolina del Norte
Nàm Khà-lò-lòi-na̍p	Carolina del Sur
Loire-sén	Río Loira
Pâ-set-lò-nâ	Barcelona
Vòng-lî	Ananas comosus
Me̍t-sî-sî-pí	Misisipi
Thièn-na̍p-sî	Tennessee
Néu Me̍t-sî-kô	Nuevo México
Mìn-nì-sû-tha̍t	Minnesota
Vî-sṳ̂-không-sîn	Wisconsin
Oi-hò-fà	Iowa
Nui-pu-lâ-sṳ̂-kâ	Nebraska
Khâm-sat-sṳ̂	Kansas
Yin-thi-ngî	Hindi
Me̍t-sû-lî	Misuri
Lu-yi-sṳ̂-ôn-ná	Luisiana
Khén-thap-kî	Kentucky
Â-khén-set	Arkansas
Neil Armstrong	Neil Armstrong
O-khiet-lâ-hò-mâ	Oklahoma
Pet-hói	Mar del Norte
Mo̍k-sṳ̂-khô-chû	Óblast de Moscú
Kiel	Kiel
Schwerin	Schwerin
Potsdam	Potsdam
Hanover	Hannover
Düsseldorf	Düsseldorf
Mainz	Maguncia
Wiesbaden	Wiesbaden
Saarbrücken	Sarrebruck
Mu-nì-het	Múnich
Erfurt	Érfurt
Dresden	Dresde
Kaliningrad-chû	Óblast de Kaliningrado
Murmansk-chû	Óblast de Múrmansk
Kak-than-sṳ̂-khiet	Gdansk
Fap-làn-khiet-fuk	Fráncfort del Meno
Fut-lò-tshṳ-ngá-fû	Breslavia
Làn	Lantano
Ki (鉕)	Prometio
Sân	Samario
Â-chhè Thi̍t-phe̍t Hàng-chṳn-khî	Aceh
Nga̍t (釓)	Gadolinio
Thi̍t (鋱)	Terbio
Tit (鏑)	Disprosio
Sṳn-kîn	Biblia
Fó	Holmio
Ngí (鉺)	Erbio
Tiû	Tulio
Yi	Iterbio
Liu	Lutecio
Hò-nui-sṳ	Hanói
Chṳ̂n Yâ-sû Kau-fi	Verdadera Iglesia de Jesús
Yîn-ngî	Idioma inglés
Màn-kuk	Bangkok
Kit-lùng-po	Kuala Lumpur
Pâng-kâ Vú-lî-thung-sén	Bangka-Belitung
Thòi-pet-sṳ	Taipéi
Mî (鋂)	Americio
Arkhangelsk-chû	Óblast de Arcángel
Khiu̍k	Curio
Thùng-hói-sṳ	Đồng Hới
Concepción	Concepción (Chile)
Pet (鉳)	Berkelio
Khà (鉲)	Californio
Mìn-kú-lû-sén	Bengkulu
Oi	Einstenio
Fi	Fermio
Mùn	Mendelevio
Na	Nobelio
Ontario-sén	Ontario
Lò	Lawrencio
Karelia Khiung-fò-koet	República de Carelia
Końskowola	Końskowola
2002-ngièn	2002
2008-ngièn	2008
Charles de Gaulle	Charles de Gaulle
Cham-pî-sén	Jambi (provincia)
Komi Khiung-fò-koet	Komi
Nâm-póng-sén	Lampung
Pet Sû-mùn-tap-lia̍p-sén	Sumatra Septentrional
Syktyvkar	Syktyvkar
Québec-sṳ	Quebec (ciudad)
Nenets Chhṳ-chhṳ-khî	Nenetsia
Liàu-nui-sén	Riau
Leningrad-chû	Óblast de Leningrado
Pskov-chû	Óblast de Pskov
Nizhny Novgorod-chû	Óblast de Nizhni Nóvgorod
Nàm Sû-mùn-tap-lia̍p-sén	Sumatra Meridional
Lò-mâ Ti-koet	Imperio romano
Mì-ngiôn Kûng-sṳ̂	Microsoft
Tver-chû	Óblast de Tver
Khù-lû-fû	Kurów
Fa-ho̍k	Química
Smolensk-chû	Óblast de Smolensk
Yaroslavl-chû	Óblast de Yaroslavl
Kostroma-chû	Óblast de Kostromá
Ivanovo-chû	Óblast de Ivánovo
Arnold Schwarzenegger	Arnold Schwarzenegger
Chiuk-khiù	Fútbol
Ryazan-chû	Óblast de Riazán
IPhone	IPhone
Sî Sû-mùn-tap-lia̍p-sén	Sumatra Occidental
Tula-chû	Óblast de Tula
IPad	IPad
Mâ-tet-lî	Madrid
Bryansk-chû	Óblast de Briansk
Michael Jackson	Michael Jackson
Kaluga-chû	Óblast de Kaluga
Loire-Atlantique-sén	Loira Atlántico
Ain-sén	Ain
Allier-sén	Allier
Khâm-phì-là	Canberra
Sông Alpes-sén	Altos Alpes
Oryol-chû	Óblast de Oriol
Sit-nì	Sídney
Alpes-de-Haute-Provence-sén	Alpes de Alta Provenza
Liu̍k-set	Verde
Alpes-Maritimes-sén	Alpes Marítimos (departamento de Francia)
Hâ-tet-sùn-hò	Río Hudson
Me̍t-ngì-pún	Melbourne
Fùng-set	Rojo
Ardèche-sén	Ardèche
Jena	Jena
Kursk-chû	Óblast de Kursk
Ariège-sén	Ariège
Aude-sén	Aude
Aveyron-sén	Aveyron
Sîn Nàm Vî-ngì-sṳ̂-chû	Nueva Gales del Sur
Bouches-du-Rhône-sén	Bocas del Ródano
Àu-thai-li-â Sú-tû Liâng-thi	Territorio de la Capital Australiana
Cantal-sén	Cantal
Belgorod-chû	Óblast de Bélgorod
Côte-d'Or-sén	Côte-d'Or
Côtes-d'Armor-sén	Côtes-d'Armor
Drôme-sén	Drôme
Finistère-sén	Finisterre (Francia)
Voronezh-chû	Óblast de Vorónezh
Sû-mùn-tap-lia̍p	Sumatra
Lipetsk-chû	Óblast de Lípetsk
Van-tan-sén	Bantén (provincia)
Chûng Cháu-ôa-sén	Java Central
Fùi-sên	Cometa
Rostov-chû	Óblast de Rostov
Tûng Cháu-ôa-sén	Java Oriental
Ngâ-kâ-tha̍t Sú-tû Thi̍t-khî	Yakarta
Sî Cháu-ôa-sén	Java Occidental
Adygea Khiung-fò-koet	Adigueya
Ngit-ngiâ Thi-fông Thi̍t-khî	Yogyakarta
Gera	Gera
Maykop	Maikop
Cháu-ôa-tó	Java (isla)
Kâ-lî-man-tân-chû	Kalimantan
Séu Sùn-thâ Khiùn-tó	Islas menores de la Sonda
Sû-lâ-vî-sî-tó	Célebes
Mô-lu̍k-kâ Khiùn-tó	Islas Molucas
Chûng Kâ-lî-man-tân-sén	Borneo Central
Tûng Kâ-lî-man-tân-sén	Kalimantan Oriental
Nàm Kâ-lî-man-tân-sén	Borneo Meridional
Kâ-li-sî-â	Galicia
Sî Kâ-lî-man-tân-sén	Borneo Occidental
Thai-ho̍k	Universidad
Pretoria	Pretoria
Chok-khiù	Tenis de mesa
Â-sṳ̂-thù-lî-â-sṳ̂	Asturias
Wikipedia:Sandbox	Wikipedia:Zona de pruebas
Astrakhan-chû	Óblast de Astracán
Kham-thap-pu-lî-â	Cantabria
Kalmykia Khiung-fò-koet	Kalmukia
Weimar	Weimar
Osasco	Osasco
Â-là-kung	Aragón
Kak-là-sṳ̂-kô	Glasgow
Thùng-hói Kî-chhòng	Aeropuerto de Đồng Hới
Vú-lîn-ngièn Fûng-kín Miàng-sṳn-khî	Wulingyuan
分類:Thòi-vân li̍t-sṳ́	Categoría:Historia de Taiwán
Curitiba	Curitiba
Chloë Grace Moretz	Chloë Grace Moretz
Khûng-chṳ́	Confucio
Corbin Bleu	Corbin Bleu
分類:Sṳ-ho̍k	Categoría:Matemáticas
分類:Ngìn-kûng ngî-ngièn	Categoría:Lenguas artificiales
Pâ-lî-sén	Bali
Mî-kîm	Dólar estadounidense
Thi-chûng-hói	Mar Mediterráneo
Hông-chû-sṳ	Hangzhou
Kî-tuk-kau	Cristianismo
Tûng Nú-sâ Tên-kâ-là-sén	Islas menores de la Sonda orientales
Sî Nú-sâ Tên-kâ-là-sén	Islas menores de la Sonda occidentales
Chûng Sû-lâ-vî-sî-sén	Célebes Central
Kô-lùn-tá-lo̍k-sén	Gorontalo
Pet Sû-lâ-vî-sî-sén	Célebes Septentrional
Tûng-nàm Sû-lâ-vî-sî-sén	Célebes Suroriental
Nàm Sû-lâ-vî-sî-sén	Célebes Meridional
Sî Sû-lâ-vî-sî-sén	Célebes Occidental
Vò-é	Arroz
Mâ-lû-kú-sén	Molucas (provincia)
Pet Mâ-lû-kú-sén	Molucas septentrionales
Pâ-pu-â-sén	Papúa (provincia)
Sî Pâ-pu-â-sén	Provincia de Papúa Occidental
Dagestan Khiung-fò-koet	Daguestán
Sú-tû	Capital (política)
Monzón	Monzón (Huesca)
Phù-thò-ngà-ngî	Idioma portugués
Ngie̍t	Mes
Mustafa Kemal Atatürk	Mustafa Kemal Atatürk
Makhachkala	Majachkalá
Chechnya Khiung-fò-koet	Chechenia
Grozny	Grozni
Almazán	Almazán
Vòng Hien-fàm	Huang Xianfan
Ingushetia Khiung-fò-koet	Ingusetia
Magas	Magás
Pet Ossetia–Alania Khiung-fò-koet	Osetia del Norte-Alania
Kabardino-Balkaria Khiung-fò-koet	Kabardia-Balkaria
Tson-sa̍k	Diamante
Bill Gates	Bill Gates
Ngi̍t-ngî	Idioma japonés
Pak-khô-chhiòn-sû	Enciclopedia
頭頁	Wikipedia:Portada
Karachay-Cherkessia Khiung-fò-koet	Karacháyevo-Cherkesia
Saratov	Sarátov
Saratov-chû	Óblast de Sarátov
Orenburg-chû	Óblast de Oremburgo
Mordovia Khiung-fò-koet	Mordovia
Saransk	Saransk
Yâ-khiù	Béisbol
Làm-khiù	Baloncesto
Kirov-chû	Óblast de Kírov
Udmurtia Khiung-fò-koet	Udmurtia
Sî-pak-li-â	Siberia
Mari El Khiung-fò-koet	Mari-El
Yoshkar-Ola	Yoshkar-Olá
Stellenbosch	Stellenbosch
Sverdlovsk-chû	Óblast de Sverdlovsk
Cape Town	Ciudad del Cabo
Chuvash Khiung-fò-koet	Chuvasia
Durban	Durban
Cheboksary	Cheboksary
Tat-tat-sṳ̂-thán Khiung-fò-koet	Tartaristán
Penza-chû	Óblast de Penza
Là-fî-ngì	Rafael Sanzio
Pí-tet Lû-pún-sṳ̂	Peter Paul Rubens
Ulyanovsk-chû	Óblast de Uliánovsk
Gung-gung-hi-tsaa	Autobús
Kâ-thai-lò-nì-â	Cataluña
Bashkortostan Khiung-fò-koet	Baskortostán
Chelyabinsk-chû	Óblast de Cheliábinsk
Pâ-lùn-sî-â Chhṳ-chhṳ-khî	Comunidad Valenciana
Khà-sṳ̂-tì-li-â lâu Lòi-ngong	Castilla y León
Kurgan-chû	Óblast de Kurgán
Mô Chhe̍t-tûng	Mao Zedong
Tyumen-chû	Óblast de Tiumén
Omsk-chû	Óblast de Omsk
Thai-mí-ngì-ngî	Idioma tamil
Chet-ho̍k	Filosofía
分類:Candidates for speedy deletion	Categoría:Wikipedia:Borrar (definitivo)
Altai Khiung-fò-koet	República de Altái
Kòng-khìm	Piano
Gorno-Altaysk	Gorno-Altaisk
Kemerovo-chû	Óblast de Kémerovo
Hebe Camargo	Hebe Camargo
Chṳ̂-pún chú-ngi	Capitalismo
Koet-kâ	País
Mìn-chhu̍k	Nación
Khanty-Mansi Chhṳ-chhṳ-khî	Janty-Mansi
Yamalo-Nenets Chhṳ-chhṳ-khî	Yamalia-Nenetsia
Montpellier	Montpellier
分類:Thiên-vùn-ho̍k	Categoría:Astronomía
Khakassia Khiung-fò-koet	Jakasia
Irkutsk-chû	Óblast de Irkutsk
Sakha Khiung-fò-koet	República de Sajá
Khiet-lò-âi-sî-â-ngî	Idioma croata
Hon-pó	Hamburguesa
Buryatia Khiung-fò-koet	Buriatia
Vû-làn Vû-tet	Ulán-Udé
Amur-chû	Óblast de Amur
Ngi-sṳ̍p Sṳ-ki	Siglo XX
Gotha	Gotha
Dijon	Dijon
Kâ-thai-lò-nì-â-ngî	Idioma catalán
Nordhausen	Nordhausen
Kit-lò-na̍p-sén	Gerona
Eisenach	Eisenach
Se-pâu Sâng-vu̍t-ho̍k	Biología celular
Sṳ-kie Ngiùn-hòng Si̍p-thòn	Banco Mundial
A-la-pak Liên-mên	Liga Árabe
Mìn-tsú Tsú-ngi	Democracia
Chhîn-chhèu (秦朝)	Dinastía Qin
Pet Thai-sî-yòng Kûng-yok Chû-chṳt	OTAN
Chhìn Sṳ Fòng	Qin Shi Huang
Hon-chhèu	Dinastía Han
Hon Vú-ti Liù Chha̍t	Emperador Wu
Sâng-vu̍t	Ser vivo
Kiûn-chú-chṳ	Monarquía
Khiung-fò-koet	República
Yí-mô-khiù	Bádminton
Ngièn-chhèu	Dinastía Yuan
Nazi Tet-koet	Alemania nazi
Yù-thai-ngìn	Pueblo judío
Chang Fò	Zheng He
Chìn-chhèu	Dinastía Jin (265-420)
Ngí	Oído
Phi	Nariz
Ngién	Ojo
Mûn-é	Culicidae
Mièn-yòng	Ovis orientalis aries
Lo̍k-thò	Camelus
Phú-nen thung-vu̍t	Mammalia
Ngie-kûng	Formicidae
Phûng-é	Anthophila
Hò-làn-ngî	Idioma neerlandés
Fà-thi̍t Thit-sṳ-nì Kûng-sṳ̂	The Walt Disney Company
Thot-yong Fu̍t-thông Fu̍t-son	Ácido desoxirribonucleico
Khiô	Solanum melongena
Siet	Nieve
Â-pâ	Padre
Fûn	Minuto
Yù-thai Chhṳ-chhṳ-chû	Óblast Autónomo Hebreo
Ngò-lò-sṳ̂-ngî	Idioma ruso
Tûng-nàm-â Koet-kâ Lièn-mèn	Asociación de Naciones del Sudeste Asiático
Sakhalin-chû	Óblast de Sajalín
Mien-pâu	Pan
Sṳ-kie Mo-yi Chû-chṳt	Organización Mundial del Comercio
漢語	Idioma chino
Se-pâu	Célula
Hiet-yi̍t	Sangre
Hi	Pulmones
Lò-mâ-nì-â-ngî	Idioma rumano
Pó-kâ-li-â-ngî	Idioma búlgaro
Magadan-chû	Óblast de Magadán
Chhṳ-yèn Khô-ho̍k	Ciencias naturales
Het-chhe̍t Mìn	Akira Kurosawa
Franklin D. Roosevelt	Franklin D. Roosevelt
Thi-khiù Khô-ho̍k	Ciencias de la Tierra
Sa̍k-thèu	Roca
Yùn	Nube
Kí-hò-ho̍k	Geometría
Tet-lu-kú-ngî	Idioma télugu
Thai-hì-chhèn	Atmósfera
Kak-lû-kit-â-ngî	Idioma georgiano
Kîn-chi-ho̍k	Economía
Pîn-kóng	Pangkal Pinang
漢字	Sinograma
Sî-lî-ngì Sṳ-mû	Alfabeto cirílico
Lâ-tên sṳ-mû	Alfabeto latino
Vùn-ho̍k	Literatura
分類:Fap-koet	Categoría:Francia
分類:Yîm-ngo̍k	Categoría:Música
分類:Vùn-ho̍k	Categoría:Literatura
La̍p-pá	Trompeta
Â-li̍t-sân-thai sâm-sṳ	Alejandro Magno
Kiûn-sṳ-thán-tên Yit-sṳ	Constantino I (emperador)
Set-lû-sṳ thai-ti	Ciro II el Grande
Vùn-mìn	Civilización
Kau-yuk	Educación
Kâ-thìn	Familia
Nàm-ngìn	Varón
Fûn-yîn	Matrimonio
Kiûn-sṳ	Militar
Kâ-pî	Café
Ngiù-nen	Leche
Sûn Chûng-sân	Sun Yat-sen
Â-yuk-vòng	Aśoka
香港	Hong Kong
Thai-yîn Ti-koet	Imperio británico
Sú-ngì	Seúl
Kâm-nái-thit Koet-chi Kî-chhòng	Aeropuerto Internacional John F. Kennedy
上海	Shanghái
Lùn-tûn Hî-sṳ̂-lu Kî-chhòng	Aeropuerto de Londres-Heathrow
Lùn-tûn Kak-vet Kî-chhòng	Aeropuerto de Londres-Gatwick
Set-vì-li-â	Sevilla
Chhîn-chhèu	Dinastía Qing
Â-ngì-pâ-nì-â-ngî	Idioma albanés
Pâ-sṳ̂-khiet-ngî	Euskera
Â-lâ-kung-ngî	Idioma aragonés
Yîn-koet Hòng-khûng	British Airways
Â-mî-nì-â-ngî	Idioma armenio
Vû-khiet-làn-ngî	Idioma ucraniano
Pâ-lùn-sî-â	Valencia
Shuì-tién-ngî	Idioma sueco
Tan-ma̍k-ngî	Idioma danés
Nò-vî-ngî	Idioma noruego
Kô-thi̍t-fu̍t-lòi-tet Vî-liâm Lòi-pu-nì-tsṳ	Gottfried Leibniz
Tshia̍p-khiet-ngî	Idioma checo
Sṳ̂-lo̍k-phat-khiet-ngî	Idioma eslovaco
Sṳ̂-lo̍k-vì-nì-â-ngî	Idioma esloveno
Hiûng-ngà-li-ngî	Idioma húngaro
Oi-sâ-nì-â-ngî	Idioma estonio
Là-thot-vì-â-ngî	Idioma letón
Li̍p-thâu-vón-ngî	Idioma lituano
Pha̍k-ngò-lò-sṳ̂-ngî	Idioma bielorruso
Kui-mí-thi̍t-lî Mùn-tet-lie̍t-fû	Dmitri Mendeléyev
Ngièn-chṳ́	Átomo
Lâ-set-fuk	Ernest Rutherford
Hî-lia̍p-ngî	Idioma griego
Oi-ngì-làn-ngî	Idioma irlandés
Pô-sṳ̂-ngî	Idioma persa
Chûng-kau	Religión
Chêu-sién-ngî	Idioma coreano
Chhóng-sṳ-ki	Génesis
Kóng-tûng-fa	Cantonés estándar
Chhut-âi-khi̍p-ki	Éxodo
Ye̍t-nàm-ngî	Idioma vietnamita
Pó-lò	Pablo de Tarso
Kô-mièn-ngî	Idioma camboyano
Thai-ngî	Idioma tailandés
Mâ-lòi-ngî	Idioma malayo
Yin-nì-ngî	Idioma indonesio
Mùng-kú-ngî	Idioma mongol
Hâ-sat-khiet-ngî	Idioma kazajo
Vû-tsṳ̂-phe̍t-khiet-ngî	Idioma uzbeko
Thú-khù-màn-ngî	Idioma turcomano
Yù-thai-kau	Judaísmo
Hî-pak-lói-ngî	Idioma hebreo
Â-set-pai-kiông-ngî	Idioma azerí
Mâ-khì-tun-ngî	Idioma macedonio
Set-ngì-vì-â-ngî	Idioma serbio
Set-ngì-vì-â Khiet-lò-thi-â-ngî	Idioma serbocroata
Pô-sṳ-nì-â-ngî	Idioma bosnio
Kâ-lî-sî-â-ngî	Idioma gallego
Vî-ngì-sṳ̂-ngî	Idioma galés
Sû-kak-làn Koi-ngì-ngî	Gaélico escocés
Siak-khiet-kau	Sijismo
John Maynard Keynes	John Maynard Keynes
Lufthansa Hòng-khûng	Lufthansa
Ló-chṳ́	Lao-Tsé
Kôn-chhóng	Hígado
Shìn	Riñón
Sṳ̀n-kîn Ne-thúng	Sistema nervioso
Sîm-lî-ho̍k	Psicología
Sṳt-kâ-mèu-nì	Buda Gautama
Mâ-tên Lu-tet	Martín Lutero
Yî-kâ	Confucianismo
Thiên-chú-kau	Iglesia católica
Tho-kau	Taoísmo
Chit-siói	Médula espinal
Sa̍t	Lengua (anatomía)
Yî-tshóng	Páncreas
Hèu-thèu	Laringe
Fuk-khiet-làn khiùn-tó	Islas Malvinas
Vàng-kak-mo̍k	Diafragma (anatomía)
Lân-mî	Apéndice vermiforme
Elizabeth Ngi-sṳ	Isabel II del Reino Unido
Thòng-chhèu	Dinastía Tang
John F. Kennedy	John F. Kennedy
Mìn-chhèu	Dinastía Ming
Dwight D. Eisenhower	Dwight D. Eisenhower
Ronald Reagan	Ronald Reagan
Sat-là-kô-sat	Zaragoza
Kîm Tsang-ngit	Kim Jong-il
Ngièn-su Chû-khì-péu	Tabla periódica de los elementos
Chû-su̍k	Sus
Mariano Rajoy	Mariano Rajoy
Se-khiûn	Bacteria
Phù-thò	Uva
Phûng-thòng	Miel
Thông	Azúcar
Vòng-theu	Glycine max
Kûng-chhàng-ho̍k	Ingeniería
Vùn-fa	Cultura
Fan-vun	Sánscrito
Sùn-fàn Hì-thúng	Aparato circulatorio
Sôn	Ácido
Yî-ho̍k	Medicina
Néu-Yok Sṳ-kie Mo-yi Chûng-sîm	World Trade Center
Hâ Màn-hâ-tun	Lower Manhattan
Yàm	Sal
分類:Pâ-sî	Categoría:Brasil
Màn-hâ-tun	Manhattan
Ngièn-su	Elemento químico
Kâ-suk-thu	Aceleración
Li̍t	Fuerza
Kú	Tambor
Tsṳt-liông	Masa
Thien-yáng	Película
Kîm-su̍k	Metal
Nùng-ngia̍p	Agricultura
Sâng-yîm	Sonido
Sṳ̀-kiên	Tiempo
Mien-chit	Área
Kûng-kîn	Kilogramo
Kûng-tshak	Metro
Miéu	Segundo
Pâu-siuk	Zea mays
Kûng-sṳ̂n	Litro
Fà-ngì-kiê	Wall Street
Tûng-nàm-â	Sudeste Asiático
Tshùng-khin	Chongqing
Thiên-tsîn	Tianjín
Vú-hon-sṳ	Wuhan
Kú Hî-lia̍p	Antigua Grecia
Thomas Jefferson	Thomas Jefferson
Vùi-sṳ̂-khà	Huesca
Tychy	Tychy
El Masnou	El Masnou
Pu-lie̍t-thap-nì-ngî	Idioma bretón
Brittany	Bretaña
Lóng	Sordera
Chhi̍t-phiang	Enfermedad
Khien-không	Salud
Sok-lî-â	Soria
Màn-tó-ngî	Idioma manés
Chhiâng-môi-su	Penicilina
Nantes	Nantes
Pot-thâm-fó	Tuberculosis
Mà-chiông	Mahjong
模板:Location map Taiwan	Plantilla:Mapa de localización de República de China
Detroit	Detroit
Van-lî Tshòng-sàng	Gran Muralla China
Gard-sén	Gard
Gers-sén	Gers (departamento)
Sông Garonne-sén	Alto Garona
Sṳ̀n-sṳn Lò-mâ Ti-koet	Sacro Imperio Romano Germánico
Ille-et-Vilaine-sén	Ille y Vilaine
Isère-sén	Isère
Chûng-kau Kói-kiet	Reforma protestante
Sông Loire-sén	Alto Loira
Lot-sén	Lot (departamento)
Lozère-sén	Lozère
Maine-et-Loire-sén	Maine y Loira
Nì-pu-kap-nì-sat ngi-sṳ	Nabucodonosor II
Mayenne-sén	Mayenne
Morbihan-sén	Morbihan
Nièvre-sén	Nièvre
Nord-sén	Norte (Francia)
Calais Hói-hia̍p-sén	Paso de Calais (departamento)
Puy-de-Dôme-sén	Puy-de-Dôme
Sông Pyrénées-sén	Altos Pirineos
Pyrénées-Orientales-sén	Pirineos Orientales
Hâ Rhin-sén	Departamento del Bajo Rin
Sông Rhin-sén	Alto Rin
Saône-et-Loire-sén	Saona y Loira
Sarthe-sén	Sarthe
Sông Savoie-sén	Alta Saboya
Tarn-sén	Departamento de Tarn
Tarn-et-Garonne-sén	Tarn y Garona
Var-sén	Var
Vaucluse-sén	Vaucluse
Vendée-sén	Vandea
Yonne-sén	Yonne
Yî-pí-li-â Pan-tó	Península ibérica
Lai-kî	Litchi chinensis
Yâ-è	Cocos nucifera
Sa̍k-liù	Punica granatum
Chong-fa	Idioma chuang
Sông-sok-pu-ngî	Alto sorabo
Na̍p-ngá-thi̍t-ngî	Náhuatl
Mí-nàm-kâ-pó-ngî	Idioma minangkabau
Mirandés-ngî	Mirandés (asturleonés de Tierra de Miranda)
Harvard Thai-ho̍k	Universidad de Harvard
Néu-yok Chṳn-khèn Kâu-yi-só	Bolsa de Nueva York
Lie̍t-yî-tha̍t-sén	Provincia de Lérida
Â-lâ-pak-ngî	Idioma árabe
Kiú-chiu	Kyūshū
Si-koet	Región de Shikoku
O-khiet-ngî	Idioma occitano
Nàm-fî Hò-làn-ngî	Afrikáans
Lí Mìn-pok	Lee Myung-bak
Lû Vú-hién	Roh Moo-Hyun
Kâ Mà-chiok	Passer domesticus
Kô-thiet	Metro de Hong Kong
澳門	Macao
Suhl	Suhl
Mühlhausen	Mühlhausen
Sâ-thièn-khî	Sha Tin
Fù Kím-Thàu	Hu Jintao
Si̍p Khiûn-phìn	Xi Jinping
Chhòng-kiáng-lu̍k	Giraffa camelopardalis
Phì-âi-mùng-thi̍t-ngî	Idioma piamontés
Thap-là-kô-na̍p	Tarragona
Provence-Alpes-Côte d'Azur	Provenza-Alpes-Costa Azul
Chhṳ̂m-chun-sṳ	Shenzhen
Kóng-tûng	Provincia de Cantón
Kóng-sî Chong-chhu̍k Chhṳ-chhṳ-khî	Guangxi
Mô-kài	El Señor de los Anillos
Borredà	Borredá
Castellar de n'Hug	Castellar de Nuch
Hiông-kóng Thai-ho̍k	Universidad de Hong Kong
Badajoz	Badajoz
Lu̍k-yì-tó-yen	Prefectura de Kagoshima
Kiok	Pie
Sit-thit	Lacertilia
Altenburg	Altenburgo
Kiên	Hombro
Midi-Pyrénées	Mediodía-Pirineos
模板:Link FA	Plantilla:Destacado
Wikipedia:Chhâm-siòng	Wikipedia:Café
Fu-mùng-thi̍t	Vermont
Hiû-sṳ̂-tûn	Houston
Kóng-chiu-sṳ	Cantón (China)
Chiông Kie-sa̍k	Chiang Kai-shek
Vûn Kâ-pó	Wen Jiabao
Nàm-kîn-sṳ	Nankín
Phiang-yèn	Hospital
Kông-sû	Jiangsu
Chet-kông-sén	Zhejiang
Thèn Séu-phìn	Deng Xiaoping
Pet-phu Calais Hói-hia̍p	Norte-Paso de Calais
Pays de la Loire	Países del Loira
Languedoc-Roussillon	Languedoc-Rosellón
Thiap-sat-lò-nì-kâ	Salónica
西藏自治區	Tíbet
Thò-niâu	Struthio camelus
Manchester	Mánchester
Pu-lû-khiet-lìm	Brooklyn
Fòng-heu-khî	Queens
Liùng-yìn-sṳ	Yongin
Lòng	Canis lupus
Mâ-lòi Pan-tó	Península de Malaca
Sîn-yok Sṳn-kîn	Nuevo Testamento
9	Nueve
Zung-gok Thaai-liuk	China continental
Het-liùng-kông	Heilongjiang
Mâ Yîn-kiú	Ma Ying-jeou
Piên-fò-sṳ	Biên Hòa
Hiông-kóng-tó	Isla de Hong Kong
Ngà-tsông-sṳ	Nha Trang
Podolsk	Podolsk
Pô-tô Lì-kok Thu̍k-li̍p-tóng	Partido Independentista Puertorriqueño
Lì-è	Equus africanus asinus
Si-chhôn-sén	Sichuan
Khiu-yok Sṳn-kîn	Antiguo Testamento
Sṳn-tan-chiet	Navidad
Lò-màn Ngî-chhu̍k	Lenguas romances
Sâm-kok-hìn	Triángulo
Steve Jobs	Steve Jobs
Yin-Êu Ngî-ne	Lenguas indoeuropeas
Breinigerberg	Breinigerberg
Lo-fú	Panthera tigris
Fù-ôn Khà-lo̍k-sṳ̂ Yit-sṳ	Juan Carlos I de España
Súi-ngièn-sṳ	Suwon
Sâm-sên Si̍p-thòn	Samsung
Louis Couturat	Louis Couturat
Thai-thièn Kóng-vet-sṳ	Daejeon
Kîn-ki-tho	Gyeonggi
Sṳ̂-khâm-tit-nâ-vì-â	Escandinavia
Fu̍k-fa̍t-chiet	Pascua
Thien-nó Khô-ho̍k	Ciencias de la computación
Koet-chi Yîm-phiêu	Alfabeto Fonético Internacional
Hò-pet	Hebei
Phú-lìm-sṳ̂-tun Thai-ho̍k	Universidad de Princeton
Fôn-hìn-muk	Ciconiiformes
Chhṳ̀n Súi-pién	Chen Shui-bian
台灣	Isla de Taiwán
Chṳ-fi-hîn Sú-kî	Teléfono inteligente
Sa̍k-yù	Petróleo
Hài-è	Zapato
Ngiùn-hòng	Banco
Ngièn-lun Chhṳ-yù	Libertad de expresión
Oi-ngì-làn	Irlanda (isla)
Cheshire	Cheshire
Cumbria	Cumbria
Lancashire	Lancashire
Northumberland	Northumberland
Tyne and Wear	Tyne y Wear
County Durham	Condado de Durham
Pet Yorkshire	Yorkshire del Norte
Lincolnshire	Lincolnshire
Nottinghamshire	Nottinghamshire
Derbyshire	Derbyshire
Merseyside	Merseyside
Leicestershire	Leicestershire
Rutland	Rutland
Lû-sùn	Lu Xun
Northamptonshire	Northamptonshire
Devon	Devon
Oxfordshire	Oxfordshire
Wiltshire	Wiltshire
Hampshire	Hampshire
Buckinghamshire	Buckinghamshire
Surrey	Surrey
West Sussex	Sussex Occidental
East Sussex	Sussex Oriental
Kent	Kent
Thai Lùn-tûn	Gran Londres
7	Siete
8	Ocho
Lu̍k-é	Cervidae
Pên	Hielo
Chú ke Khì-tó-vùn	Padre nuestro
Ngìn-lui-ho̍k	Antropología
Fùng-hói	Mar Rojo
Oi-tên-páu	Edimburgo
Pha̍k-set	Blanco (color)
Marseille	Marsella
Thai-chhûng-thèu	Allium cepa
6	Seis
Kôn-fông ngî-ngièn	Idioma oficial
Kháu-kú-ho̍k	Arqueología
George H. W. Bush	George H. W. Bush
Pâ-ngì-kòn pan-tó	Península balcánica
Dmitry Medvedev	Dmitri Medvédev
Entrena	Entrena
Sîn-kau	Protestantismo
Selena	Selena Quintanilla Pérez
Mî-koet Thai-khûng Chúng-shu	NASA
Thai Put-lie̍t-tiên-tó	Gran Bretaña
Pâ-le̍t-sṳ̂-thán	Palestina (región)
10	Diez
Lila Downs	Lila Downs
Lia̍p-pau	Acinonyx jubatus
Liverpool	Liverpool
Bremen	Bremen
Sîn Nò-vî-ngî	Nynorsk
Meu-thèu-tiâu	Strigiformes
Sṳ̀	Hora
Fap-lò-ngî	Idioma feroés
Kîm-eu-sṳ	Cà Mau
Meu-khô	Felidae
Koet-chi Thai-khûng Chhàm	Estación Espacial Internacional
Tà-la-sṳ	Đà Lạt
Tat-tat-ngî	Idioma tártaro
Tshûng-liông	Peso
Tsûng-su	Phoenix dactylifera
Fan-tshiet-sṳ	Phan Thiết
Sî Fut-lî-sî-ngî	Lenguas frisonas
Séu Vòng-chṳ́	El principito
Phiàng-fông kûng-tshak	Metro cuadrado
Fó-yam-chhùng	Lampyridae
Li̍p-fông kûng-tshak	Metro cúbico
Fàn-chiet-thûng-vu̍t-mùn	Annelida
Chhú-khô	Muridae
Lû-sêm-nì-â-ngî	Idioma rusino
Fú-kîn	Orcinus orca
Sâ-thi̍t-fut-lî-sî-ngî	Frisón del Saterland
Liû-khiù-koet	Reino de Ryūkyū
Â-mê-ha̍p-lâ-ngî	Idioma amhárico
蝠婆	Chiroptera
Tarnobrzeg	Tarnobrzeg
Vòng Ti	Emperador amarillo
Tiau-ǹg-thòi Lie̍t-yí	Islas Senkaku
Khiung-fò-tóng (Mî-koet)	Partido Republicano (Estados Unidos)
Â-sṳ̂-thù-lî-â-sṳ̂-ngî	Asturiano (asturleonés de Asturias)
中國	China (región)
O-thi-li Pâ-vî-li-â-ngî	Idioma austro-bávaro
Mìn-chú-tóng (Mî-koet)	Partido Demócrata (Estados Unidos)
Sàng-tû-sṳ	Chengdú
Âi-sṳ̂-thi̍t-lùi-mâ-thu-lâ-ngî	Idioma extremeño
Séu-su mìn-chhu̍k	Minoría
Pô-lòi-kú	Pleiku
Â-ha̍p-sṳ̂-vòng	Ajaz
Chûng-chû-sṳ	Chungju
Yî-liàu Ví-sâng	Asistencia sanitaria
Yòng-suk-yen	Yangshuo
Khiet-là-khô-fû	Cracovia
臺灣省	Provincia de Taiwán
Pet-kîn Sú-tû Koet-chi Kî-chhòng	Aeropuerto Internacional de Pekín-Capital
Sîn-kâ-po Hòng-khûng Kûng-sṳ̂	Singapore Airlines
Thien-nó Thôn-chhèn Só-mèu	Tomografía axial computarizada
Vî-nî-sṳ̂-ngî	Idioma véneto
Koet-li̍p Thòi-vân Thai-ho̍k	Universidad de Taiwán
Vì-phú-sêm-ngî	Idioma vepsio
Fu̍t-lò-ngî	Idioma võro
Pân-mâ	Cebra
Valery Leontiev	Valery Leontiev
Khô-sî-kâ-ngî	Idioma corso
Buryat-ngî	Idioma buriato
Sùn-tho-chûng	Metodismo
Suk-vú-ngî	Idioma cebuano
Chavacano-ngî	Idioma chabacano
Chûng-pí-khô-ngì-ngî	Bicolano central
Tha̍t-lò-phî-thû Ngî-hì	Lenguas drávidas
Ló-kiê-sṳ	Lào Cai
客家語	Chino hakka
Fut-liù-li-ngî	Idioma friulano
Pâng-mî-tsuk	Buôn Ma Thuột
Kàm-ngî	Chino gan
Pok-vu̍t-kón	Museo
Yin-thu Yî-lóng Ngî-chhu̍k	Lenguas indoiranias
Thai-yùng-meu	Ailuropoda melanoleuca
Kalmyk-ngî	Idioma calmuco
Mân-ngî	Idioma manchú
Kû-li̍p ngî-ngièn	Lengua aislada
Kit-là-kî-ngî	Idioma guilakí
Khà-sû-pí-ngî	Idioma casubio
Karachay-Balkar-ngî	Idioma karachái-bálkaro
Lùn-pâ-tí-ngî	Idioma lombardo
Sú	Mano
Thu fú	Du Fu
O-lî-â-ngî	Idioma oriya
Ngìn-khiéu	Población
Nò-man-thi-ngî	Idioma normando
Pâng-â-sî-nâm-ngî	Idioma pangasinense
Pet-sat-mí-ngî	Sami septentrional
O-set-thôi-ngî	Idioma osetio
Sî-sî-lî-ngî	Idioma siciliano
Sat-tên-nî-â-ngî	Idioma sardo
Nì-ngá-ngì-ngî	Nepal bhasa
Valparaíso	Valparaíso
Yên-yèn	Actor
Thap-kâ-lo̍k-ngî	Idioma tagalo
Thùng	Bronce
Surigaonon-ngî	Idioma surigaense
Tausūg-ngî	Idioma joloano
Vlaams-ngî	Dialecto flamenco
Fà-liùng-ngî	Idioma valón
Sú-ngî	Lengua de señas
Yî-ngî	Idioma nuosu
Międzyrzec Podlaski	Międzyrzec Podlaski
Phiêu-chún Chhông-ngî	Idioma tibetano
Ngá-shuì-ngá-shuì-ngî	Idioma samareño
Yì-ku-tshu̍k	Yugur
N̂g-ngî	Chino wu
Woodrow Wilson	Woodrow Wilson
Fu̍t-sân-sṳ	Foshan
Ngiù-chîn Thai-ho̍k	Universidad de Oxford
Sú-tsṳ́	Dedo
Sṳ̍p-thiàu Kie-min	Diez Mandamientos
Yok-hon-nì-sṳ̂-páu	Johannesburgo
Kî-tuk Kau-fi	Iglesia
Pau-é	Panthera pardus
Sîn-kiông	Sinkiang
Muk-kôa	Carica papaya
Pu-lî-sṳ̂-pân	Brisbane
Vî-liâm Lùn-khìm	Wilhelm Röntgen
Chû-chhèu	Dinastía Zhou
Ido-ngî	Ido
Brad Pitt	Brad Pitt
Pa̍k-kiûng	Casa Blanca
Tha̍t-mâ-thai-ngî	Idioma dalmático
Tat-tat-chhu̍k	Tártaros
Thai-fán-sṳ	Osaka
Kiam-khiâu Thai-ho̍k	Universidad de Cambridge
Kûng-khín	Hectárea
Sé-lî	Bautismo
Pông-hâ	Asma
Chuk	Bambuseae
Hiligaynon-ngî	Idioma hiligainón
Fù Tsṳ-mìn	Hồ Chí Minh
Thièn-piên-fú	Điện Biên Phủ
Khûn-sṳ-làn-chû	Queensland
Ha-liùng-sṳ	Ha Long
Kûi-yìn-sṳ	Quy Nhơn
Mìn-nì-â-pô-li-sṳ̂	Minneapolis
Li-kú-lî-â-ngî	Idioma ligur
Phô-lò-chû	Isla de Borneo
Khà-phién-phién-kâm-ngî	Idioma pampango
Vù-fâ-kó	Ficus carica
Sun-fa-sṳ	Huế
Tshòng-thu	Longitud
Sṳ̂-chhù-chṳ̂-lu	Ruta de la seda
Mô-li-ngî	Idioma maorí
Mên-tûng-ngî	Min Dong
Mên-pet-ngî	Chino min bei
Tô-se-pâu sâng-vu̍t	Pluricelular
Mên-nàm-ngî	Chino min nan
Tshiên-ngièn	Milenio
Ho̍k-miàng	Nomenclatura binomial
Vì-tô-li-â-chû	Victoria (Australia)
Chong-chhu̍k	Etnia zhuang
Sông-hói-fa	Dialecto shanghainés
Aung San Suu Kyi翁山蘇姬	Aung San Suu Kyi
Yok-hon-fuk-yîm	Evangelio de Juan
William Vòng-chṳ́	Guillermo de Cambridge
Chhṳ̀n Kóng-sâng	Jackie Chan
12	Doce
Vok-là-phú-khiet-ngî	Volapük
Toshiro Mifune	Toshirō Mifune
Kám-lám-su	Olea europaea
Só-lò-mùn-vòng	Salomón
O-khiet-làn	Auckland
Chhṳ̍t-sien	Recta
11	Once
13	Trece
Sûn-chṳ́	Sun Tzu
Sṳn-lìn	Espíritu Santo
Lû-pu-lìm	Lublin
Thì-thèu	Arachis hypogaea
100	Cien
Tshit-thèu	Articulación de la rodilla
Tô-piên-hìn	Polígono (geometría)
Nàm Chûng-koet Hói	Mar de la China Meridional
Campora San Giovanni	Campora San Giovanni
Pien-set-liùng	Chamaeleonidae
Bloemfontein	Bloemfontein
Ngiam-set-thí	Cromosoma
O-khiet-làn Vùn-fap Ho̍k-káu	Auckland Grammar School
Ngióng-kông	Rangún
Ma̍k-tông-lò Kûng-sṳ̂	McDonald's
1000000	Millón
Meu-miàng-sṳ	Maoming
Liú-chiu-sṳ	Liuzhou
Pet-pan-khiù	Hemisferio norte
Ló-chhú	Mus (animal)
Het-tsṳ̂	Hercio
Pak-pân-khiet	Burbank
Sien-lia̍p-thí	Mitocondria
Yî-sên	Médico
Ki-sa̍k-chhṳn	Stonehenge
Chúng-thí Kîn-chi-ho̍k	Macroeconomía
Ágreda	Ágreda
Lu-kâ-fuk-yîm	Evangelio de Lucas
Sîn Kí-nui-â	Nueva Guinea
Sṳ́-thù-hàng-chhon	Hechos de los Apóstoles
Mô-hái	Brachyura
PH	PH
Khì-tó	Oración (religión)
Ôn-fui-sén	Anhui
Chûng-chhîn Pet-tho	Chungcheong del Norte
Chûng-chhîn Nàm-tho	Chungcheong del Sur
Kông-ngièn-tho (Hôn-koet)	Gangwon
Nui Mùng-kú	Mongolia Interior
Kîm Ngit-sṳ̀n	Kim Il-sung
Chhái-na̍p Koet-chi Phú-chhu Ngî-ngièn Thoi-péu-thòn	Delegación para la adopción de una lengua auxiliar internacional
Pí-tet-kô-sṳ̍p	Bydgoszcz
Nottingham	Nottingham
Thai-ví-vòng	David
Li-vi-ki	Levítico
Sṳ̂-thán-fuk Thai-ho̍k	Universidad Stanford
Fuk-kian	Fujian
Kûng-khiet	Gramo
Mùng-kú-tshu̍k	Mongol (etnia)
Khí-sṳ-liu̍k	Apocalipsis
Kong-lîn-sṳ	Gangneung
Kiê-liùng-sṳ	Gyeryong
Kô-yòng-sṳ	Goyang
Kûng-chû-sṳ	Gongju
Kó-chhôn-sṳ	Gwacheon
Kông-mìn-sṳ	Gwangmyeong
Kóng-chû-sṳ (Hôn-koet)	Gwangju (Gyeonggi)
Kiú-lî-sṳ	Guri
Kiûn-phú-sṳ	Gunpo
Kîm-phú-sṳ	Gimpo
Nàm-yòng-chû-sṳ	Namyangju
Lun-sân-sṳ	Nonsan
Thông-chîn-sṳ (Hôn-koet)	Dangjin
Tûng-theu-chhôn-sṳ	Dongducheon
Tûng-hói-sṳ (Hôn-koet)	Donghae
Pó-nèn-sṳ	Boryeong
Fu-chhôn-sṳ	Bucheon
Sâm-chit-sṳ	Samcheok
Shuì-sân-sṳ	Seosan
Sàng-nàm-sṳ	Seongnam
Suk-chhó-sṳ	Sokcho
Sṳ́-hîn-sṳ	Siheung
Ngà-sân-sṳ	Asan
Ôn-sân-sṳ	Ansan (Corea del Sur)
Ôn-sàng-sṳ (Hôn-koet)	Anseong
Ôn-yông-sṳ	Anyang (Corea del Sur)
Yòng-chû-sṳ	Yangju
Vû-sân-sṳ	Osan
Ngièn-chû-sṳ	Wonju
Ngi-vòng-sṳ	Uiwang
Ngi-chṳn-fú-sṳ	Uijeongbu
Li-chhôn-sṳ (Hôn-koet)	Icheon
Thî-chhôn-sṳ	Jecheon
Thiên-ôn-sṳ	Cheonan
Chhîn-chû-sṳ	Cheongju
Chhûn-chhôn-sṳ	Chuncheon
Thai-pha̍k-sṳ	Taebaek
Po-chû-sṳ	Paju
Phìn-tshe̍t-sṳ	Pyeongtaek
Phàu-chhôn-sṳ	Pocheon
Hò-nàm-sṳ	Hanam
Fà-sàng-sṳ	Hwaseong
Buckingham Kiûng	Palacio de Buckingham
Hói-nàm	Hainan
Yén-tûng	Extremo Oriente
Ngiên-kiu	Investigación
Kâm-suk	Gansu
Pha̍k Se-pâu	Leucocito
York	York
Tsiú	Articulación del codo
Sṳ̂n-min-ki	Deuteronomio
Sû-chû-sṳ	Suzhou
Vûn-chû-sṳ	Wenzhou
Windsor Sàng-páu	Castillo de Windsor
Hòn-chhu̍k	Etnia han
Nèn-pô-sṳ	Ningbo
Tet-koet-ngìn	Alemanes
Ko-men	Alergia
Fù-khì	Hirudinea
Kîm-yùng	Finanzas
1000	Mil
Mìn-su-ki	Números
Liu̍k Khiet-vùn	Kevin Rudd
Ngo̍k-ǹg	Crocodylidae
Yùn-nàm	Yunnan
Vû-â	Corvus
Plymouth	Plymouth
Sân-tûng	Shandong
Pí	Brazo
Derby-sṳ	Derby
Thàn-khîn Fa-ha̍p-vu̍t	Hidrocarburo
Hò-nàm	Henan
Montehermoso	Montehermoso
Liâu-nèn	Liaoning
El Cid	Rodrigo Díaz de Vivar
Jim Morrison	Jim Morrison
Kóng-khiéu	Puerto
Thòi-vân Thò-yèn Koet-chi Kî-chhòng	Aeropuerto Internacional de Taiwán Taoyuan
Kit-lìm	Jilin
Fù-nàm	Hunan
Chhiâng-hói	Qinghai
Vì-ngâ-ngì-tshu̍k	Etnia uigur
Rhône-sén	Ródano (departamento)
Koet-kâ Kûng-yèn	Parque nacional
Pâ-lì Charles-de-Gaulle Koet-chi Kî-chhòng	Aeropuerto de París-Charles de Gaulle
Chṳ̂-sán	Activo (contabilidad)
O-le̍t-liòng	Aureliano
Fù-pet	Hubei
Sân-sî	Shanxi
Hòng-khûng Kûng-sṳ̂	Aerolínea
Hò-khiéu-vân	Estuario
Chûng-set	Marrón
Kui-chû	Guizhou
Chûng-khi Sṳ̀n-kîn Ne-thúng	Sistema nervioso central
Yî-fut-só	Éfeso
Ôn-tha̍t-màn Hói	Mar de Andamán
Yok-sû-â-ki	Libro de Josué
Sî-pet Yîn-kak-làn	Noroeste de Inglaterra
Shám-sî-sén	Shaanxi
Tûng-pet Yîn-kak-làn	Nordeste de Inglaterra
Tûng Midlands	Midlands del Este
Tûng Yîn-kak-làn	Este de Inglaterra
Tûng-nàm Yîn-kak-làn	Sudeste de Inglaterra
Sî-nàm Yîn-kak-làn	Sudoeste de Inglaterra
模板:Commonscat	Plantilla:Commonscat
Sî Midlands	Midlands del Oeste
Yorkshire lâu Humber	Yorkshire y Humber
Kòn Se-pâu	Célula madre
Lò-mâ-sû	Epístola a los romanos
Mâ-liuk-kap Hói-hia̍p	Estrecho de Malaca
Yù-thai Vòng-koet	Reino de Judá
Mî-koet Pha̍k-ngìn	Uso del término «hombre blanco» en Estados Unidos
Fî-yí Mî-koet Het-ngìn	Población afroestadounidense
Mà-sat-chû-set Lî-kûng Ho̍k-yen	Instituto Tecnológico de Massachusetts
Pô-sṳ-tun Thai-ho̍k	Universidad de Boston
Yâ-lû Thai-ho̍k	Universidad Yale
Lû-khái-ngî	Idioma rukai
Nàm-pet-chêu	Dinastías Meridionales y Septentrionales
Liû-Sùng	Dinastía Liu Song
Fûn-lî	Boda
Pan Chúng-thúng-chṳ	Semipresidencialismo
Kâ-phìn-khiùn	Gapyeong-gun
Fâi-sân-khiùn	Goesan-gun
Tan-yòng-khiùn (Hôn-koet)	Condado de Danyang
Po-ên-khiùn	Boeun
Fù-yì-khiùn	Condado de Buyeo
Yòng-phìn-khiùn	Yangpyeong-gun
Lî-chû-sṳ	Yeoju
Liên-chhôn-khiùn	Yeoncheon-gun
Yún-thùng-khiùn	Yeongdong-gun
Yîm-sàng-khiùn	Eumseong-gun
Chên-phiàng-khiùn	Jeungpyeong
Chṳ́n-chhôn-khiùn	Jincheon-gun
Thiet-ngièn-khiùn	Cheorwon-gun
Fà-chhôn-khiùn	Hwacheon
Ên-phìn-sṳ	Eunpyeong-gu
Fî-li̍p-pí-sû	Epístola a los filipenses
Thiên-koet Pat-fuk	Bienaventuranza
Mî-koet Lièn-pâng Chún-phi Ne-thúng	Sistema de Reserva Federal
Kúai-é	Anura
Hâ Sî-lî-sî-â-sén	Voivodato de Baja Silesia
Khù-â-vì - Pô-mî-là-nì-â-sén	Voivodato de Cuyavia y Pomerania
Lû-pu-lìm-sén	Voivodato de Lublin
Lû-pu-sṳ̂-khà-sén	Voivodato de Lubusz
Lò-tsṳ-sén	Voivodato de Łódź
Séu Pô-làn-sén	Voivodato de Pequeña Polonia
Mâ-tsó-fû-sá-sén	Voivodato de Mazovia
O-pô-lòi-sén	Voivodato de Opole
Khak-ngì-pâ-yèn-sân-sén	Voivodato de Subcarpacia
Pô-tet-là-chhia-sén	Voivodato de Podlaquia
Pô-mî-là-nì-â-sén	Voivodato de Pomerania
Sî-lî-sî-â-sén	Voivodato de Silesia
Sṳn-sṳ̍p-sṳ-sén	Voivodato de Santa Cruz
Sî Pô-mî-là-nì-â-sén	Voivodato de Pomerania Occidental
Pâ-lùn-sî-â-sén	Provincia de Valencia
Sat-là-kô-sat-sén	Provincia de Zaragoza
Vùi-sṳ̂-khà-sén	Provincia de Huesca
Baak-gaa-seng	Cien apellidos de familia
Sok-lî-â-sén	Provincia de Soria
Hien-thoi Khì-chhâ	Hyundai Motor Company
Kîm Tsang-ên	Kim Jong-un
Kông-sî	Jiangxi
Wernher von Braun	Wernher von Braun
Nèn-ha	Ningxia
Lí Hién-liùng	Lee Hsien Loong
Kîm-fà-sṳ	Jinhua
Thòi-chû-sṳ	Taizhou (Zhejiang)
Phòng-châ-phú-ngî	Idioma punjabí
Phú-sṳ̍p-thok-ngî	Idioma pastún
Yâ-chû	Sus scrofa
Chû-hói-sṳ	Zhuhai
Sân-thèu-sṳ	Shantou
Shâu-kûan-sṳ	Shaoguan
Kông-mùn-sṳ	Jiangmen
Chhám-kông-sṳ	Zhanjiang
Shàu-khin-sṳ	Zhaoqing
Fi-chiu-sṳ	Huizhou
Mòi-chiu-sṳ	Meizhou
San-mî-sṳ	Shanwei
Hò-ngièn-sṳ	Heyuan
Yòng-kông-sṳ	Yangjiang
Chhîn-yén-sṳ	Qingyuan
Tûng-kôn-sṳ	Dongguan
Chûng-sân-sṳ	Zhongshan
Chhèu-chiu-sṳ	Chaozhou
Thiên-tén-yen	Tiandeng
Liùng-chiu-yen	Longzhou
Nèn-mìn-yen	Ningming
Thai-sîn-yen	Daxin
Sâ-chhà-chiòng	Salsa shacha
Mâ-liuk-kap-sṳ	Malaca (ciudad)
Khiâu-chhṳ-sṳ	George Town
IPhone 5	IPhone 5
Sṳn-chhôn-lî	Eucaristía
Fuk-chiu-sṳ	Fuzhou
Nàm-phìn-sṳ	Nanping
Phû-thièn-sṳ	Putian
Sâm-mìn-sṳ	Sanming
Tshièn-chiu-sṳ	Quanzhou
Hà-mûn-sṳ	Xiamen
Chông-chiu-sṳ	Zhangzhou
Liùng-ngâm-sṳ	Longyan
Nèn-tet-sṳ	Ningde
Sî-pak-li-â Fú	Panthera tigris altaica
Thiên-ngô-yen	Tian'e
Nàm-tan-yen	Nandan
Tûng-làn-yen	Donglan
Sîn-chuk-yen	Condado de Hsinchu
Nó	Encéfalo
Thông Ngiâ-mong	Johann Adam Schall von Bell
Yáng-chhiong Chín-thôn-ho̍k	Radiología
La̍p-tsuk	Vela (iluminación)
Hiet-chiong	Plasma (sangre)
Southampton	Southampton
Lu-tet-ki	Libro de Rut
Hâ-sat-khiet-chhu̍k	Kazajo (etnia)
Yòng-mî	Anisoptera
Chit-fûn-ho̍k	Integración
Kô-lìm-tô-chhièn-sû	Primera epístola a los corintios
Sî-pân-ngà Ti-koet	Imperio español
Pha̍k-yùn-khî (Kóng-chiu-sṳ)	Baiyun
Sṳ-sṳ̂-ki	Libro de los Jueces
Po-lîn-chhòi	Spinacia oleracea
Pâ-set-lò-nâ-sén	Provincia de Barcelona
Liuk-piên-hìn	Hexágono
Thòi-pet 101	Taipei 101
Lùn-tûn Thap-khiâu	Puente de la Torre
Luì-kûng	Trueno
Siù-li Yún-kòn-sien-chhùng	Caenorhabditis elegans
O-pô-lòi	Opole
Sopot	Sopot
Â-sṳ̂-thù-lî-â-sṳ̂-sén Chhṳ̍t-hot-sṳ	Anexo:Concejos y comarcas del Principado de Asturias
Kám-lám-yù	Aceite de oliva
Chim-sin-fi	Iglesias bautistas
Lie̍t-yî-tha̍t-sén Chhṳ̍t-hot-sṳ	Anexo:Municipios de la provincia de Lérida
Vú-yî-sân-sṳ	Ciudad de Wuyishan
Set-vì-li-â-sén	Provincia de Sevilla
Thap-là-kô-na̍p-sén	Provincia de Tarragona
Provence-sén	Provenza
Kî-hài Kûng-chhàng	Ingeniería mecánica
Apeldoorn	Apeldoorn
Lìm-pó-ngî	Idioma limburgués
Khái-ngì-chhái	Kielce
Bytom	Bytom
Ôn-sit-ngit	Sabbat
Khìm-sṳ̂-thok-khok-ngá	Częstochowa
Zabrze	Zabrze
Ôn-sit-ngit-fi	Iglesia Adventista del Séptimo Día
Jean Michel Jarre	Jean-Michel Jarre
Thai Pô-làn Thi-khî Kô-yî-fû	Gorzów Wielkopolski
Là-tô-mê	Radom
Lo̍k-chham-ki-yen	Condado de Los Ángeles
Słupsk	Słupsk
Sosnowiec	Sosnowiec
Gliwice	Gliwice
Yo̍k-sṳ̂	Farmacéutico
Hi-kôn Yì-chhṳ̍t	Trasplante (medicina)
Pâ-lùn-sî-â-sén Chhṳ̍t-hot-sṳ	Anexo:Municipios de la provincia de Valencia
Bielsko-Biała	Bielsko-Biała
Rybnik	Rybnik
Tân-fu̍t Se-pâu	Monocito
Mâ-khó-fuk-yîm	Evangelio de Marcos
Ruda Śląska	Ruda Śląska
Yok-thán-vòng	Jotán de Judá
Thò-yèn-yen	Taoyuan
Nò-mí	Arroz glutinoso
Kîn-tû-fú	Prefectura de Kioto
Kau-su	Profesor
Thai-fán-fú	Prefectura de Osaka
Fuk-kông-yen	Prefectura de Fukuoka
Oi-yèn-yen	Prefectura de Ehime
Kô-lìm-tô-heu-sû	Segunda epístola a los corintios
Khien-mî	Culturismo
Port Elizabeth	Puerto Elizabeth
Kimberley (Nàm-fî)	Kimberley (Sudáfrica)
Yok-sâ-fap-vòng	Josafat de Judá
Thòi-vân Hói-hia̍p	Estrecho de Taiwán
Sî Khôi-phú-sén	Provincia Occidental del Cabo
Yamaguchi-yen	Prefectura de Yamaguchi
Khiâu-chhṳ Sâm-sṳ	Jorge III del Reino Unido
Chûng-koet Thi-fông	Región de Chūgoku
Mî-koet Thu̍k-li̍p Siên-ngièn	Declaración de Independencia de los Estados Unidos
Sâm-tshûng-yen	Prefectura de Mie
Yù-mu̍k mìn-chhu̍k	Nómada
Hiông-pak-su	Cedrus
Hî-pak-lòi-sû	Epístola a los hebreos
Kâ-lâ-thai-sû	Epístola a los gálatas
Màn-é	Anguilliformes
Sông-chhèu	Dinastía Shang
Thai-thúi	Muslo
Pîn-khù-yen	Prefectura de Hyōgo
Kiûng-khì-yen	Prefectura de Miyazaki
Yùng-pún-yen	Prefectura de Kumamoto
Stamford Raffles	Thomas Stamford Raffles
Sha̍m-é	Cicadidae
Tûng Khôi-phú-sén	Provincia Oriental del Cabo
Fap-koet Hòng-khûng	Air France
Lie̍t-vòng-ki-song	I Reyes
Kô-lò-sî-sû	Epístola a los colosenses
Ngâ-kok-sû	Epístola de Santiago
Yok-hon-yit-sû	Primera epístola de Juan
Fî-li-mùn-sû	Epístola a Filemón
Thiap-sat-lò-nì-kâ-heu-sû	Segunda epístola a los tesalonicenses
Thiap-sat-lò-nì-kâ-chhièn-sû	Primera epístola a los tesalonicenses
Pí-tet-chhièn-sû	Primera epístola de Pedro
Thì-mô-thai-chhièn-sû	Primera epístola a Timoteo
Lí Kông-yeu	Lee Kuan Yew
Chṳ̂-kâ-kô Thai-ho̍k	Universidad de Chicago
Tsṳ̂-fo-yen	Prefectura de Shiga
Mu-nì-het Kî-chhòng	Aeropuerto Internacional de Múnich-Franz Josef Strauss
Yok-hon-ngi-sû	Segunda epístola de Juan
Thì-mô-thai-heu-sû	Segunda epístola a Timoteo
Thì-tô-sû	Epístola a Tito
Yî-sṳ̂-lâ-ki	Libro de Esdras
Nì-hî-mí-ki	Libro de Nehemías
Pietersburg	Polokwane
Séu Pha̍k-Lù	Egretta garzetta
Chhòn-ngiam-phiang	Enfermedad infecciosa
Kôn-yàm	Hepatitis
Chhûn-chiet	Año Nuevo chino
Shinzō Abe	Shinzō Abe
Mpumalanga-sén	Mpumalanga
Pet Khôi-phú-sén	Provincia Septentrional del Cabo
Tó-kîn-yen	Prefectura de Shimane
Kông-sân-yen	Prefectura de Okayama
Gauteng-sén	Gauteng
Thung-fûng	Gota (enfermedad)
Thai-fûn-yen	Prefectura de Ōita
Tiâu-tshí-yen	Prefectura de Tottori
Nùng-la̍k	Calendario chino
Kô-tî-yen	Prefectura de Kōchi
Pha̍k-hèu	Difteria
Exeter	Exeter
Saint Lawrence-hò	Río San Lorenzo
Limpopo-sén	Provincia de Limpopo
Kô-tén Kau-yuk	Educación superior
Sân-tá-kîn	Sandakan
Â-pí	Kota Kinabalu
Ngi̍t-pún thúng-tshṳ sṳ̀-thoi (Thòi-vân)	Ocupación japonesa de Taiwán
Phok Kiún-fi	Park Geun-hye
Berthierville, Québec	Berthierville
Lévis	Lévis
Thòi-nàm-sṳ	Tainan
Laval (Québec)	Laval (Quebec)
Charlemagne, Québec	Charlemagne (Quebec)
Mâ-lòi Pô-lî-nì-sî-â Ngî-chhu̍k	Lenguas malayo-polinesias
Fên-yòng-sṳ	Hengyang
Mân-chiu-tshu̍k	Manchú
Doetinchem	Doetinchem
Zamość	Zamość
Malbork	Malbork
Groesbeek	Groesbeek
Mì-chit-fûn-ho̍k	Cálculo
Mì-fûn	Cálculo diferencial
Ngo̍k-yòng-sṳ	Yueyang
BP	BP
Sú-thiàu	Papas fritas
Yùn-lìm-yen	Condado de Yunlin
Kiok-tsṳ́	Dedos del pie
Vî-liâm Â-li̍t-sân-thai (Hò-làn)	Guillermo Alejandro de los Países Bajos
Vì-tô-li-â Kóng	Puerto de Victoria
Sî-kung-khî	Sai Kung
Mâ-nâ-sî-vòng	Manasés de Judá
Kî-kîm-fi	Fundación (derecho)
A-hîn Kôn-yàm	Hepatitis A
Yù-tsiâm-vong-khî	Yau Tsim Mong
Fûng-sái	Diospyros kaki
Tshṳ̍t-tshòng	Recto
Chhṳ-yù Pâng-sén	Provincia del Estado Libre
Tsó-fo-yen	Prefectura de Saga
Tet-tó-yen	Prefectura de Tokushima
Sî-pân-ngà-ngìn	Pueblo español
Fu̍t-chhṳ̂ Khiung-chṳn Sṳ̀n-siong	Imagen por resonancia magnética
Hiông-tshon-yen	Prefectura de Kagawa
Reading, Berkshire	Reading
Kâ-chû Lî-kûng Ho̍k-yen	Instituto de Tecnología de California
Vì-ngì-tshṳ-páu Thai-ho̍k	Universidad de Wurzburgo
Êu-kí-lî-tet Kí-hò	Geometría euclidiana
Si̍t-kuk	Silicon Valley
Khiu Tha̍t-sîn	Thaksin Shinawatra
Thòi-sân-sṳ	Taishan
Kîm-kôa	Calabaza gigante
Thai Sùn-thâ Khiùn-tó	Islas mayores de la Sonda
Sî-pet-sén	Provincia del Noroeste
Sien-thon	Segmento
Vûn-tai	Clima templado
Â-kûng	Abuelo
Thai-khi̍t-khièn	Taichí
Kiok-khwá	Tobillo
Hò-làn Tâi-thi Sat-khiet-sùn-ngî	Bajo sajón
Pân-kiêu-é	Streptopelia turtur
Tshòng-khì-yen	Prefectura de Nagasaki
Hà-chhèu	Dinastía Xia
Chû-vì Sṳ̀n-kîn Ne-thúng	Sistema nervioso periférico
Lùn-tûn Thai-ho̍k	Universidad de Londres
Kip-sú	Serie matemática
Nelspruit	Nelspruit
Sâ-là-ye̍t-chû	Sarawak
Â-chû Thai-phìn-yòng Kîn-tsi Ha̍p-tsok Fi-ngi	Foro de Cooperación Económica Asia-Pacífico
Kôan-chiet-yàm	Artritis
Chûng-la̍k-sṳ	Zhongli
Montauban	Montauban
Chhòng-sâ-sṳ	Changsha
Thai Put-lie̍t-tiên lâu Oi-ngì-làn Lièn-ha̍p Vòng-koet	Reino Unido de Gran Bretaña e Irlanda
Kiok-kiên	Talón
Kûng-fûn	Centímetro
Lièn-ha̍p Hòng-khûng	United Airlines
Yen-thèu	Faringe
Hò-mí	Milímetro
Mì-mí	Micrómetro (unidad de longitud)
Khi̍t-han (Sú-ho̍k)	Límite matemático
Theu-fú	Tofu
Phù-sat	Bodhisattva
Chóng-ló Kau-fi	Presbiterianismo
Hien-thoi Veloster	Hyundai Veloster
Nai-mí	Nanómetro
Berlanga de Duero	Berlanga de Duero
Pâ-chûng-sṳ	Bazhong
Sâ-pâ-chû	Sabah
Nàm-nèn-sṳ	Nanning
Ngâ-li-ôn-ngìn	Arios
Yù-sṳn-mî-thi Koet-kâ Kûng-yèn	Parque nacional de Yosemite
Chhiâng-set	Cian (color)
Ho̍k-yen	Facultad universitaria
Kô-hiùng-sṳ	Kaohsiung
Pet-mî Chhṳ-yù Mo-yi Hia̍p-ngi	Tratado de Libre Comercio de América del Norte
Rustenburg	Rustenburg
Yen-tsong-fui	Concierto
Yù-fu̍t-chû	Johor
Ngò-lò-sṳ̂ Lièn-pâng Chhṳ̍t-hot-sṳ	Ciudades federales de Rusia
Fì-tshu̍k	Etnia hui
Sha̍k-sṳ	Maestría
Preston, Lancashire	Preston
Sî-tí-kâ-vòng	Sedecías de Judá
Sâm-koet	Tres Reinos
Chhûn-chhiû Sṳ̀-khì	Primaveras y Otoños
Chan-koet Sṳ̀-khì	Reinos Combatientes
Mâ-liuk-kap-chû	Malaca
Pietermaritzburg	Pietermaritzburg
Sú-vón	Muñeca (anatomía)
Kit-làn-tan-chû	Kelantan
Tshông-tshu̍k	Etnia tibetana
Pîn-sàng-chû	Penang
Blackburn	Blackburn
Chûng-sin Pha̍k-hiet-khiû	Neutrófilo
Pâng-kâ-tó	Isla de Bangka
Phìn-chhông-khiùn	Pyeongchang
Thai-koet Koet-chi Hòng-khûng Kûng-sṳ̂	Thai Airways
Thai Ngi̍t-pún Ti-koet	Imperio del Japón
Hiûng-nù	Xiongnu
Phit-li̍t-chû	Perak
Lùn-tûn Ti-koet Ho̍k-yen	Imperial College London
Tsen-sàng-sṳ	Zengcheng
Kui-lìm-sṳ	Guilin
Siet-làn-ngô-chû	Selangor
Tui-kok-sien	Diagonal
Fi-li-phi Liuk-sṳ	Felipe VI de España
Kûng-tún	Tonelada
Phàng-hên-chû	Pahang
中國象棋	Ajedrez chino
Pit-sṳn-hak	Pizza Hut
Yim-suk Siáu-tsṳ́	Sonic the Hedgehog (personaje)
Ngo̍k-vûn-khiet-tshu̍k	Etnia evenki
Kiu-ên	Salvación
Nàm-kîn Thai-thù-sat	Masacre de Nankín
Yún Chṳ-Hau	Yun Chi-ho
Phì-mí	Picómetro
Chûng-koet 2010-ngièn Sông-hói Sṳ-kie Pok-lám-fi	Exposición Universal de Shanghái de 2010
Carlisle, Cumbria	Carlisle
Sandomierz	Sandomierz
Ngit-tèu-kông	Luz solar
Khwon-kûan-tsiet	Articulación de la cadera
Fûn-kî-hon-khiûn	Mycobacterium
Chàu-yòng-sṳ	Shaoyang
Phìn-tûng-yen	Condado de Pingtung
Hién-mì-kiang	Microscopio
Chông-kâ-kie-sṳ	Zhangjiajie
Chṳ Sṳ̀n-kûng	Koxinga
Chṳ́n-hói-khî (Nèn-pô-sṳ)	Distrito de Zhenhai
Chu-chû-sṳ	Zhuzhou
Nàm-sâ-khî	Nansha
Kûng-tshun	Decímetro
McGill Thai-ho̍k	Universidad McGill
Sâm-fòng Ńg-ti	Tres augustos y cinco emperadores
Sanok	Sanok
Mâ-tshâ	Carro de guerra
Milton Keynes	Milton Keynes
Â-mî-tshu̍k	Ami (pueblo)
Ên-tién	Gracia divina
Hî-lìn-tên-khî	Municipio de Hillingdon
Chṳ̂-yòng-sṳ	Ziyang
Sṳ̀n-chhùng	Imago (zoología)
Chang Thien-chṳ́ Fat-sa Kie-son-kî Thôn-chhèn Só-mèu	Tomografía por emisión de positrones
Przemyśl	Przemyśl
Chhiòn-khiû Sàng-sṳ	Ciudad global
Pî-mí	Femtómetro
Burnley	Burnley
Tûng Lùn-tûn, Tûng Khôi-phú-sén	East London
Sat-mû-ngí-ki-ha	II Samuel
Li̍t-thoi-chṳ-ha	II Crónicas
Lie̍t-vòng-ki-ha	II Reyes
Biała Podlaska	Biała Podlaska
Mèu-tshu̍k	Miao
Pet-hói-sṳ	Beihai
Mafikeng	Mafikeng
Mí-sâ-yên Khiùn-tó	Bisayas
Lò-pô-ôn-vòng	Roboam
Slough	Slough
Thì-mô-thai	Timoteo (santo)
Chho̍k-sṳ̂-lia̍p	Centrómero
Tûng-hò, Néu-yok-sṳ	Río Este (Nueva York)
Chhêu-fông-hìn	Hipercubo
Sêm-mî-làn-chû	Negeri Sembilan
Brzeg	Brzeg
Fidel Valdez Ramos	Fidel V. Ramos
Łomża	Łomża
Siong-thâm-sṳ	Xiangtan
Thûng-tshu̍k	Dong (etnia)
Pak-fo Kûng-sṳ̂	Grandes almacenes
Thòi-vân Ngièn-tshu-mìn	Aborígenes de Taiwán
騷靈現象	Poltergeist
Tha̍t-vat-ngì-tshu̍k	Daur
Na̍p-sî-tshu̍k	Naxi
Outaouais	Outaouais
Kuî-é	Testudines
Pak-sâ-sat	Baltasar de Babilonia
Tshièn-pí	Antebrazo
Yî-set-lie̍t Vòng-koet	Reino de Israel
Sîn-sân-sṳ	Johor Bahru
Khiu-kîm-sân Vân	Bahía de San Francisco
Li Mâ-teu	Matteo Ricci
Tshài Yîn-vùn	Tsai Ing-wen
Chełm	Chełm
Pha̍k-ngìn	Blanco (persona)
Â-ha̍p-vòng	Ajab
Suwałki	Suwałki
Ngì-làn-yen	Condado de Yilan (Taiwán)
Sî-làn-ngî	Zelandés
Epe	Epe
Chû Khiet-lùn	Jay Chou
Winburg	Winburg
Kiú-liùng	Kowloon
Nâ-pô-nì-tha̍t	Nabonido
Ngie-mí-li-ôn Lò-mâ-nok-ngî	Idioma emiliano-romañol
Sîn-pet-sṳ	Nuevo Taipéi
Hî-sî-kâ-vòng	Ezequías
Thòi-chûng-sṳ	Taichung
IPhone 4S	IPhone 4s
Kîm-mùn-yen	Kinmen
Kâ-ngi-sṳ	Chiayi
Kî-lùng-sṳ	Keelung
Busko-Zdrój	Busko-Zdrój
Àu-thai-li-â Ngièn	Dólar australiano
Tûng-yín-hiông	Dongyin
Hon-ho̍k	Sinología
Vùn-sân-khî (Thòi-pet-sṳ)	Wenshan
Yî-pó-sṳ	Ipoh
Ná-pô-pha-lâ-sâ-ngì	Nabopolasar
Â-pí-ngâ-vòng	Abías de Judá
Sûn N̂g	Wu (reino)
Pha̍k-chhu̍k	Bai
Pińczów	Pińczów
Xuxa	Xuxa
Lucélia Santos	Lucélia Santos
Montréal-tó	Isla de Montreal
IPhone 3GS	IPhone 3GS
IPhone 4	IPhone 4
IPhone 3G	IPhone 3G
Alan Dawa Dolma	Alan (cantante)
Mâ-lòi-sî-â Hòng-khûng	Malaysia Airlines
Lì-tshu̍k	Li (etnia)
Chûng-sî-khî (Hiông-kóng)	Central y Oeste
Mí-nâ-hien-vòng	Menajem
Â-ha̍p-chhia-vòng (Yî-set-lie̍t)	Ocozías de Israel
Â-ha̍p-chhia-vòng (Yù-thai)	Ocozías de Judá
Yok-làn-vòng (Yù-thai)	Joram de Judá
Â-sat-li-ngâ	Ozías
Peter Nalitch	Peter Nalitch
Yâ-lò-pô-ôn yit-sṳ	Jeroboam I
Am-li-vòng	Omrí
Nâ-tap-vòng	Nadab
Pâ-sâ-vòng	Basá
Yâ-fu-vòng	Jehú
Yok-sî-â-vòng	Josías de Judá
Yok-â-sṳ̂-vòng (Yù-thai)	Joás de Judá
Sîm-li-vòng	Zimri
Yâ-lò-pô-ôn ngi-sṳ	Jeroboam II
Yî-vi-mí-lò-tha̍t	Evilmerodac
Â-mâ-chhia-vòng	Amasías
Yî-sṳ̂-pô-sat-vòng	Isbaal
N̂g Chok-tùng	Goh Chok Tong
Â-sat-vòng	Asa de Judá
Â-mùn-vòng	Amón de Judá
Chong Koet-yùng（Chong Fat-chûng）	Leslie Cheung
Lí Tên-Fî	Lee Teng-hui
Yî-lâ-vòng	Ela
Yok-ngâ-kin-vòng	Joaquim
Hò-se-â-vòng	Oseas de Israel
Yok-ngâ-kîn-vòng	Joaquín de Judá
Biłgoraj	Biłgoraj
Chhî Chai-Phit	Seo Jae-pil
Puławy	Puławy
Chuk Hon	Shu (reino)
Chhâu Ngùi	Wei (reino)
Abitibi-Témiscamingue	Abitibi-Témiscamingue
Mò-tóng-sit	Candidato independiente
Iwakuni-sṳ	Iwakuni
Kâu-thûng kûng-khí	Anexo:Medios de transporte
Phok Hièn-yún	Pak Heon-yeong
Sat-kâ-li-ngâ-vòng	Zacarías de Israel
Yok-ha̍p-sṳ̂-vòng	Joacaz de Israel
Fùng Siù-chhiòn	Hong Xiuquan
Yok-â-sṳ̂-vòng (Yî-set-lie̍t)	Joás de Israel
Yok-làn-vòng (Yî-set-lie̍t)	Joram de Israel
Pí-kâ-vòng	Pecaj
Sâ-liùng-vòng	Sellum
Pí-kâ-hot-vòng	Pecajías
Khiu Sṳ̀n-thûng	Shing-Tung Yau
Fùng Puk-kím Kiê	Chrysolophus pictus
Sat-lâ-tshu̍k	Salar (etnia)
Yok-ha̍p-sṳ-vòng	Joacaz de Judá
瑤族	Yao
Hagi-sṳ	Hagi (Yamaguchi)
Chûng-chhiû-chiet	Fiesta del Medio Otoño
Nài-lî-kak-li-sâ-ngì	Neriglisar
Fùng-theu	Vigna angularis
Łuków	Łuków
Łęczna	Łęczna
Pô-sṳ̂ Ti-koet	Imperio aqueménida
Nagato-sṳ	Nagato (Yamaguchi)
Mâ-thai-fuk-yîm	Evangelio de Mateo
Sṳ̍p-sṳ-ka	Cruz cristiana
Â-chû Hòng-khûng X	AirAsia X
Â-chû Hòng-khûng	AirAsia
Yî-fut-só-sû	Epístola a los Efesios
Sòng-tet-sṳ	Changde
Yit-yòng-sṳ	Yiyang
Chhim-chû-sṳ	Chenzhou
Tshî Kông-khí	Xu Guangqi
Súi-nèn-sṳ	Suining
Nui-kông-sṳ	Neijiang
Tha̍t-chû-sṳ	Dazhou
Ngá-ôn-sṳ	Ya'an
10000	Diez mil
Fú-kûa	Momordica charantia
Fún-fùng-set	Rosa (color)
Nâ-sat-le̍t	Nazaret
Yî-tshu̍k	Yi
Mî-koet Kûng-lî-fi Chhâ-fi	American Board of Commissioners for Foreign Missions
Â-thâ-li-ngâ	Atalía
Windsor, Berkshire	Windsor (Berkshire)
Kô Khô-kî	Alta tecnología
Hòn Hòn	Han Han
Tczew	Tczew
Hâ-nì-tshu̍k	Hani
Fù-chṳ-mìn-sṳ Kî-chhòng	Aeropuerto Internacional de Tan Son Nhat
Hien-thoi Accent	Hyundai Accent
Hien-thoi Sonata	Hyundai Sonata
Hien-thoi Elantra	Hyundai Elantra
Vû-tsṳ-phe̍t-khiet-chhu̍k	Uzbeko (etnia)
Hien-thoi Genesis Coupé	Hyundai Genesis Coupe
Thap-kit-khiet-tshu̍k	Tayikos
Wal-Mart Kûng-sṳ̂	Walmart
緋彈个婭里婭	Hidan no Aria
Yùn-tôn yun-son	Computación en la nube
Ńg-sùn-chiet Yun-thung	Pentecostalismo
Liu̍k-theu	Vigna radiata
Chêu-siên-chhu̍k	Etnia coreana
Khúa-ngì-khiet-tsṳ-tshu̍k	Kirguís (etnia)
Burgo de Osma-Ciudad de Osma	El Burgo de Osma
Sông-hói Ha̍p-tsok Tsû-tsṳt	Organización de Cooperación de Shanghái
Yì Kit-chùn	Yu Gil-jun
Reus	Reus
San Esteban de Gormaz	San Esteban de Gormaz
Hien-thoi Santa Fe	Hyundai Santa Fe
Yî-ho̍k-yen	Facultad de medicina
Het-mien Phî-lù	Platalea minor
Sṳ̀n-chheu-fi	Asambleas de Dios
Phok Chhùng-yòng	Park Jung-yang
Fâ-tû-khî	Huadu
Sâ-â-nàm	Shah Alam
Kit-lùng-po Koet-chi Kî-chhòng	Aeropuerto Internacional de Kuala Lumpur
Ngiu̍k-Sân	Yu Shan
Thai-yí-sân	Isla Lantau
Starogard Gdański	Starogard Gdański
Het-tsat-tshu̍k	Hezhen
Mauricie	Mauricie
Hò-làn Tâi-thi Sat-khiet-sêm-ngî	Bajo sajón neerlandés
Khiùn	Comandería
Vû-yìn	Muscidae
Tha̍t-mâ-thai	Dalmacia
Witwatersrand Thai-ho̍k	Universidad del Witwatersrand
Hò-tûng-sṳ	Hà Đông
Mùng-sân-yen	Mengshan
Vú-fûng-hiông	Wufeng
Pán-khièu-khî	Panch'iao
Sâm-chṳ-khî	Sanzhi
Thâm-súi	Tamsui
Sip-chṳ-khî	Hsichih
Fû-lùn-pi-ngì-sṳ	Hulun Buir
Ǹg-chiu-sṳ	Wuzhou
Fòng-sàng-kóng-sṳ	Fangchenggang
Khîm-chiu-sṳ	Qinzhou
Kui-kóng-sṳ	Guigang
Ngiu̍k-lìm-sṳ	Yulin (Guangxi)
Pak-set-sṳ	Baise
Fo-chiu-sṳ	Hezhou
Hò-chhṳ̀-sṳ	Hechi
Lòi-pîn-sṳ	Laibin
Fuk-thièn-khî	Futian
Chhùng-chó-sṳ	Chongzuo
Thú-kâ-tshu̍k	Tujia
Lai-vân-khî	Liwan
Sîn-kie	Nuevos Territorios
Khôi-phìn-sṳ	Kaiping
Mo-yi	Comercio
Kędzierzyn-Koźle	Kędzierzyn-Koźle
Yo̍k-ho̍k	Farmacia
Kóng-tó-yen	Prefectura de Hiroshima
Thu̍k-liùng-tshu̍k	Derung
IPhone (Thi-yit thoi)	IPhone (1.ª generación)
Ye̍t-nàm-ngî sṳ-mû	Alfabeto vietnamita
Ólvega	Ólvega
Thú-ngí-khì-ngî sṳ-mû	Alfabeto turco
Longás	Longás
Kô-tá-ha̍p-lû-sṳ	Kota Bharu
Sú-chiuk-khiéu-phiang	Fiebre aftosa humana
Chhṳ̂m-súi-phu-khî	Sham Shui Po
Mielec	Mielec
客家	Hakka
Vù-kau-piáng	Pan plano
Wejherowo	Wejherowo
Pu-yî-chhu̍k	Buyei
Ngì-làn-sṳ	Ciudad de Yilan
Ńg-fù Sṳ̍p-liuk-koet	Dieciséis Reinos
Néu-yok Tû-fi-khî	Área metropolitana de Nueva York
歷峯雧團	Richemont (empresa)
Lanaudière	Lanaudière
Thap-lùn-ti-nò-ngî	Dialecto tarentino
Vòng Sîm-lìn	Cyndi Wang
Chhṳ̀n Kâ-fà	Ella Chen
Tshu-theu-fú	Tofu maloliente
Sû-o-tsṳ́n	Su-ao (Yilan)
Làn-yí	Isla Orquídea (Taiwán)
2009-ngièn sṳ-kie yun-thung-fi	Juegos Mundiales de 2009
Nàm-o-hiông	Nan-ao (Yilan)
Liu̍k-tó-hiông	Isla Verde (Taiwán)
Nàm-kôn-hiông	Nangan
Tûng-sân-hiông (Thòi-nàm)	Dongshan (Tainan)
Ǹg-yèn	Bola de pescado
Lò-tûng-tsṳ́n	Luodong (Yilan)
Tûng-sân-hiông	Dongshan (Yilan)
Tshit-mî-hiông	Qimei
Sâm-sên-hiông	Sanxing (Yilan)
Thòi-vân Ngiùn-hòng	Banco de Taiwán
Vû-hiu-hiông	Wuqiu
Thai-su-hiông	Distrito de Dashu
Mong-ôn-hiông	Wang-an
Pet-kôn-hiông	Beigan
Lie̍t-yí-hiông	Pequeña Kinmen
Yòng-mìn-sân Koet-kâ Kûng-yèn	Yangmingshan
Hak-kâ chhoi	Gastronomía de Hakka
Wong Gaa-khi	Wong Ka Kui
Phìn-fông Kûng-lî	Kilómetro cuadrado
Phùn-tshoi	Pun choi
Liòng Kuet-hiùng	Leung Kwok-hung
Fung-fa-sṳ	Fenghua
F4	F4 (banda)
Chùng-chṳ́	Zongzi
Hak-kâ Yòng-theu-fú	Yong tau fu
Thòi-fûng Mo̍k-Là-Khiet (2009-ngièn)	Tifón Morakot (2009)
Thòi-pet Tshia̍p-yun	Metro de Taipéi
Kí-kóng-hiông	Juguang
Chhòn-yùng Hòng-khûng	EVA Air
Kôn-yîm	Guan Yin
Phài-vân-tshu̍k	Paiwan (pueblo)
Thòi-vân nàm-tó ngî-ngièn	Lenguas formosanas
Lìm-pâ Se-pâu	Linfocito
Phài-vân-ngî	Idioma paiwan
Hak-kâ thú-lèu	Fujian Tulou
Chûng-fà Thai-ho̍k	Universidad Chung Hua
100000	Cien mil
Tûng-khî (Hiông-kóng)	Distrito Este (Hong Kong)
Gaspésie–Îles-de-la-Madeleine	Gaspésie–Îles-de-la-Madeleine
Tshiâ-tshu̍k	She
Sîn-kâ-po Koet-li̍p Thai-ho̍k	Universidad Nacional de Singapur
Sên-sán	Producción (economía)
Chojnice	Chojnice
Bronckhorst	Bronckhorst
Thi-kip-sṳ	Ciudad-prefectura de la República Popular China
Mì-fûn-ho̍k	Diferencial de una función
Tûng-hiông-tshu̍k	Dongxiang
Lâ-fú-tshu̍k	Lahu
Włodawa	Włodawa
Stalowa Wola	Stalowa Wola
Chat-ho̍k Pok-sṳ	Philosophiæ doctor
Lì-tó-khî	Distrito de las Islas
Thông-phûng	Apidae
Tshûng-shîn-yen	Prefectura de Okinawa
Sâm-súi-khî	Sanshui
Montpellier Thai-ho̍k	Universidad de Montpellier
Luceni	Luceni
Fà-khièu	Diáspora china
Lô-kông-khî	Luogang
Madrid Chhṳ-chhṳ Thai-ho̍k	Universidad Autónoma de Madrid
Tshṳ-tshṳ-chû	Prefectura autónoma de China
Medway	Medway
Pó-ôn-khî	Bao'an
Nysa, Pô-làn	Nysa
Belver de Cinca	Belver de Cinca
Pó-ôn-chhu̍k	Bonan
Culemborg	Culemborg
Kôan-tan-sṳ	Kuantan
Hikari-sṳ	Hikari
Krosno	Krosno
Kûng-lî	Kilómetro
Almarza	Almarza
Aldealices	Aldealices
Aldealafuente	Aldealafuente
Alentisque	Alentisque
Adradas	Adradas
Alconaba	Alconaba
Abejar	Abejar
Aldealpozo	Aldealpozo
Alcubilla de las Peñas	Alcubilla de las Peñas
Aldealseñor	Aldealseñor
Alcubilla de Avellaneda	Alcubilla de Avellaneda
Covaleda	Covaleda
Almazul	Almazul
Arcos de Jalón	Arcos de Jalón
Aldehuela de Periáñez	Aldehuela de Periáñez
Almenar de Soria	Almenar de Soria
Vinuesa	Vinuesa
Duruelo de la Sierra	Duruelo de la Sierra
San Leonardo de Yagüe	San Leonardo de Yagüe
Shâu-sân-sṳ	Shaoshan
Tai-tshu̍k	Dai
Mùn-pâ-tshu̍k	Monba
Kiong-tshu̍k	Qiang
Afrikaner-ngìn	Afrikáner
Ngá-tshu̍k	Va
Kûng-yîn	Hectómetro
Fû-yûng-sṳ	Seremban
Jasło	Jasło
Â-chhông-chhu̍k	Achang
Thú-tshu̍k	Tu (etnia)
Kîn-mí	Gigámetro
Pân-kap	Columba guinea
Súi-tshu̍k	Shui
Nyet-láu-tshu̍k	Gelao
Kín-phó-tshu̍k	Jingpo
Lo̍k-pâ-tshu̍k	Lhoba
Li̍t-siuk-tshu̍k	Lisu
Vì-kî Pak-khô Ngî-ngièn Lie̍t-péu	Wikipedia:Lista completa de Wikipedias
Siên-pî-chhu̍k	Xianbei
Billingham	Billingham
Pet-khî (Hiông-kóng)	Distrito Norte (Hong Kong)
Mô-nàm-tshu̍k	Maonan
Nu-tshu̍k	Nu (etnia)
Mu̍k-láu-tshu̍k	Mulao
Sî-sûng-pán-na̍p Thài-tshu̍k Tshṳ-tshṳ-chû	Prefectura autónoma dai de Xishuangbanna
Ngièn-lóng-khî	Yuen Long
Kôn-thòng-khî	Kwun Tong
Khwûi-tshiâng-khî	Kwai Tsing
Phù-mí-tshu̍k	Pumi
Thai-pu-khî	Tai Po
Tet-ngo-tshu̍k	De'ang
Vòng-thai-siên-khî	Distrito de Wong Tai Sin
Tshiên-vân-khî	Distrito de Tsuen Wan
Pu-lóng-chhu̍k	Blang
Thiên-hò-khî	Tianhe
Hàng-thung Chok-ngia̍p Ne-thúng	Sistema operativo móvil
Hói-tshong-khî	Haicang
Pet Québec Thi-khî	Nord-du-Québec
Montérégie	Montérégie
Sun-tet-khî	Shunde
Fân-nyî-khî	Panyu
Québec-ngìn Tóng	Parti québécois
Grahamstown	Grahamstown
Si̍p-mî-khî	Jimei
Daniele Suzuki	Daniele Suzuki
Thûn-mùn-khî	Tuen Mun
Nàm-khî (Hiông-kóng)	Distrito Sur (Hong Kong)
Vân-chái-khî	Wan Chai
Villanueva de Sigena	Villanueva de Sigena
Kô-lò-sî	Colosas
Lò-fù-khî	Luohu
Yàm-thièn-khî	Yantian
Khiâm-nàm Pu-yî-tshu̍k Mèu-tshu̍k Tshṳ-tshṳ-chû	Prefectura autónoma buyei y miao de Qiannan
Lìm-ha Fì-tshu̍k Tshṳ-tshṳ-chû	Prefectura autónoma hui de Linxia
Liùng-kông-khî	Longgang
Graaff-Reinet	Graaff-Reinet
Orania	Orania (Sudáfrica)
Â-pa Chhong-chhu̍k Kiông-chhu̍k Chhṳ-chhṳ-chû	Prefectura autónoma tibetana y qiang de Ngawa
Vú-mîn-yen	Wuming
Hói-tsû-khî	Haizhu
Ye̍t-siù-khî	Yuexiu
Vryheid	Vryheid
Swellendam	Swellendam
Vòng-pu-khî	Distrito de Huangpu
Nàm-hói-khî	Distrito de Nanhai
Lùng-ôn-yen	Long'an
Mâ-sân-yen	Mashan
Tshiùng-fa-sṳ	Conghua
Thùng-ôn-khî	Tong'an
Liu̍k-fûng-sṳ	Lufeng
Siông-ôn-khî	Xiang'an
Sa-fi Mìn-tsú Lièn-sien	Liga de los Socialdemócratas
Vi	Estómago
Liùng-hâ	Nephropidae
Pak-van-mí	Megámetro
Kî-nok-tshu̍k	Jino
Ngo̍k-lùn-tshùn-tshu̍k	Oroqen
Tshòng-tin-yen	Changting
Chaudière-Appalaches	Chaudière-Appalaches
Liông (Nàm-chhèu)	Dinastía Liang
Pet-ngan Thi-khî (Québec)	Côte-Nord
Néu-yok-kóng	Puerto de Nueva York
Tha̍k-é	Dizi
Tân-yit kón-lî-khî	Autoridad unitaria
Hiông-kóng Thit-sṳ-nì Lo̍k-yèn Thu-ká-khî	Hong Kong Disneyland Resort
Sông-lìm-yen	Shanglin
Sâm-kông Thûng-chhu̍k Chhṳ-chhṳ-yen	Sanjiang
Nàm-ôn-sṳ	Nan'an
Àu-choi Fôn	Ephippiorhynchus senegalensis
Kî-chhòng	Aeropuerto
Yen	Condado de la República Popular China
Fûng-tshe̍t-khî	Fengze
Sé-kiok-lî	Lavatorio
Ngìn-kûng Hi-kôn	Órgano artificial
Kîm-siu Yâu-chhu̍k Chhṳ-chhṳ-yen	Jinxiu
Lùng-lìn Kok-chhu̍k Chhṳ-chhṳ-yen	Longlin
Â-ha̍p-sùi-lû-vòng	Asuero
Sṳ-mìn-khî	Siming
Thí-ngoi Mo̍k-yòng-ha̍p	Oxigenación por membrana extracorpórea
Lìm Tan	Lin Dan
分類:Tet-koet	Categoría:Alemania
分類:Yi-thai-li	Categoría:Italia
分類:Kâ-nâ-thai	Categoría:Canadá
分類:Sî-pân-ngà	Categoría:España
分類:Chûng-koet	Categoría:China
分類:Ngi̍t-pún	Categoría:Japón
分類:Àu-thai-li-â	Categoría:Australia
分類:Yin-thu	Categoría:India
分類:Yî-set-lie̍t	Categoría:Israel
分類:Nàm-fî	Categoría:Sudáfrica
Koet-li̍p Thòi-vân Thai-ho̍k Yî-ho̍k-yèn Fu-sat Yî-yèn	Hospital de la Universidad Nacional de Taiwán
Thiên-sái (Hiông-kóng)	The Cullinan
分類:Yin-thu-nì-sî-â	Categoría:Indonesia
分類:Pâ-kî-sṳ̂-thán	Categoría:Pakistán
分類:Pô-làn	Categoría:Polonia
分類:Sîn-kâ-po	Categoría:Singapur
分類:Hòn-koet	Categoría:Corea del Sur
分類:Thai-koet	Categoría:Tailandia
分類:Ye̍t-nàm	Categoría:Vietnam
分類:Phú-nen-lui	Categoría:Mammalia
分類:Tiâu	Categoría:Aves
分類:Chhṳ̍t-vu̍t	Categoría:Plantae
分類:Vu̍t-lí-ho̍k	Categoría:Física
分類:Chhṳ-yèn Khô-ho̍k	Categoría:Ciencias naturales
分類:Sâng-vu̍t-ho̍k	Categoría:Biología
分類:Fa-ho̍k	Categoría:Química
分類:Li̍t-sṳ́	Categoría:Historia
分類:Thi-lî	Categoría:Geografía
分類:Sa-fi	Categoría:Sociedad
分類:Chûng-kau	Categoría:Religión
分類:Thí-yuk	Categoría:Deporte
分類:Khô-ho̍k	Categoría:Ciencia
分類:Lièn-ha̍p-koet	Categoría:Organización de las Naciones Unidas
分類:Êu-chû Lièn-mèn	Categoría:Unión Europea
分類:Kien-chuk-vu̍t	Categoría:Edificios y estructuras
分類:Thûng-sin	Categoría:Comunicación
分類:Thi-khiù	Categoría:Tierra
Zuera	Zuera
Langa del Castillo	Langa del Castillo
Contamina	Contamina
Abiego	Abiego
Abanto	Abanto (Zaragoza)
Kú Lò-mâ	Antigua Roma
La Fueva	La Fueva
Tsui-heu ke Sṳ́m-phan	Juicio Final
Greenwich Thai-ho̍k	Universidad de Greenwich
Sat-mû-ngí-ki-song	I Samuel
分類:Chet-ho̍k	Categoría:Filosofía
分類:Fu̍t-kau	Categoría:Budismo
分類:Kî-tuk-kau	Categoría:Cristianismo
分類:Yù-thai-kau	Categoría:Judaísmo
Ên-tiâu	Águila
Ngùi Pó-lò	Paul Wei
Hò-sṳ̂n	Mililitro
Bochotnica	Bochotnica
琴浦同學	Kotoura-san
分類:Hàng-sên	Categoría:Planetas
分類:Vùn-fa	Categoría:Cultura
分類:Ngìn-vùn Khô-ho̍k	Categoría:Humanidades
分類:Tî-sṳt	Categoría:Conocimiento
Gurrea de Gállego	Religión en Cuba
Hiông-kóng Sṳp-thi Kûng-yèn	Parque del humedal de Hong Kong
Ngiù-yèn	Bola de ternera
Chṳ́-set	Púrpura
Notre-Dame-du-Mont-Carmel, Québec	Notre-Dame-du-Mont-Carmel
Thai-phìn-thiên-koet	Reino Celestial Taiping
Hiông (Thòi-vân)	Kecamatan
Ap-è	Pato
Lù-tshṳ̀	Phalacrocoracidae
分類:Yên-yèn	Categoría:Actores
模板:Tl	Plantilla:Ep
模板:Userbox	Usuario:Userbox/Userbox
模板:Wikipedialang	Plantilla:Portada:Idiomas
分類:Koet-kâ	Categoría:Países
Wikipedia:Kón-lî-yèn	Wikipedia:Bibliotecarios
分類:Chûng-fà Mìn-chhu̍k	Categoría:Etnias de China
分類:Ngìn-vu̍t	Categoría:Personas
分類:Mìn-chhu̍k	Categoría:Etnias
Wikipedia:Hàng-tsṳn-yèn	Wikipedia:Burócratas
Wikipedia:IP chhà-fûng li-ngoi-chá	Wikipedia:Exento de bloqueo a IP
Wikipedia:Kî-hi-ngìn	Wikipedia:Bot
分類:Sṳ̀-kiên	Categoría:Tiempo
分類:Chhṳ-yèn	Categoría:Naturaleza
分類:Kûng-chhàng	Categoría:Ingeniería
分類:Yî-ho̍k	Categoría:Medicina
分類:Chṳn-chṳ	Categoría:Política
分類:Kau-yuk	Categoría:Educación
分類:Kông-ho̍k	Categoría:Óptica
Âi-khi̍p	Egipto
分類:Chat-ho̍k-kâ	Categoría:Filósofos
模板:Bot	Plantilla:Bot
Kâ-nâ-thai	Canadá
分類:Hiûng-ngà-li	Categoría:Hungría
分類:Hî-lia̍p	Categoría:Grecia
分類:Lâ-thot-vì-â	Categoría:Letonia
分類:Yù-hi	Categoría:Juegos
Thiên-koet	Cielo (religión)
分類:Êu-chû koet-kâ	Categoría:Países de Europa
分類:Êu-chû	Categoría:Europa
模板:Documentation	Plantilla:Documentación
Wikipedia:Yung-fu	Wikipedia:Tipos de usuarios
Wikipedia:Sa-khî	Portal:Comunidad
分類:Wikipedians by language	Categoría:Wikipedia:Wikipedistas por idioma
Sṳ̀n Chhai-kî	Sung Jae-ki
Khi-néu Kî-chhòng	Centro de conexión
Khî-ngia̍p	Negocio
Ngiuk-yèn	Albóndiga
模板:Softredirect	Plantilla:Redirección suave
模板:Delete	Plantilla:Destruir
分類:Kî-su̍t	Categoría:Tecnología
分類:Ngî-ngièn	Categoría:Lenguas
Wikipedia:Chhóng-kien Sîn Thiàu-muk	Ayuda:Cómo empezar una página
分類:還無索引嘅頁面	Categoría:Wikipedia:Páginas no indexadas
分類:含有損壞文件鏈接嘅頁面	Categoría:Wikipedia:Páginas con enlaces rotos a archivos
模板:Navbox	Plantilla:Navegación
Thoi-chhú	Canguro
Pak-ha̍p-fâ	Lilium
模板:!	Plantilla:!
模板:!-	Plantilla:!-
模板:Tnavbar	Plantilla:Navbar
模板:Unicode	Plantilla:Unicode
模板:Smallcaps	Plantilla:Versalita
模板:Small	Plantilla:Small
模板:Nowrap	Plantilla:Nowrap
分類:Fî-chû	Categoría:África
分類:Mpumalanga-sén	Categoría:Mpumalanga
分類:Sṳn-kîn	Categoría:Biblia
分類:Si	Categoría:Libros
模板:Pâ-phe̍t	Plantilla:Babel
模板:Reflist	Plantilla:Listaref
模板:Stub	Plantilla:Esbozo
分類:Yî-chhiu	Categoría:Universo
模板:Location map/Info	Plantilla:Mapa de localización/Info
分類:Khûn-chhùng	Categoría:Insecta
分類:Â-chû	Categoría:Asia
分類:Chṳ-li	Categoría:Chile
分類:Sok-lî-â-sén	Categoría:Provincia de Soria
分類:Nàm-mî-chû	Categoría:América del Sur
分類:Khà-sṳ̂-tì-li-â lâu Lòi-ngong	Categoría:Castilla y León
模板:Esoteric	Plantilla:Plantilla compleja
分類:Mâ-lòi-sî-â	Categoría:Malasia
分類:Sṳ̍t-phín	Categoría:Alimentos
模板:SIL	Plantilla:Doc ISO3
分類:Thiàu-mi-liau	Categoría:Condimentos
分類:Chû-chṳt	Categoría:Organizaciones
分類:Ngî-ngièn-ho̍k	Categoría:Lingüística
模板:ITA	Plantilla:ITA
模板:SVK	Plantilla:SVK
模板:Infobox Country	Plantilla:Ficha de país
模板:TUR	Plantilla:TUR
分類:User en-4	Categoría:Wikipedia:Wikipedistas con nivel experto de inglés
分類:User en	Categoría:Wikipedia:Wikipedistas con conocimientos de inglés
分類:User zh	Categoría:Wikipedia:Wikipedistas con conocimientos de chino
分類:User zh-N	Categoría:Wikipedia:Wikipedistas con nivel nativo de chino
分類:User en-2	Categoría:Wikipedia:Wikipedistas con nivel intermedio de inglés
模板:Cite web	Plantilla:Cita web
分類:Hòng-khûng	Categoría:Aviación
模板:Country data	Plantilla:Geodatos
分類:Yím-sṳ̍t	Categoría:Comida y bebida
模板:BS3	Plantilla:BS3
分類:Tsúng-thúng	Categoría:Presidentes
模板:IPA	Plantilla:AFI
分類:Chṳn-chṳ Ngìn-lui	Categoría:Políticos
分類:Mî-chû	Categoría:América
模板:其他	Plantilla:Otros usos
分類:Language user templates	Categoría:Wikipedia:Plantillas Babel
模板:User language-N	Plantilla:BabelN
Wikipedia:GNU自由文檔協議證書	Wikipedia:Texto de la Licencia de documentación libre de GNU
模板:Topicon	Plantilla:Icono en título
分類:Vùn-ho̍k-kâ	Categoría:Escritores
分類:Kiûn-sṳ	Categoría:Fuerzas armadas
分類:Thai-ho̍k	Categoría:Universidades
模板:Country data Malaysia	Plantilla:Geodatos Malasia
模板:Lang-he	Plantilla:Lang-he
模板:Both	Plantilla:Ambas
分類:Sṳ-kie Pok-lám-fi	Categoría:Exposiciones Universales
分類:Chûng-fà Ngìn-mìn Khiung-fò-koet Chú-sit	Categoría:Presidentes de la República Popular China
模板:Documentation subpage	Plantilla:Subpágina de documentación
分類:Fu̍k-tsông	Categoría:Monjes budistas
模板:FIN	Plantilla:FIN
模板:Purge	Plantilla:Purgar
模板:Lang-de	Plantilla:Lang-de
模板:DNK	Plantilla:DNK
模板:Userpage	Plantilla:Página usuario
模板:DEU	Plantilla:DEU
模板:SWE	Plantilla:SWE
模板:User language-4	Plantilla:Babel4
分類:Ye̍t-nàm kî-chhòng	Categoría:Aeropuertos de Vietnam
Kiet-tshòng	Colon
分類:Kûng-sṳ̂	Categoría:Empresas
Â-mí	Attómetro
模板:JPN	Plantilla:JPN
分類:Thien-nó	Categoría:Computadoras
模板:MKD	Plantilla:MKD
模板:LTU	Plantilla:LTU
分類:Sṳ-chhòng	Categoría:Mercados
Mô-li-ngìn	Maorí
分類:Tho-lu	Categoría:Calles y carreteras
模板:Disambig	Plantilla:Desambiguación
分類:Khien-không Khô-ho̍k	Categoría:Ciencias de la salud
分類:Hàng-thung Thien-fa	Categoría:Teléfonos móviles
模板:GRC	Plantilla:GRC
模板:Lang-grc	Plantilla:Lang-grc
模板:CZE	Plantilla:CZE
模板:Lifetime	Plantilla:NF
模板:Lang-en	Plantilla:Lang-en
分類:Chhòn-ngiam-phiang	Categoría:Enfermedades infecciosas
分類:Sîn-kau	Categoría:Protestantismo
模板:GBR	Plantilla:GBR
分類:Sâng-vu̍t	Categoría:Organismos
模板:SVN	Plantilla:SVN
模板:FRA	Plantilla:FRA
分類:Kâ-li-sî-â	Categoría:Galicia
分類:User yue	Categoría:Wikipedia:Wikipedistas con conocimientos de Cantonese
分類:User fr	Categoría:Wikipedia:Wikipedistas con conocimientos de francés
分類:User ja	Categoría:Wikipedia:Wikipedistas con conocimientos de japonés
分類:User pt	Categoría:Wikipedia:Wikipedistas con conocimientos de portugués
分類:User nl-3	Categoría:Wikipedia:Wikipedistas con nivel avanzado de neerlandés
分類:User fr-2	Categoría:Wikipedia:Wikipedistas con nivel intermedio de francés
分類:User ja-2	Categoría:Wikipedia:Wikipedistas con nivel intermedio de japonés
分類:User ko-N	Categoría:Wikipedia:Wikipedistas con nivel nativo de coreano
分類:User fr-N	Categoría:Wikipedia:Wikipedistas con nivel nativo de francés
分類:Vùn-sṳ	Categoría:Sistemas de escritura
分類:Tho-kau	Categoría:Taoísmo
分類:User de	Categoría:Wikipedia:Wikipedistas con conocimientos de alemán
分類:User de-2	Categoría:Wikipedia:Wikipedistas con nivel intermedio de alemán
分類:User de-N	Categoría:Wikipedia:Wikipedistas con nivel nativo de alemán
分類:User en-3	Categoría:Wikipedia:Wikipedistas con nivel avanzado de inglés
分類:User en-N	Categoría:Wikipedia:Wikipedistas con nivel nativo de inglés
分類:User es	Categoría:Wikipedia:Wikipedistas con conocimientos de español
分類:User es-2	Categoría:Wikipedia:Wikipedistas con nivel intermedio de español
分類:User es-N	Categoría:Wikipedia:Wikipedistas con nivel nativo de español
分類:Hiông-kóng Thi-lî	Categoría:Geografía de Hong Kong
模板:Lang-lv	Plantilla:Lang-lv
分類:Yî-set-lie̍t kiûn-vòng	Categoría:Reyes de Israel
分類:Kí-hò-ho̍k	Categoría:Geometría
分類:User ja-1	Categoría:Wikipedia:Wikipedistas con nivel básico de japonés
分類:User ko	Categoría:Wikipedia:Wikipedistas con conocimientos de coreano
模板:Lang-vi	Plantilla:Lang-vi
分類:Lièn-ha̍p-koet Pi-sû-chóng	Categoría:Secretaría general de Naciones Unidas
分類:Hói-yòng	Categoría:Mares
分類:Ido-ngî	Categoría:Ido
模板:LUX	Plantilla:LUX
分類:Thai-yòng-ne	Categoría:Sistema Solar
分類:Kóng-tûng-sén	Categoría:Provincia de Cantón
分類:Fuk-kian	Categoría:Fujian
分類:Koet-chi Chû-chṳt	Categoría:Organizaciones internacionales
分類:Fat-mìn-kâ	Categoría:Inventores
分類:Yím-liau	Categoría:Bebidas
分類:Sa-fi Khô-ho̍k	Categoría:Ciencias sociales
分類:Mî-koet Koet-kâ Kûng-yèn	Categoría:Parques nacionales de Estados Unidos
分類:Kô-tén Kau-yuk	Categoría:Educación superior
分類:Thi-hìn	Categoría:Accidentes geográficos
分類:Pâ-lùn-sî-â Chhṳ-chhṳ-khî	Categoría:Comunidad Valenciana
分類:Thiên-chú-kau	Categoría:Catolicismo
分類:Yîm-ngo̍k-kâ	Categoría:Músicos
模板:!((	Plantilla:!((
模板:))!	Plantilla:))!
模板:Lang	Plantilla:Lang
分類:Fa-kâ	Categoría:Pintores
分類:Yin-thu chûng-kau	Categoría:Religión en la India
分類:Ho̍k-su̍t	Categoría:Academia
分類:Ngìn-lui	Categoría:Humanos
模板:CYP	Plantilla:CYP
分類:Yin-thu Thi-lî	Categoría:Geografía de la India
分類:Sông-ngia̍p	Categoría:Comercio
分類:Fap-koet fòng-ti	Categoría:Emperadores de Francia
模板:EST	Plantilla:EST
模板:AUT	Plantilla:AUT
分類:Meu-khô	Categoría:Felidae
分類:Kâ-le̍t-pí-hói	Categoría:Mar Caribe
分類:Thòi-vân Thi-lî	Categoría:Geografía de la República de China
分類:Nì-pok Thi-lî	Categoría:Geografía de Nepal
分類:Thai-khûng-ngìn	Categoría:Astronautas
分類:Chûng-fà Mìn-tshu̍k Tshṳ-tshṳ-chû	Categoría:Prefecturas autónomas de China
分類:Khî-ngia̍p-kâ	Categoría:Empresarios
分類:Fî-li̍t-pîn	Categoría:Filipinas
分類:User nl	Categoría:Wikipedia:Wikipedistas con conocimientos de neerlandés
分類:User zh-1	Categoría:Wikipedia:Wikipedistas con nivel básico de chino
分類:Ho̍k-vi	Categoría:Grados académicos
分類:Pô-sṳ̂ koet-vòng	Categoría:Reyes de Persia
分類:Kîm-yùng	Categoría:Finanzas
分類:Chûng-fà mìn-koet tsúng-thúng	Categoría:Presidentes de la República de China
分類:Thien-sṳ	Categoría:Televisión
分類:Chhòn-kau-sṳ	Categoría:Misionarios
分類:Hói-hia̍p	Categoría:Estrechos
粵語	Chino cantonés
分類:Yin-Êu Ngî-ne	Categoría:Lenguas indoeuropeas
分類:Kî-chhòng	Categoría:Aeropuertos
分類:Fa-ho̍k ngièn-su	Categoría:Elementos químicos
分類:Khô-ho̍k-kâ	Categoría:Científicos
分類:Pâ-kî-sṳ̂-thán Thi-lî	Categoría:Geografía de Pakistán
分類:Kî-tuk-kau lî-ngì	Categoría:Liturgia
分類:Nì-pok	Categoría:Nepal
分類:Thòi-vân	Categoría:Taiwán
分類:Chûng-koet chhèu-thoi	Categoría:Dinastías de China
分類:Pet-mî-chû koet-kâ	Categoría:Países de América del Norte
分類:Sṳ-tshòi	Categoría:Verduras
分類:Súi-kó	Categoría:Frutas
分類:Khiu-yok Sṳn-kîn	Categoría:Antiguo Testamento
分類:Pok-vu̍t-kón	Categoría:Museos
分類:Hì-hèu	Categoría:Clima
分類:Â-chû Thi-lî	Categoría:Geografía de Asia
分類:Ngìn-lui-ho̍k	Categoría:Antropología
分類:Thai-khûng Chhàm	Categoría:Estaciones espaciales
分類:Fap-koet Thai-ho̍k	Categoría:Universidades de Francia
模板:ESP	Plantilla:ESP
分類:Thung-vu̍t	Categoría:Animales
分類:Chit-chhûi Thung-vu̍t	Categoría:Vertebrata
分類:Ngî-yîm-ho̍k	Categoría:Fonética
分類:Hòng-khûng Kûng-sṳ̂	Categoría:Aerolíneas
分類:Ngìn-khièn	Categoría:Derechos humanos
分類:Ngo̍k-hi	Categoría:Instrumentos musicales
分類:Ngî-ne	Categoría:Familias de lenguas
分類:Hon-sṳ	Categoría:Escritura china
分類:Pó-sa̍k	Categoría:Gemas
分類:Koet-kâ Kûng-yèn	Categoría:Parques nacionales
分類:Hi-siong-ho̍k	Categoría:Meteorología
分類:Chûng-mî-chû	Categoría:América Central
分類:Fî-kîm-su̍k	Categoría:No metales
分類:Hiông-kóng	Categoría:Hong Kong
分類:Kóng-sî-sén	Categoría:Guangxi
分類:Yên-liau	Categoría:Combustibles
分類:Sông-hói	Categoría:Shanghái
分類:Sin-sit kî-su̍t	Categoría:Tecnologías de la información
分類:Ngiuk-lui	Categoría:Carnes
分類:Yo̍k-ho̍k	Categoría:Farmacia
分類:Sú-tû	Categoría:Capitales nacionales
分類:Nàm-Â	Categoría:Asia Meridional
分類:Kham-thap-pu-lî-â	Categoría:Cantabria
分類:Â-sṳ̂-thù-lî-â-sṳ̂-sén	Categoría:Asturias
分類:Kîm-su̍k	Categoría:Metales
分類:Thòi-pet-sṳ	Categoría:Taipéi
分類:Lò-màn Ngî-chhu̍k	Categoría:Lenguas romances
分類:Kâu-thûng	Categoría:Transporte
分類:Ngiên-kiu	Categoría:Investigación
分類:Thông-lui	Categoría:Glúcidos
分類:Fòng-ti	Categoría:Emperadores
分類:Nàm-tó ngî-hì	Categoría:Lenguas austronesias
分類:Pet-mî-chû	Categoría:América del Norte
分類:Kô-sú	Categoría:Cantantes
分類:Si-chhòng	Categoría:Tíbet
分類:Sú-ho̍k-kâ	Categoría:Matemáticos
分類:Vu̍t-lî ho̍k-kâ	Categoría:Físicos
分類:Kîn-chi ho̍k-kâ	Categoría:Economistas
分類:Mìn-tsú	Categoría:Democracia
分類:Kî-tuk-kau Li̍t-sṳ́	Categoría:Historia del cristianismo
分類:Àu-mûn	Categoría:Macao
分類:Hàng-sên-ne	Categoría:Sistemas planetarios
分類:Hiông-kóng pan-tó	Categoría:Archipiélagos e islas de Hong Kong
分類:Thòi-vân ngî-ngièn	Categoría:Lenguas de Taiwán
分類:Thòi-vân Koet-kâ Kûng-yèn	Categoría:Parques nacionales de Taiwán
分類:Khiù-lui Yun-thung	Categoría:Deportes de pelota
分類:Ngiùn-hòng	Categoría:Bancos
Fu̍k-vu	Servicio (economía)
分類:Chûng-fà Ngìn-mìn Khiung-fò-koet	Categoría:República Popular China
分類:Kâ-thai-lò-nì-â	Categoría:Cataluña
分類:Khien-không	Categoría:Salud
模板:Lang-pl	Plantilla:Lang-pl
Trojany	Trojany
分類:Pâ-pí-lùn-ngìn	Categoría:Babilonios
分類:Â-chû koet-kâ	Categoría:Países de Asia
分類:Mî-chû koet-kâ	Categoría:Países de América
分類:Ngì-làn-yen	Categoría:Yilan
模板:MLT	Plantilla:MLT
分類:Kûng-yèn	Categoría:Parques
分類:Thòi-vân Ngiùn-hòng	Categoría:Bancos de Taiwán
分類:Sùn-fàn Hì-thúng	Categoría:Sistema circulatorio
分類:Si-chhòng Thi-lî	Categoría:Geografía de la región autónoma del Tíbet
分類:Nui-mùng-kú Tshṳ-tshṳ-khî	Categoría:Mongolia Interior
分類:Koet-tsi kîn-tsi tsû-tsṳt	Categoría:Organismos económicos internacionales
分類:Lâ-tên Mî-chû	Categoría:América Latina
分類:Chúng-chhu̍k	Categoría:Raza
分類:Chûng-fà Mìn-koet	Categoría:República de China
分類:Nàm-thèu-yen	Categoría:Condado de Nantou
分類:Siak-khiet-kau	Categoría:Sijismo
分類:Sa-fi Mìn-tsú Tsú-ngi	Categoría:Socialdemocracia
模板:BEL	Plantilla:BEL
分類:Kú-thoi chhu̍k-khiùn	Categoría:Pueblos antiguos
分類:Vùi-sṳ̂-khà-sén	Categoría:Provincia de Huesca
分類:Thap-là-kô-na̍p-sén	Categoría:Provincia de Tarragona
分類:Pâ-set-lò-nâ-sén	Categoría:Provincia de Barcelona
分類:Pâ-lùn-sî-â-sén	Categoría:Provincia de Valencia
分類:Chûng-kau-ho̍k	Categoría:Estudio de las religiones
分類:Thòi-vàn Ngièn-chhu-mìn	Categoría:Aborígenes de Taiwán
分類:Thien-fa	Categoría:Telefonía
分類:Ngân-set	Categoría:Color
分類:Â-là-kung	Categoría:Aragón
分類:Tseu-mìn	Categoría:Iluminación
分類:Phòng-châ-phú	Categoría:Panyab
分類:Lie̍t-yî-tha̍t-sén	Categoría:Provincia de Lérida
甲型流感病毒H7N9亞型	Influenzavirus A subtipo H7N9
分類:Sat-là-kô-sat-sén	Categoría:Provincia de Zaragoza
模板:HUN	Plantilla:HUN
Vòng-phûng	Avispa
分類:User en-1	Categoría:Wikipedia:Wikipedistas con nivel básico de inglés
分類:User de-1	Categoría:Wikipedia:Wikipedistas con nivel básico de alemán
Li̍t-thoi-chṳ-song	I Crónicas
Liû-khiû Khiùn-tó	Islas Ryūkyū
2013-ngièn Lù-sân Thi-chṳ́n	Terremoto de Ya'an de 2013
模板:Ping	Plantilla:Respuesta a
IPhone 5S	IPhone 5s
IPhone 5C	IPhone 5c
Sûng-kú Lô-siên	Doble hélice
Yun Hyon-seok	Yun Hyon-seok
特殊:最近更改	Especial:CambiosRecientes
模組:HtmlBuilder	Módulo:HtmlBuilder
馬來西亞航空17號班機空難	Vuelo 17 de Malaysia Airlines
Ngit-tèu Fuk-sa	Radiación solar
