អាហ្វ្រិក	África
ជប៉ុន	Japón
អង់គ្លេស	Inglaterra
ស្កុតឡែន	Escocia
វ៉ែល	Gales
អៀរឡង់ខាងជើង	Irlanda del Norte
សាធារណរដ្ឋអៀរឡង់	Irlanda
ប្រទេសហុងគ្រី	Hungría
អេស្ប៉ាញ	España
សហរដ្ឋអាមេរិក	Estados Unidos
ផែនដី	Tierra
ប៊ឺណឺស លី	Tim Berners-Lee
ស៊ុយអែត	Suecia
ប្រទេសប៉ូឡូញ	Polonia
អ៊ីតាលី	Italia
ព័រទុយហ្គាល់	Portugal
អឺរ៉ុប	Europa
អាស៊ី	Asia
វិគីភីឌា	Wikipedia
ភីអេចភី	PHP
ទីក្រុងញូវយ៉ក	Nueva York
កុំព្យូទ័រ	Computadora
អ៊ីនធើណេត	Internet
បារ៉ាក់ អូបាម៉ា	Barack Obama
ប៉ារីស	París
អាប្រាហាម លីនខូន	Abraham Lincoln
ប្រព័ន្ធប្រតិបត្តការ Android	Android
Google ស្វែងរក	Google
ម៉ិកស៊ិក	México
មហាសមុទ្រអាត្លង់ទិក	Océano Atlántico
មហាសមុទ្រប៉ាស៊ីហ្វិក	Océano Pacífico
ថ្ងៃច័ន្ទ	Lunes
ខែមករា	Enero
ខែកុម្ភៈ	Febrero
ខែមីនា	Marzo
ភពអង្គារ	Marte (planeta)
ខែមេសា	Abril
ខែឧសភា	Mayo
ខែមិថុនា	Junio
ខែកក្កដា	Julio
ខែសីហា	Agosto
ខែកញ្ញា	Septiembre
ខែតុលា	Octubre
ខែវិច្ឆិកា	Noviembre
ខែធ្នូ	Diciembre
អង្គារ	Martes
ថ្ងៃពុធ	Miércoles
ថ្ងៃព្រហស្បតិ៍	Jueves
ថ្ងៃសុក្រ	Viernes
ថ្ងៃសៅរ៍	Sábado
ថ្ងៃអាទិត្យ	Domingo
សេះ (​អុក​)	Caballo (ajedrez)
បារាំង	Francia
សត្វឆ្កែ	Canis lupus familiaris
រាជាណាចក្ររួម	Reino Unido
ឆ្មា	Felis silvestris catus
ភាសាបារាំង	Idioma francés
ប្រេស៊ីល	Brasil
រុស្ស៊ី	Rusia
ការ៉េ	Cuadrado
សមុទ្រ	Mar
អាល្លឺម៉ង់	Alemania
ភាសាអាល្លឺម៉ង់	Idioma alemán
ប្រទេសអាយឡែន	Islandia
ភពសៅរ៍	Saturno (planeta)
១ (លេខ)	Uno
២ (លេខ)	Dos
៣ (លេខ)	Tres
៥	Cinco
ចតុកោណកែង	Rectángulo
មុំកែង	Ángulo recto
អ៊ុយក្រែន	Ucrania
ទីក្រុងរ៉ូម	Roma
អាល់បានី	Albania
អាស៊ែបៃហ្សង់	Azerbaiyán
អង់ដូរ៉ា	Andorra
សាធារណរដ្ឋកាហ្សាក់ស្ថាន	Kazajistán
បុរីវ៉ាទីកង់	Ciudad del Vaticano
គុយបា	Cuba
ឥណ្ឌូនេស៊ី	Indonesia
អាហ្វ្រិកខាងត្បូង	Sudáfrica
ប្រវត្តិសង្ខេប ក្រុមតន្រ្តី រ៉ុក linkin park	Linkin Park
ប្រទេសអាល់ហ្សេរី	Argelia
ស្រា	Vino
ទឹក	Agua
ទូរទស្សន៏	Televisión
ភាសាអាយឡែន	Idioma islandés
ឈីលី	Chile
ព្រះយេស៊ូវ គ្រីស្ទ	Jesús de Nazaret
ភពពុធ	Mercurio (planeta)
ប្រវត្តិសាស្ត្រ	Historia
ភពសុក្រ	Venus (planeta)
ភាសា	Lenguaje
ភពព្រហស្បតិ៍	Júpiter (planeta)
ភពអ៊ុយរ៉ានុស	Urano (planeta)
វិគីភីឌាភាសាអង់គ្លេស	Wikipedia en inglés
ភពណិបទូន	Neptuno (planeta)
សិង្ហបុរី	Singapur
ភ្លុយតុង	Plutón (planeta enano)
ហ្វេសប៊ុក	Facebook
សង្គ្រាមលោកលើកទីមួយ	Primera Guerra Mundial
សង្គ្រាមលោកលើកទី២	Segunda Guerra Mundial
Ubuntu	Ubuntu
គណិតវិទ្យា	Matemáticas
បារ៉ែន	Baréin
ព្រះចន្ទ	Luna
អូស្ត្រាលី	Australia
រូបវិទ្យា	Física
ជីវវិទ្យា	Biología
កូរ៉េខាងជើង	Corea del Norte
ព្រះរាជាណាចក្រកម្ពុជា	Camboya
ឌីណូស័រ	Dinosauria
សាសនាឥស្លាម	Islam
សេរីភាព	Paz
សហភាពអឺរ៉ុប	Unión Europea
ណាប៉ូលេអុងបូណាប៉ារត៍	Napoleón Bonaparte
ព្រះអាទិត្យ	Sol
ឆ្នាំពន្លឺ	Año luz
អូសេអានី	Oceanía
ប្រព័ន្ធព្រះអាទិត្យ	Sistema Solar
អុីដ្រូសែន	Hidrógeno
ទីម័រខាងកើត	Timor Oriental
ម៉ុង ប្លុង	Mont Blanc
សឺរេស	Ceres (planeta enano)
អៀរីស	Eris (planeta enano)
ភព	Planeta
តន្ត្រី	Música
ភាសាអ៊ីតាលី	Idioma italiano
អាលុយមីញ៉ូម	Aluminio
នូវែលសេឡង់	Nueva Zelanda
ឥណ្ឌា	India
អង់ដ្រេ ម៉ារី អំពែរ	André-Marie Ampère
វីលីម ហ្សេកស្ពែរ	William Shakespeare
ប៉ាឡាវ	Palaos
ម៉ុងហ្គោលី	Mongolia
ជេនហ្គិស ខាន់	Gengis Kan
កូឡុំប៊ី	Colombia
ព្រះពុទ្ធសាសនា	Budismo
ហ្គាតេម៉ាឡា	Guatemala
មហាសមុទ្រអាកទិក	Océano Ártico
អ៊ីរ៉ង់	Irán
ភាសាប៉ូឡូញ	Idioma polaco
ហ្សកដង់	Jordania
កៀហ៊្សីស៊ីស្ថាន	Kirguistán
គុយវ៉ែត	Kuwait
ឡាវ	Laos
លីបង់	Líbano
ទ្វីបអាមេរិក	América
ម៉ាឡេស៊ី	Malasia
មីយ៉ាន់ម៉ា	Birmania
នេប៉ាល់	Nepal
ប៉ាគីស្ថាន	Pakistán
MySQL	MySQL
អារ៉ាប៊ីសាអូឌីត	Arabia Saudita
ស្រីលង្កា	Sri Lanka
ផ្លាតូ	Platón
តាជីគីស្ថាន	Tayikistán
YouTube	YouTube
អារីស្តូត	Aristóteles
ថៃ	Tailandia
វិទ្យុ	Radiocomunicación
តួរមិនីស្ថាន	Turkmenistán
វៀតណាម	Vietnam
កូរ៉េខាងត្បូង	Corea del Sur
សាធារណរដ្ឋឥស្លាមអាហ្វហ្កានីស្ថាន	Afganistán
ព្រែកជីកស៊ុយអែស	Canal de Suez
បង់ក្លាដែស្ស	Bangladés
សូក្រាត	Sócrates
ធ្វិតថឺរ	Twitter
ប៊្រុយណេ	Brunéi
ហ្វីលីពីន	Filipinas
អ៊ីសាក់ ញូតុន	Isaac Newton
OpenStreetMap	OpenStreetMap
អាល់បឺត អែងស្តែង	Albert Einstein
ប្រទេសហ្សំប៊ី	Zambia
ប៉េកាំង	Pekín
មហាត្មះគន្ធី	Mahatma Gandhi
ឆាលែស ដាវីន	Charles Darwin
ជូលីស៍ សេសារ	Julio César
ឥន្ទធនូ	Arco iris
អង្គការសហប្រជាជាតិ	Organización de las Naciones Unidas
ភូមិវិទ្យា	Geografía
ទីក្រុងប្រាក	Praga
បន្ទុកអគ្គីសនី	Carga eléctrica
ខេត្តជើងភ្នំ (ប្រទេសអ៊ីតាលី)	Piamonte
មហាសមុទ្រឥណ្ឌា	Océano Índico
អូសាម៉ា ប៊ីន ឡាឌែន	Osama bin Laden
ភាសាអេស្ប៉ាញ	Idioma español
ភីឡាដេលផ្យា	Filadelfia
ញូវយ៉ក	Nueva York (estado)
វ្លាឌីមៀរ អ៊ីលីច លេនីន	Lenin
អូហ្គុសទុស	César Augusto
លោកកៃយុសសេសារ	Calígula
ត្រាហ្សាន	Trajano
Kde	KDE
កូរ៉ាស៊ូន អាគីណូ	Corazón Aquino
ទីក្រុងតូខ្យូ	Tokio
ហ្វឺឌីណាន់ដ៏ ម៉ាហ្សេឡង់	Fernando de Magallanes
ស៊ីសេរ៉ូ	Marco Tulio Cicerón
ភ្នំពេញ	Nom Pen
ទីក្រុងព្រៃនគរ	Ciudad Ho Chi Minh
ទីក្រុងហានូយ	Hanói
គ្រិស្តសាសនា	Verdadera Iglesia de Jesús
ភាសាអង់គ្លេស	Idioma inglés
គូឡាឡាំពួ	Kuala Lumpur
២០០១	2001
JavaScript	JavaScript
HTML5	HTML5
ល្បឿនពន្លឺ	Velocidad de la luz
JPEG	Joint Photographic Experts Group
អេឡិចត្រុង	Electrón
ចក្រភព រ៉ូម	Imperio romano
Microsoft	Microsoft
គីមីវិទ្យា	Química
ស៊ីទ្រុងជ្រូក	C Sharp
បេណេឌីកទី១៦	Benedicto XVI
៧ កក្កដា	7 de julio
បាល់ទាត់	Fútbol
ទីក្រុងបូកូតា	Bogotá
ថ្ងៃទី៣១ខែធ្នូ	31 de diciembre
រិសថា	(4) Vesta
ស៊ីដនីយ៏	Sídney
ភ្លើង	Fuego
ខ្យល់	Atmósfera terrestre
កោះស៊ូម៉ាត្រា	Sumatra
ចាការតា	Yakarta
ចំណាត់ថ្នាក់ក្រុម:Wikipedia templates	Categoría:Wikipedia:Plantillas
កោះជ្វា	Java (isla)
ចំណាត់ថ្នាក់ក្រុម:ចំណាត់ថ្នាក់ក្រុមនៃទំព័រគំរូវិគីភីឌា	Categoría:Wikipedia:Plantillas por temática
កាលីម៉ាន់តាន់	Kalimantan
ខេត្តបន្ទាយមានជ័យ	Provincia de Banteay Mean Chey
វិគីភីឌា:ប្រអប់ខ្សាច់	Wikipedia:Zona de pruebas
អាកាសយានដ្ឋាន ដុង ហ៊យ	Aeropuerto de Đồng Hới
អាន់ ហ្វ្រែង	Ana Frank
ខុង ជឺ	Confucio
ម៉ារីលីន ម៉ុនរ៉ូ	Marilyn Monroe
ចំណាត់ថ្នាក់ក្រុម:គណិតវិទ្យា	Categoría:Matemáticas
ទំព័រគំរូ:ទិន្នន័យប្រទេស អ៊ីរ៉ង់	Plantilla:Geodatos Irán
ចំណាត់ថ្នាក់ក្រុម:ប្រវត្តិសាស្ត្រខ្មែរ	Categoría:Historia de Camboya
ចំណាត់ថ្នាក់ក្រុម:ប្រវត្តិសាស្រ្តសិង្ហបុរី	Categoría:Historia de Singapur
សមុទ្រ មេឌីទែរ៉ានេ	Mar Mediterráneo
វីនដូអេច	Windows 8
ទំព័រគំរូ:Agree	Plantilla:A favor
ទន្លេហ្គារ៉ូន	Río Garona
ស៊ីតថល	Seattle
ជញ្ជាំង ប៊ែរឡាំង	Muro de Berlín
ស្រូវ	Arroz
ទំព័រគំរូ:Lang-tr	Plantilla:Lang-tr
ទំព័រគំរូ:ផតថល	Plantilla:Portal
ប៊ីល ហ្គេត	Bill Gates
ភាសាជប៉ុន	Idioma japonés
ប្រជុំវីជ្ជា	Enciclopedia
ឌីវីឌី	DVD
ទំព័រដើម	Wikipedia:Portada
Central processing unit	Unidad central de procesamiento
រេស៊ីស្ទ័រ	Resistor
កីឡាអូឡាំពិក	Juegos olímpicos
សមុទ្រ កាសព្យែន	Mar Caspio
ឈី ហ្គីវ៉ារ៉ា	Ernesto Guevara
ទីក្រុងកាបូល	Kabul
ហ្គ្រាប្រីអ៊ែល ហ្រ្គារ៉ាស្សៀ ម៉ារ៉ាហ្គេស	Gabriel García Márquez
ទស្សនវិជ្ជា	Filosofía
ចំណាត់ថ្នាក់ក្រុម:លុប	Categoría:Wikipedia:Borrar (definitivo)
លិទ្ធិកុម្មុយនិស្ត	Comunismo
ហ៊ីលឡារី រូដហេម គ្លីនតុន	Hillary Clinton
Boeing 737	Boeing 737
អាហារនៅប្រទេសបារំាង និង របៀបធ្វើ	Gastronomía de Francia
មណ្ឌលម៉ាញេតូ	Magnetosfera
ភាសាកាតាឡាន	Idioma catalán
បណ្ណាល័យ	Biblioteca
នីល ហេនរីក ដេវីដ ប៊័រ	Niels Bohr
និវេសនវិទ្យា	Ecología
ក្លឹបបាល់ទាត់បារសេឡូណា	Fútbol Club Barcelona
នយោបាយ	Política
ធនាគារពិភពលោក	Banco Mundial
ប្រជាធិបតេយ្យ	Democracia
អង្គការសន្ធិសញ្ញាអាត្លង់ទិកខាងជើង	OTAN
ម៉ារី ស្កូដូស្កា គុយរី	Marie Curie
រង្វាន់ណូបែល	Premio Nobel
មជ្ឈិមបូព៌ា	Oriente Medio
រាជវង្សហាន	Dinastía Han
ប្រទេស	Estado
គ្រឹស្តុបផើ កូឡំបូស (Christopher Columbus)	Cristóbal Colón
ព្រែកជីកប៉ាណាម៉ា	Canal de Panamá
មហាសមុទ្រខាងត្បូង	Océano Antártico
ក្មេង	Niño
លេអុនហាដ អយល័រ	Leonhard Euler
ណាប៉ូលេអុងទី៣	Napoleón III Bonaparte
ភាសារុស្ស៊ី	Idioma ruso
ល្វី ដ៏អស្ចារ្យ	Luis XIV de Francia
សមាគមប្រជាជាតិអាស៊ីអាគ្នេយ៍	Asociación de Naciones del Sudeste Asiático
ប្រវត្តិសាស្ត្របារាំង	Historia de Francia
តុលាការយុត្តិធម៌អន្តរជាតិ	Corte Internacional de Justicia
យូណេស្កូ	Unesco
អង្គការសុខភាពពិភពលោក	Organización Mundial de la Salud
អង្គការពាណិជ្ជកម្មពិភពលោក	Organización Mundial del Comercio
ភាសាចិន	Idioma chino
ធម្មជាតិ	Naturaleza
ឈាម	Sangre
រញ្ជួយផែនដី	Terremoto
សមុទ្រឡាប់តែវ	Mar de Láptev
ភ្លើងចរាចរ	Semáforo
ម៉ាទីន ឡូតធឺរ ឃីង	Martin Luther King
ត្រីកោណមាត្រ	Trigonometría
ធរណីមាត្រ	Geometría
វេយ្យាករណ៍	Gramática
សេដ្ឋកិច្ច	Economía
អក្សរក្រិច	Alfabeto griego
អក្សរឡាតាំង	Alfabeto latino
រឿងមហាភារតយុទ្ធ	Majabhárata
ការិយាល័យសហព័ន្ធស៊ើបអង្កេត	FBI
វីយោឡុង	Violín
ឃឹម	Címbalo húngaro
អេឡិចសាន់ដឺ ដឹ ហ្គារ៉ែត	Alejandro Magno
សង្គម	Sociedad
ការអប់រំ	Educación
មនុស្សប្រុស	Varón
វិគីភីឌាភាសាអេស៉្បាញ	Wikipedia en español
សិទ្ធិមនុស្ស	Derechos humanos
ទាសភាព	Esclavitud
សង្គ្រាមស៊ីវិល	Guerra civil
ភ្នំ	Montaña
ហុងកុង	Hong Kong
សង្គ្រាមត្រជាក់	Guerra Fría
សេអ៊ូល	Seúl
សង្គ្រាមវៀតណាម	Guerra de Vietnam
ម៉ៃឃើល ហ្វារ៉ាដេយ	Michael Faraday
អង់រីកូ ហ្វែរមី	Enrico Fermi
ភាសាអ៊ុយក្រែន	Idioma ucraniano
HTML	HTML
ច្យូហានេស គូទេនបឺគ	Johannes Gutenberg
ភាសាដាណឺម៉ាក	Idioma danés
ភាសាអេស្តូនី	Idioma estonio
ហិណ្ឌូសាសនា	Hinduismo
ភាសាពែក	Idioma persa
សាសនា	Religión
ភាសាកូរ៉េ	Idioma coreano
ភាសាខ្មែរ	Idioma camboyano
ហ្រ្គេតស៊ីងមួន	Sigmund Freud
ភាសាថៃ	Idioma tailandés
ភាសាម៉ាឡេ	Idioma malayo
ភាសាឥណ្ឌូនេស៊ី	Idioma indonesio
ភាសាហេប្រ៊ូ	Idioma hebreo
ចន ឡុក	John Locke
ថ្លើម	Hígado
ចិត្តវិទ្យា	Psicología
មហាសមុទ្រ	Océano
ពុទ្ធប្រវត្តិសង្ខេប	Buda Gautama
ចរិយាមារយាទ	Ética
សារជីវកម្មផ្សព្វផ្សាយព័ត៌មានរបស់ចក្រភពអង់គ្លេស(BBC)	BBC
ក្លិបបាល់ទាត់ឆេលស៊ី	Chelsea Football Club
គ្រោងឆ្អឹងមនុស្ស	Esqueleto humano
ក (អវយវៈ)	Cuello
រាជវង្សថាង	Dinastía Tang
John F. Kennedy	John F. Kennedy
LibreOffice	LibreOffice
ផ្លូវរូងដីក្រោមសមុទ្រ	Eurotúnel
តារាងខួបនៃធាតុគីមី	Tabla periódica de los elementos
ប្រូម៉ាស	Queso
ទំពាំងបាយជូរ	Uva
បន្លែ	Verdura
បច្ចេកវិទ្យា	Tecnología
វិស្វកម្ម	Ingeniería
ទំនាក់ទំនង	Comunicación
វិជ្ជាជីវៈខាងសារព័ត៌មាន	Periodismo
កាសែត	Prensa escrita
ទូរស័ព្ទ	Teléfono
វប្បធម៌	Cultura
សំស្ក្រឹត	Sánscrito
ប្រដាប់របត់ឈាម	Aparato circulatorio
The Guardian	The Guardian
សមីការឌីផេរ៉ង់ស្យែល	Ecuación diferencial
មៃក្រូសូហ្វអ៊ិសេល	Microsoft Excel
មុំ	Ángulo
សំទុះ	Aceleración
ព្រះសិវៈ	Shiva
ព្រះវិស្ណុ	Visnú
Local Area Network	Red de área local
Wide Area Network	Red de área amplia
ព្រះព្រហ្ម	Brahma
កម្លាំង	Fuerza
អេឡិចត្រូម៉ាញ៉េទិច	Electromagnetismo
កសិកម្ម	Agricultura
សំលៀកបំពាក់	Ropa
ល្បឿន	Velocidad
ក្រដាស	Papel
សុញ្ញកាស	Vacío
ស៊ីនេម៉ាទិច	Cinemática
ក្រលាផ្ទៃ	Área
ទ្រឹស្តីបទពីតាករ	Teorema de Pitágoras
ចំនួនកុំផ្លិច	Número complejo
Cristiano Ronaldo	Cristiano Ronaldo
អ្នកថតរូប	Fotografía
ល្ខោន	Teatro
គ្រឿងអេឡិចត្រូនិច	Componente electrónico
ព័ត៌មានវិទ្យា	Tecnología de la información
អាស៊ីអាគ្នេយ៍	Sudeste Asiático
ក្រុងសៀមរាប	Ciudad de Siem Riep
បញ្ជីរាយនាម ប្រទេស	Anexo:Países
វិគីភីឌាភាសាព័រទុយហ្គាល់	Wikipedia en portugués
ប្រដាប់រំលាយអាហារ	Digestión
កីឡាចាក់សាប	Esgrima
រោគផ្ដាសាយធម្មតា	Resfriado común
រោគសរសៃប្រសាទ	Enfermedad mental
ប្រតិទិន ក្រេកូរី	Calendario gregoriano
សុខភាព	Salud
ជម្ងឺរលាកទងសួត	Neumonía
ជំងឺអេដស៍	Sida
កូដ QR	Código QR
ជំងឺទឹកនោមផ្អែម	Diabetes mellitus
ទំព័រគំរូ:Location map Belgium	Plantilla:Mapa de localización de Bélgica
ទំព័រគំរូ:Location map Croatia	Plantilla:Mapa de localización de Croacia
ទំព័រគំរូ:Location map Ukraine	Plantilla:Mapa de localización de Ucrania
ទំព័រគំរូ:Location map Burma	Plantilla:Mapa de localización de Myanmar
ទំព័រគំរូ:Location map Philippines	Plantilla:Mapa de localización de Filipinas
ទំព័រគំរូ:Location map Vietnam	Plantilla:Mapa de localización de Vietnam
ទំព័រគំរូ:Location map Cambodia	Plantilla:Mapa de localización de Camboya
ទំព័រគំរូ:Location map Thailand	Plantilla:Mapa de localización de Tailandia
ទំព័រគំរូ:Location map Indonesia	Plantilla:Mapa de localización de Indonesia
ទំព័រគំរូ:Location map Australia	Plantilla:Mapa de localización de Australia
ញូតុន	Newton (unidad)
ចក្រភព អូតូម៉ង់	Imperio otomano
ម៉ាស៊ីនចំហេះក្នុង	Motor de combustión interna
ក្បាច់គិតលេខ	Ábaco
វឺតប្រែស	WordPress
Joomla!	Joomla
ដើមដូង	Cocos nucifera
ភាសាណាវ៉ាថ្ល៍	Náhuatl
ភាសាម៉ាយ៉ាយូកាតិក	Idioma maya
អែនជេលីណា ចូលី	Angelina Jolie
អ៊ីលដឺហ្រ្វែន	Isla de Francia
ភាសាអារ៉ាប់	Idioma árabe
Thanksgiving	Día de Acción de Gracias
តំបន់ឃ្ជឺស្សឺ	Kyūshū
តំបន់ស៊ីកុគឹ	Región de Shikoku
នាយករដ្ឋមន្ត្រី	Primer ministro
ទង់ជាតិ	Bandera
ខ្មៅដៃ	Lápiz
សហភាពសូវៀត	Unión Soviética
ចំណុចរលាយ	Punto de fusión
កាមេរ៉ា	Cámara fotográfica
កម្មវិធីទូរទស្សន៍	Programa (difusión)
ខេត្តខាហ្គុស៊ីម៉ា	Prefectura de Kagoshima
ភាសាស៊ី	C (lenguaje de programación)
ម៉ង់តេរីយើ	Montesquieu
វិគីភីឌា:អត្ថបទពិសេស	Wikipedia:Artículos destacados
ទំព័រគំរូ:Link FA	Plantilla:Destacado
ពិភពលោក	Mundo
ឈូក	Nelumbo nucifera
ឡងប៊ិច (កាលីផ្វនញ៉ា)	Long Beach (California)
រង្វង់	Circunferencia
ប្លង់	Plano (geometría)
វិគីភីឌាភាសាកូរ៉េ	Wikipedia en coreano
ទៀបកោះម៉ាឡេ	Península de Malaca
អេប៉ុងហ្ស៍ (ពពុះទឹក)	Porifera
មធ្យមនព្វន្ធ	Media aritmética
World Cup	Copa Mundial de Fútbol
សម្ដេចប៉ាប	Papa
IATA	Asociación Internacional de Transporte Aéreo
បុណ្យណូអែល	Navidad
ត្រីកោណ	Triángulo
លោកអេលីសេ រីខ្លាស	Élisée Reclus
អ្នកប្រើប្រាស់:អេង ឡុង/សង្គមវិទ្យាមូលដ្ឋាន	Sociología
សញ្ញាសំលេងអន្តរជាតិ	Alfabeto Fonético Internacional
តៃវ៉ាន់	Isla de Taiwán
Friedrich Schiller	Friedrich Schiller
ជំនឿបាហៃ	Bahaísmo
១	1
អាប្រាហាម ម៉ាស្លូ	Abraham Maslow
ខ្ទឹមស	Allium sativum
អ៊ូលេនបាធរ	Ulán Bator
កោះ	Isla
ភាសាផ្លូវការ	Idioma oficial
ខ្សែអេក្វាទ័រ	Ecuador terrestre
ទិស	Punto cardinal
លេខអាតូម	Número atómico
អាល់ហ្វ្រិដ ណូបែល	Alfred Nobel
សម្ដេចប៉ាប យូហាន ទី២៣	Juan XXIII
កិរិយាសព្ទ	Verbo
ទីតានិច	RMS Titanic
សត្វឆ្អឹងកង	Vertebrata
បាគូ	Upupa epops
អំពែរ	Amperio
ISO 3166-1	ISO 3166-1
១ មុនគ.ស	1 a. C.
ម៉ែត្រការ៉េ	Metro cuadrado
ជំនួយ:Interlanguage links	Plancton
សហស្សវត្សរ៍ទី២	II milenio
ខេត្តកំពង់គោ	Long An
ទ្រឹស្តីបទទ្វេធា	Teorema del binomio
សមុទ្រជប៉ុន	Mar del Japón
អាស៊ីខាងកើត	Asia Oriental
អាមេរិក កណ្ដាល	América Central
គ្រីស្ទអឌែលហ្វៀន	Cristadelfianos
បរិមាត្រ	Perímetro
ចក្រភព អូទ្រីស-ហុងគ្រី	Imperio austrohúngaro
បណ្ណាល័យជាតិ	Biblioteca pública
ផាយថុន	Python
អានន្ទ	Ananda
អាស៊ីហ្គេមឆ្នាំ១៩៥១	Juegos Asiáticos de 1951
បាកាន	Bagan
ចិន	China (región)
សំទុះទំនាញដី	Intensidad del campo gravitatorio
ច្បាប់ធម្មតា	Derecho anglosajón
អ្នកម្តាយ តេរេសា​ (Mother Teresa)	Teresa de Calcuta
ប្លូក	Blog
រោគគ្រុនចាញ់	Dengue
ដុល្លារហុងកុង	Dólar de Hong Kong
Xian JH-7	Xian JH-7
ខ្សែបណ្ដោយ	Meridiano
ខេត្តឃ្លាំង	Sóc Trăng
ខេត្តទឹកខ្មៅ	Cà Mau (provincia)
សមុទ្រខារ៉ា	Mar de Kara
ផ្លេតបន្ទោរ	Rayo
កំរងកោះ	Archipiélago
តួប្រុស	Actor
អំបូរភាសាយូតូអាហ្សតិក	Lenguas uto-aztecas
ចាស្ទីន ពីពេ្រ	Justin Bieber
ក្រុម​ភាសា​ថៃកៈដៃ	Lenguas tai-kadai
ចក្រភព រុស្ស៊ី	Imperio ruso
មឞវជ	Mošovce
បេណាហ្សៀរ ប៊ូតូ	Benazir Bhutto
ស៊ីឌី	Disco compacto
ឧទ្ធម្ភាគចក្រ	Helicóptero
គុណនាម	Adjetivo
វីតាមីន	Vitamina
វែបសាយ	Sitio web
តំបន់ហុកកៃដូ	Hokkaidō
រូបមន្តសមមូលម៉ាស់-ថាមពល	Equivalencia entre masa y energía
សមុទ្រ អារ៉ាល់	Mar de Aral
ហូ ជីមិញ	Hồ Chí Minh
ម៉ាក ហ្សុកឃឺបឺក	Mark Zuckerberg
ប្រតិកម្មគីមី	Reacción química
ខេត្តក្រមួនស	Kiên Giang
ខេត្តមាត់ជ្រូក	An Giang
ខេត្តរោងដំរី	Tay Ninh
ខេត្តព្រះត្រពាំង	Trà Vinh
Binomial nomenclature	Nomenclatura binomial
ខេត្តពលលាវ	Bạc Liêu
ខេត្តផ្សារដែក	Đồng Tháp
វ៉ែសបែង	Cisjordania
ភាសាបាលី	Pali
គេហទំព័រ	Página web
ចតុកោណ	Cuadrilátero
ឈិន ឡុង	Jackie Chan
ទិវាកុមារអន្តរជាតិ	Día del Niño
Yahoo!	Yahoo!
បន្ទាត់	Recta
ហ្មរិឩពឡ	Mariúpol
G8	G8
អង្កត់ផ្ចិត	Diámetro
គ្រូបង្រៀន	Maestro
ស្នាដៃនៃបុព្វបុរសខ្មែរ	Escritura
ស្ដេចប៉ាប យ៉ូហាន ប៉ូលទី១	Juan Pablo I
ណៃពិដោ	Naipyidó
ISO 4217	ISO 4217
ព្យែរ គុយរី	Pierre Curie
ក្រុមប្រឹក្សាសន្តិសុខ អង្គការសហប្រជាជាតិ	Consejo de Seguridad de las Naciones Unidas
ពហុកោណ	Polígono (geometría)
ទិវានៃក្ដីស្រលាញ់	Día de San Valentín
ហ្គូហ្គល	Mercado
សមុទ្រចិនខាងត្បូង	Mar de la China Meridional
និវេសនប្រព័ន្ធ	Ecosistema
សមុទ្រលឿង	Mar Amarillo
យ៉ាំងហ្គូន	Rangún
សូរព្យញ្ជនៈ	Consonante
ច្បាប់ចលនារបស់ញូតុន	Leyes de Newton
ឈូងសមុទ្របេងហ្គាល់	Bahía de Bengala
ទិវានារីអន្តរជាតិ	Día Internacional de la Mujer
.jp	.jp
ភ្នំហ្វឹជី	Monte Fuji
ប៉ុលពត	Pol Pot
Xian H-6	Xian H-6
Chengdu J-7	Chengdu J-7
Shenyang J-8	Shenyang J-8
ភ្នំភ្លើង អ៊ីស៊ាឡឺក	Eyjafjallajökull
ម៉ាក្រូសេដ្ឋកិច្ច	Macroeconomía
Harbin SH-5	Harbin SH-5
ដីជ្រោយហ្គាស្សា	Franja de Gaza
​វិទ្យុ​ស្ទូឌីយោ 54 បណ្តាញ	Radio Studio 54 Network
អេលីប	Elipse
វិទ្យុអាស៊ីសេរី	Radio Free Asia
សមាគមន៍សារព័ត៌មាន	Associated Press
អធិដ្ឋាន	Oración (religión)
គណៈកម្មាធិការអូឡាំពិកអន្តរជាតិ	Comité Olímpico Internacional
Skype	Skype
.kh	.kh
ចតុកោណស្មើ	Rombo
ទន្លេមេគង្គ	Río Mekong
មេកានិច	Mecánica
វិចិត្រសាលវលញ្ឆករប្រទេស	Anexo:Escudos de estados soberanos
ហែងរីហ ហឺត	Heinrich Rudolf Hertz
អង់រី បិកកឺរ៉ែល	Henri Becquerel
ទស្សនាវដ្ដី	Revista
សមីការដឺក្រេទី២	Ecuación de segundo grado
រូពីឥណ្ឌូនេស៊ី	Rupia indonesia
សមុទ្រអុកហុតស្គ៍	Mar de Ojotsk
ចិត្តវិភាគ	Psicoanálisis
ខ្មែរម៉ាស្ទើ	Webmaster
.kr	.kr
URL	Localizador de recursos uniforme
ក្រុមបាល់ទាត់ជម្រើសជាតិ អេស្ប៉ាញ	Selección de fútbol de España
Google Earth	Google Earth
ប៊ែនហាដ រីម៉ាន	Bernhard Riemann
កោន	Cono (geometría)
អាតុល	Atolón
ទិន្នន័យ	Dato
ខ្លែង	Cometa (juego)
ស្ថាបត្យករ	Arquitecto
មហាអំណាច អាប់ស៊ីស	Potencias del Eje en la Segunda Guerra Mundial
វិគីភីឌា:FAQ	Ayuda:Preguntas frecuentes
.th	.th
ចក្រភព អាល្លឺម៉ង់	Imperio alemán
ក្រុមបាល់ទាត់ជម្រើសជាតិ អាល្លឺម៉ង់	Selección de fútbol de Alemania
ហេរី ផោតធ័រ និង សិលាទេព	Harry Potter y la piedra filosofal
អង្គការ Creative Commons	Creative Commons
ឥណ្ឌូចិន	Indochina
ប្រាសាទអង្គរវត្ត	Angkor Wat
ទ្រឹស្ដីរ៉ឺឡាទីវីតេ	Teoría de la relatividad
ប្រុស	Masculino
Toulon	Tolón
ប៉ាស្កាល់	Pascal (unidad)
ទ្រឹស្ដីល្បែង	Teoría de juegos
នីតិរដ្ឋ	Imperio de la ley
សមុទ្រចិនខាងកើត	Mar de China Oriental
ខ្នុរ	Artocarpus heterophyllus
ប្រលេឡូក្រាម	Paralelogramo
ប្រាសាទព្រះវិហារ	Templo Preah Vihear
ចតុកោណព្នាយ	Trapecio (geometría)
ស៊ូស៊ី	Sushi
រូប៊ិក ខ្យូប	Cubo de Rubik
កាល	Plauto
ចង្រិត	Gryllidae
ទិវាពលកម្មអន្ដរជាតិ	Día Internacional de los Trabajadores
ស្ទឹង	Arroyo
សមុទ្រអង់ដាម៉ង់	Mar de Andamán
ប៉ិបស៊ី	Pepsi
ក្រុមបាល់ទាត់ជម្រើសជាតិ អង់គ្លេស	Selección de fútbol de Inglaterra
ក្រុមបាល់ទាត់ជម្រើសជាតិ បារាំង	Selección de fútbol de Francia
ទំព័រគំរូ:Commonscat	Plantilla:Commonscat
វិគីភីឌាភាសាអាល្លឺម៉ង់	Wikipedia en alemán
អាស៊ីខាងលិច	Oriente Próximo
យេនឌ័រ	Identidad de género
អង្គការសហភាពអន្តរជាតិដើម្បីអភិរក្សធម្មជាតិ	Unión Internacional para la Conservación de la Naturaleza
ទីក្រុងមេឌេយីណ	Medellín
ប៉ារ៉ាបូល	Parábola (matemática)
ខេត្តអ៊ីវ៉ាតិ	Prefectura de Iwate
ទ្វារសមុទ្រមលក្កា	Estrecho de Malaca
មហាយាន	Mahāyāna
ប្រព័ន្ធប្រតិបត្តការ iOS	IOS
ចំនួនបឋម	Número primo
សង្គ្រាម ប្រាំមួយ ថ្ងៃ	Guerra de los Seis Días
ក្រុងឡូវែល រដ្ឋម៉ាស្សាឈូស៊ែត	Lowell (Massachusetts)
សមុទ្រជ្វា	Mar de Java
សិប្បកម្មខ្ញុំ	Minecraft
ច្រកសមុទ្រធ្ងន់ធ្ងរ	Dire Straits
វីហ្សួលបេហ៊្សិក.ណេត	Visual Basic .NET
បំណែងចែករដ្ឋបាលនៃកម្ពុជា	Anexo:Organización territorial de Camboya
អនុគមន៍ដឺក្រេទី២	Función cuadrática
ច្បាប់អំពែរ	Ley de Ampère
ជំងឺអ៊ីបូឡា	Enfermedad por el virus del Ébola
ច្រកកូរ៉េ	Estrecho de Corea
ឆកសមុទ្រកូរ៉េ	Bahía de Corea
កង្កែប	Anura
ខ្សែទឹកឃឹរ៉ុស៊ីអុ	Corriente de Kuroshio
ចំណាត់ថ្នាក់ក្រុម:ព្រះមហាក្សត្រ	Categoría:Monarcas
ចំណាត់ថ្នាក់ក្រុម:រដ្ឋាភិបាល	Categoría:Gobierno
ទំព័រគំរូ:Infobox legislature	Plantilla:Ficha de parlamento
ទន្លេយ៉ាលូ	Río Yalu
មីហ្គេល អ៊ីដាលហ្គោ អ៊ី កុស្ទីយ៉ា	Miguel Hidalgo y Costilla
នរោត្តម សីហមុនី	Norodom Sihamoní
ហ៊ុន សែន	Hun Sen
តូក្យូស្កាយទ្រី	Skytree
ភាសាប៉ាស្តូ	Idioma pastún
កំណែទម្រង់រូបិយវត្ថុ	Reforma monetaria
ធនាគារកណ្ដាល	Banco central
Pidgin	Pidgin (software)
​វិលហែម វុឌ	Wilhelm Wundt
យិដា តាដូ	Gerda Taro
មនុស្សពីងពាង	Spider-Man
សារធាតុគីមី	Sustancia química
ចលនានៅក្នុងរូបវិទ្យា	Movimiento (física)
ជម្ងឺកញ្ជ្រឹល	Sarampión
ក្រុមបាល់ទាត់ជម្រើសជាតិ អាហ្សង់ទីន	Selección de fútbol de Argentina
ខ្យល់ព្រះអាទិត្យ	Viento solar
បាល់ទាត់ពិភពលោក ២០១៤	Copa Mundial de Fútbol de 2014
ម៉ូបាល (អាល់ឡាបាម៉ា)	Mobile (Alabama)
កុំព្យូទ័រផ្រូក្រាមមីង(Computer programming)	Programación
ខេត្តឈីបា	Prefectura de Chiba
អាំងតេក្រាល	Integración
ខេត្តអៃឈិ	Prefectura de Aichi
វិបត្តិសេដ្ឋកិច្ចឆ្នាំ ១៩៩៧	Crisis financiera asiática
ខ្មែរ	Adulto
សិល្បៈប្រើវោហារបង្ហូរគំនិត	Retórica
ឃីមីហ្គាយ៉ុ	Himno Nacional de Japón
សាល អូហ្គុស្ទីន ដឺ គូឡុំ	Charles-Augustin de Coulomb
ខេត្តអាគីតា	Prefectura de Akita
ថ្នាក់ពាក្យ	Categoría gramatical
ស្ថានភាពអភិរក្ស	Estado de conservación
កាន់ជិ	Kanji
នាម	Nombre
ប្រវត្តិសាស្ត្រចិន	Historia de China
អវតារ	Avatar
ច្បាប់គូឡុំ	Ley de Coulomb
រឿង រ៉ូមេអូ និង ហ្ស៊ុយលីយេ	Romeo y Julieta
សាលីណា កូមាស់	Selena Gomez
ក្រុមបាល់ទាត់ជម្រើសជាតិ ប្រេស៊ីល	Selección de fútbol de Brasil
កាល ឡែមស្ដែនណឺ	Karl Landsteiner
ឯកសារភាពយន្ត	Documental
អនុគមន៍ត្រីកោណមាត្រ	Función trigonométrica
ហ្រាន្ដកូស ហ្វីឡុន	François Fillon
ល្បែងទាញព្រ័ត្រ	Juego de la soga
Article (grammar)	Artículo (gramática)
មេដ្យានទ័រ	Compás (instrumento)
Rfid	RFID
អ៊ីប៉ូតេនុស	Hipotenusa
ហិចហ្វាន់	Fondo de cobertura
ISO 3166	ISO 3166
សញ្ញាជាតិកូរ៉េខាងជើង	Emblema nacional de Corea del Norte
មេហ្គា	Mega
គីឡូ	Kilo (prefijo)
ការតាំងសមាធិ	Meditación
ប៉េតា	Peta (prefijo)
យ៉ុតតា	Yotta
សង់ទី	Centi
ហ្គីហ្គា	Giga
តេរ៉ា	Tera (prefijo)
ហ្វង់តូ	Femto
ហ្សិតតា	Zetta
ច្រកតារតារី	Estrecho de Tartaria
ហ្សិបតូ	Zepto
កាតែត	Cateto
អាត់តូ	Atto
យ៉ុកតូ	Yocto
ដេស៊ី	Deci
ចំណែករដ្ឋបាលនៃម៉ិចស៊ិក	Organización territorial de México
ម៉ាស៊ីនស្វែងរក	Metabuscador
Shenyang J-15	Shenyang J-15
គណបក្សហ៊្វុនស៊ិនប៉ិច	Funcinpec
ខេត្តក្យូតុ	Prefectura de Kioto
តំលៃដាច់ខាត	Valor absoluto
ហេដ្ឋារចនាសម្ព័ន្ធ	Infraestructura urbana
សាស្ត្រាចារ្យ	Profesor
តេគីឡា	Tequila
សន្ធិសញ្ញាប្រេស្ត-លីតូវស្ក	Tratado de Brest-Litovsk
William Thomson, 1st Baron Kelvin	William Thomson
អាណាខេត្តអូសាកា	Prefectura de Osaka
ខេត្តអិហ៊ីមិ	Prefectura de Ehime
វាំងននដែក	Cortina de Hierro
Kara (band)	Kara (banda)
វីលៀម ជែម	William James
ខេត្តយ៉ាម៉ាកាតា	Prefectura de Yamagata
ច្រកតៃវ៉ាន់	Estrecho de Taiwán
គំរោងម៉ាន់ហាត់ថាន់	Proyecto Manhattan
ខេត្តយ៉ាម៉ាហ្គឹឈិ	Prefectura de Yamaguchi
ខេត្តខាន់ណាហ្គាវ៉ា	Prefectura de Kanagawa
បញ្ចកោណ	Pentágono
តំបន់ជឺហ្គុកឹ	Región de Chūgoku
ខេត្តណាហ្គាណុ	Prefectura de Nagano
ខេត្តសៃតាម៉ា	Prefectura de Saitama
ខេត្តមីអិ	Prefectura de Mie
ណុត	Nudo (unidad)
តំបន់តុហុកកឹ	Región de Tōhoku
ខេត្តហ្គឺនម៉ា	Prefectura de Gunma
ជ្រូកទឹក	Dugong dugon
ខ្សែទឹកមហាសមុទ្រ	Corriente marina
ខេត្តមីយ៉ាសាគី	Prefectura de Miyazaki
ខេត្តឃឹម៉ាម៉ុតុ	Prefectura de Kumamoto
មូលដ្ឋានូបនីយកម្មភាសា	Localización de idiomas
Mikoyan MiG-29	Mikoyan MiG-29
សប្ដាហ៏ពិសិដ្ឋ	Semana Santa
ឈូងសមុទ្រថៃ	Golfo de Tailandia
លី ក្វាន់យូ	Lee Kuan Yew
កម្មសិទ្ធិបញ្ញា	Propiedad intelectual
អាណាខេត្តណារ៉ា	Prefectura de Nara
បុព្វបទនៅក្នុងប្រព័ន្ធខ្នាតអន្តរជាតិ	Prefijos del Sistema Internacional
យន្តហោះប៉ូឡូញកំទេចឆ្នាំ២០១០	Accidente del Tu-154 de la Fuerza Aérea de Polonia
ហង់រី កាវិនឌីស	Henry Cavendish
បុណ្យចូលឆ្នាំចិន	Año Nuevo chino
ថេរវាទ	Theravada
តំបន់ខាន់តូ	Región de Kantō
ខេត្តនីហ្គាតាក់	Prefectura de Niigata
ខេត្តយ៉ាម៉ាណាស៊ី	Prefectura de Yamanashi
ខេត្តស៊ីម៉ាណិ	Prefectura de Shimane
ខេត្តតុយ៉ាម៉ា	Prefectura de Toyama
ខេត្តអូកាយ៉ាម៉ា	Prefectura de Okayama
ISO 3166-2	ISO 3166-2
ខេត្តអយតាក់	Prefectura de Ōita
ខេត្តខូឈិ	Prefectura de Kōchi
អង្គការអន្តរជាតិនៃនយោបាយរបស់បារាំង	Organización Internacional de la Francofonía
ភ្នំមេរ៉ាពី	Monte Merapi
ព្រះធម៌	Dharma
តំបន់ឈឺប៊ឹ	Región de Chūbu
វ៉ាក់សាំង	Vacuna
រោគក្អកមាន់	Tos ferina
គន្ថនិទ្ទេស	Bibliografía
អាហារខ្មែរ	Gastronomía de Camboya
គីមឈី	Kimchi
ខេត្តកំពង់ចាម	Provincia de Kompung Cham
ខ្សែទឹកហ្គ្រីនលែនខាងកើត	Corriente de Groenlandia Oriental
ខ្សែទឹកប៉ាស៊ីហ្វិកខាងជើង	Corriente del Pacífico Norte
ខ្សែទឹកហាំបុល	Corriente de Humboldt
ខ្សែទឹកអូស្ត្រាលីខាងកើត	Corriente de Australia Oriental
ជ័រទឹក	Resina
ដុនបូស្កូ	Juan Bosco
ធ្នូរង្វង់	Arco (geometría)
អប្សរា	Apsará
ស្រុក	Distrito
រាជវង្សចោឡា	Dinastía Chola
ខ្លារខិន ២ (រថក្រោះ)	Leopard 2
មហាអំណាច កណ្ដាល	Potencias Centrales
អិចសា	Exa
ហិកតូ	Hecto
ដេកា	Deca
រ៉ូបឺតកាប៉ា	Robert Capa
មីល្លី	Mili
មីក្រូ	Micro (prefijo)
ពីកូ	Pico (prefijo)
ណាណូ	Nano (prefijo)
លីប៉ូល ស៊ីដាស៊ាងហ័រ	Léopold Sédar Senghor
វិគីភីឌាភាសាឥណ្ឌូនេស៊ី	Wikipedia en indonesio
ទន្ដគោម	Agave
ប្រវតិ្តBoney M	Boney M.
វីមេអូ	Vimeo
អំពើអនិត្យានុកូល	Violencia doméstica
ហង់រី ការចេរ ប្រេស្សុង	Henri Cartier-Bresson
ត្រីកោណសម័ង្ស	Triángulo equilátero
ម៉ាក់ណូលា	Magnolia
ចូសេហ្វ ហិនរី	Joseph Henry
មន ស	Morus alba
ពិធីបញ្ជាប់ពាក្យ	Esponsales
ត្រីកោណកែង	Triángulo rectángulo
សមុទ្រហ្វីលីពីន	Mar de Filipinas
ប្រព័ន្ធកូអ័រដោណេភូមិសាស្ត្រ	Geopolítica
Eurocopter Tiger	Eurocopter EC665 Tigre
តេត្រាអែត	Tetraedro
ម៉ោងផែនដី	La hora del planeta
នរោត្ដម សីហនុ	Norodom Sihanouk
ទន្លេរីយ៉ូហ្គ្រែនដេ	Río Bravo
សំព័រ	Artocarpus
កម្មវិធីអភិវឌ្ឍន៍សហប្រជាជាតិ	Programa de las Naciones Unidas para el Desarrollo
ម៉ាស៊ីនថត លេកា	Leica
សេវាសាធារណៈ	Servicio público
មេគុណជីនី	Coeficiente de Gini
នីត្រូគ្លីសេរីន	Nitroglicerina
វណ្ណយុត្តិ	Signo diacrítico
ទង់ជាតិកម្ពុជា	Bandera de Camboya
ក្រុងអង្គរ	Angkor
ក្រពេញទីមុស	Timo
ទ្រឹស្តីបទកូស៊ីនុស	Teorema del coseno
ទក្សិណ ជិនវ័ត្រ	Thaksin Shinawatra
ប្រធាន	Sujeto (gramática)
អ៊ែង​ហ្គ្រី បឺដ	Angry Birds
អ៊ីពែបូល	Hipérbola
វិសមភាពស្វ័យគុណ	Desigualdad matemática
ប៊ិច	Pluma (escritura)
XHTML	XHTML
គ្រោះទុរ្ភិក្ស	Hambruna
អរិយសច្ច៤	Cuatro nobles verdades
ស្តាទិច	Estática (mecánica)
ខេត្តណាហ្គាសាគី	Prefectura de Nagasaki
វិគីភីឌាភាសាស្វីស	Wikipedia en sueco
ភ្លើងឆេះព្រៃ	Incendio forestal
ទ្រឹស្តីបទស៊ីនុស	Teorema del seno
ច្បាប់ហ៊ូក	Ley de elasticidad de Hooke
ក្រុមបាល់ទាត់ជម្រើសជាតិ ជប៉ុន	Selección de fútbol de Japón
រោគឈឺចាប់ក្នុងសន្លាក់ឆ្អឹង	Artritis
ប្លុកហ្គឺ (Blogger)	Blogger
ធម្មនុញ្ញនៃអង្គការសហប្រជាជាតិ	Carta de las Naciones Unidas
Boeing AH-64 Apache	Boeing AH-64 Apache
រោគហើមសួត	Bronquitis
អេមីល្យូ ហ្គីណូ សេហ្គ្រែ	Emilio Gino Segrè
Sukhoi Su-27	Sukhoi Su-27
ម៉ាស៊ីនត្រជាក់	Acondicionamiento de aire
កាំ	Radio (geometría)
អភិសិទ្ធិ វេជ្ជាជីវៈ	Abhisit Vejjajiva
HAL Tejas	HAL Tejas
លីមីត	Límite matemático
អ៊ីដ្រូស្តាទិច	Hidrostática
វិគីភីឌាភាសាជប៉ុន	Wikipedia en japonés
គោលនយោបាយរូបិយវត្ថុ	Política monetaria
យានដឹកជញ្ជូនសាធារណៈ	Transporte público
ការសំភាសន៏	Entrevista periodística
ពាណិជ្ជកម្មអន្តរជាតិ	Comercio internacional
ចក្រភពអាណានិគមបារាំង	Imperio colonial francés
ពន្ធលើប្រាក់ចំណូល	Impuesto sobre la renta
HTML tag	Etiqueta (lenguaje de marcado)
រូបចំលាក់	Estatua
នាឡិកាខ្សាច់	Reloj de arena
ពុយមីស	Pumita
FM	Frecuencia modulada
សង្គមស៊ីវិល	Sociedad civil (ciencia política)
សមុទ្របូហៃ	Mar de Bohai
ការិយាល័យ	Oficina
ការបង្រៀនដែនដីបរិសុទ្ធ	Aprendizaje electrónico
ម៉ែត្រក្នុងមួយវិនាទី	Metro por segundo
រូបមន្តហេរុង	Fórmula de Herón
ទន្សោង	Bos javanicus
វីតាមីន B	Vitaminas del grupo B
គណៈកម្មាធិការជាតិអូឡាំពិក	Comité olímpico nacional
ប៉មតូក្យូ	Torre de Tokio
ទិវាទឹកអន្តរជាតិ	Día Mundial del Agua
រូបមន្តអយល័រ	Fórmula de Euler
ស៊ីយ៉ាញួរ	Cianuro
អរិយដ្ឋង្គិកមគ្គ	Noble camino óctuple
សហភាពឥណ្ឌូចិន	Indochina francesa
ចន្ទគតិ	Calendario lunar
សំទុះមុំ	Aceleración angular
អាស៊ីហ្គេមឆ្នាំ១៩៧០	Juegos Asiáticos de 1970
កាលប្បវត្តិព្រះពុទ្ធសាសនា	Anexo:Cronología del budismo
គោលនយោបាយសារពើពន្ធ	Política fiscal
ឡាហ្គូន	Laguna
Mathew Brady	Mathew B. Brady
អប់សិន (ហិរញ្ញវត្ថុ)	Opción financiera
អង្កត់ធ្នូ	Cuerda (geometría)
អាយុសង្ឃឹម	Esperanza de vida
ខុទ្ទកាល័យ	Consejo de administración
សីដក់	Sepak takraw
ធនាគារអភិវឌ្ឍន៍អាស៊ី	Banco Asiático de Desarrollo
បញ្ជីរដ្ឋមានអាវុធនុយក្លេអ៊ែរ	Países con armas nucleares
ទីផ្សារអ៊ីធើណែត	Mercadotecnia en Internet
សៀវភៅ	El libro de la selva
បារីអេឡិចត្រូនិច	Cigarrillo electrónico
Eagles (ក្រុមភ្លេង)	Eagles
កំណើនសេដ្ឋកិច្ច	Crecimiento económico
យន្តសាស្រ្តរថយន្ត	Industria automotriz
អាឌាម លេមបឺត	Adam Lambert
រូបមន្តដឺម័រ	Fórmula de De Moivre
អនុគមន៍ហ្គាំម៉ា	Función gamma
ផ្សារធំថ្មី	Mercado central de Nom Pen
ច្បាប់ប៉ាស្កាល់	Principio de Pascal
សញ្ញាជាតិបង់ក្លាដែស្ស	Emblema nacional de Bangladés
នាង​សីតា	Sita
សូរ (​ភាសាសាស្ត្រ​)	Lengua tonal
ខ្មែរក្រហម	Jemeres rojos
ម៉ូឌុល​យ៉ាំង	Módulo elástico
យុន ជីមិ-ហូ	Yun Chi-ho
កែវម៉ាស៊ីនថត	Objetivo (fotografía)
ទីភ្នាក់ងារសារព័ត៌មាន	Agencia de información
វិគីភីឌាភាសាស្លូវ៉ាគី	Wikipedia en eslovaco
ថេរហ្វារ៉ាដេយ	Constante de Faraday
និមិត្តសញ្ញាគីមី	Anexo:Elementos químicos por símbolo
ប្រវត្តិអ៊ីនធើណេត	Historia de Internet
សមភាពគួរកត់សំគាល់	Binomio
ខូប្រា	Copra
ទ្រឹស្តីបទមេនេឡូស	Teorema de Menelao
ការធ្វើពាណិជ្ជកម្ម	Publicidad interactiva
អត្ថបទ(ប្រើបា្រស់ភាសា)	Contexto lingüístico
ជូគ័រលាង	Zhuge Liang
បំលែងឡាប្លាស	Transformada de Laplace
សញ្ញាជាតិតួរគី	Escudo de Turquía
បឹងទន្លេសាប	Tonlé Sap
Dassault Mirage 2000	Dassault Mirage 2000
ចំនួនអវិជ្ជមាន	Número negativo
សញ្ញាជាតិវៀតណាម	Emblema nacional de Vietnam
ខ្មែរ (ជនជាតិ)	Pueblo jemer
សញ្ញាជាតិកូរ៉េខាងត្បូង	Emblema nacional de Corea del Sur
សញ្ញាជាតិឡាវ	Emblema nacional de Laos
សញ្ញាជាតិប៉ាគីស្ថាន	Emblema nacional de Pakistán
Tigranes the Great	Tigranes II el Grande
អាណាចក្រខ្មែរ	Imperio jemer
សម្ដេចព្រះមហាឃោសនន្ន	Prea Mojá Ghosananda
ត្រីពណ៌	Tricolor
សញ្ញាជាតិប៊្រុយណេ	Emblema nacional de Brunéi
រង្វង់ត្រីកោណមាត្រ	Circunferencia goniométrica
ចំរៀករង្វង់	Sector circular
អនុគមន៍ដឺក្រេទី៣	Ecuación de tercer grado
អនុគមន៍អ៊ីពែបូលីក	Función hiperbólica
ឆាវ ឆាវ	Cao Cao
Sukhoi Su-30	Sukhoi Su-30
កម្មវិធីស្បៀងអាហារពិភពលោក	Programa Mundial de Alimentos
រៀល	Riel camboyano
សមុទ្រស្ទើរបិទ	Mar marginal
ច្រកសិង្ហបុរី	Estrecho de Singapur
វិគីភីឌាភាសារុស្ស៊ី	Wikipedia en ruso
សញ្ញាជាតិអូម៉ង់	Emblema nacional de Omán
ភាសាកម្មវិធី Lua	Lua
សញ្ញាជាតិប៊ូតាន	Emblema nacional de Bután
ភ្លេងជាតិថៃ	Phleng Chat
ព្រះរតនត្រ័យ	Tres Joyas
អាហារនៅប្រទេសម៉ិចស៊ិក	Gastronomía de México
ច្រកឡាប៉េរូស	Estrecho de La Pérouse
ខ្នាតកំលាយនៅក្នុងប្រព័ន្ធខ្នាតអន្តរជាតិ	Unidades derivadas del Sistema Internacional
ផ្សារហិរញ្ញវត្ថុ	Mercado financiero
ញ៉ែ	Coqueteo
ព្រះឆាយាល័ក្ខកម្ពុជា	Escudo de Camboya
ទិវាអង្គការសហប្រជាជាតិ	Día de las Naciones Unidas
ខ្សែទឹកអាត្លង់ទិកខាងជើង	Corriente del Atlántico Norte
ប្រវត្តិសាស្ត្រវៀតណាម	Historia de Vietnam
ខ្សែទឹកខាណារី	Corriente de las Islas Canarias
ទ្រឹស្តីបទឆិវ៉ា	Teorema de Ceva
LinkedIn	LinkedIn
ព្រះត្រៃបិដក	Canon Pali
បុណ្យវិសាខបូជា	Vesak
ទីក្រុងព្រែកឫស្សី	Cần Thơ
ជនជាតិចាម	Champa
រីស្ស៉ាត កាពុសស៊ីនស្គី	Ryszard Kapuściński
ប្រវត្តិសាស្ត្រភូមា	Historia de Birmania
ស៊ាន ឃីងស្តន	Sean Kingston
កងទ័ពជើងទឹកបារាំង	Marina nacional de Francia
ចំប៉ី	Plumeria
ពហុកីឡាដ្ឋានសុផាចាឡាសៃ	Estadio Suphachalasai
អនុគមន៍បេសែ្សល	Función de Bessel
លោក អាប់ឌូ ឌីអោហ្វ	Abdou Diouf
វិធីហ្វៃណៃថ៍អ៊េលម៉ិន	Método de los elementos finitos
ច្បាប់អគ្គីសនីវិភាគរបស់ហ្វារ៉ាដេយ	Ley de Faraday de la electrólisis
ខេត្តព្រះសីហនុ	Ciudad de Sihanoukville
មានប្រ	Anggun
ប្រហុក	Prahok
និកាយនៃព្រះពុទ្ធសាសនា	Escuelas budistas
ដុនបូស្កូសាឡេស៊ាន្ត	Pía Sociedad de San Francisco de Sales
ខ្នាតគោលនៅក្នុងប្រព័ន្ធខ្នាតអន្តរជាតិ	Unidades básicas del Sistema Internacional
អង្គរធំ	Angkor Thom
Kara	Kara
ប្រទេសនៅអឺរ៉ុប	Anexo:División política de Europa
វិទ្យុសម្លេងសហរដ្ឋអាមេរិក	Voz de América
ជេឃ្វីរី	JQuery
ទិវាពិភពលោកគ្មានថ្នាំជក់	Día Mundial Sin Tabaco
គម្ពីរបញ្ចតន្ត្រ	Panchatantra
មេដ្យាន	Mediana (geometría)
ផ្លាយ អាស់	Cenizas volantes
T-80	T-80
សញ្ញាជាតិកាតារ	Emblema nacional de Catar
សញ្ញាយ៉ាកូប៊ី	Símbolo de Jacobi
ភាសាចាម	Idioma cham
សត្វព្រៃ	Vida silvestre
មីហ៊្គោ	MeeGo
វិភាគចិត្តវិទ្យា	Psicología analítica
លីវ ប៉ី	Liu Bei
ម៉ាត្សឹស៊ីតា ខូណុស្កិ	Konosuke Matsushita
សង្គ្រាមគ្រីមៀ	Guerra de Crimea
ក្ងោកបៃតង	Pavo muticus
នាវាចរណ៏	Navegante
Pinterest	Pinterest
អាស៊ីហ្គេមឆ្នាំ១៩៦២	Juegos Asiáticos de 1962
អៀង ធីរិទ្ធ	Ieng Thirith
ភ្នំសេមេរូ	Semeru
កោះសមុយ	Ko Samui
ថវិការដ្ឋាភិបាល	Presupuesto público
អាំងតេក្រាលដោយផ្នែក	Métodos de integración
ផ្សោតក្បាលត្រឡោក	Orcaella brevirostris
Near Field Communication	Near field communication
ខៀវ ពណ្ណារី	Khieu Ponnary
ហិរញ្ញវត្ថុសាធារណៈ	Finanzas públicas
សាលាសំណាក់	Pabellón (arquitectura)
ជយវម៌្មទី១	Jayavarman I
ខ្សែទឹកកាលីហ្វរនៀ	Corriente de California
រូបមន្តអយល័រ-ម៉ាក្លូរីន	Fórmula de Euler-Maclaurin
AIDC F-CK-1 Ching-kuo	AIDC F-CK-1 Ching-kuo
OSM	OSM
ខេត្តសាឡៈវ៉ាន់	Provincia de Salavan
WikiHow	WikiHow
ទិន្នន័យបើកចំហ	Datos abiertos
ទិន ហ្វី	Stephen Chow
ហាំង ង៉ោ	Haing S. Ngor
ព្រះបាទសូរ្យវរ្ម័នទី២	Suryavarman II
ហ្គោស ចុកតុង	Goh Chok Tong
ហិនរី វីលសុន	Henry Wilson
ហុងដា សូអ៊ិជិរ៉ូ	Sōichirō Honda
ស៊ុន ឈាន	Sun Quan (emperador Da de Wu)
ឆាវ ភី	Cao Pi
ម៉ាស៊ីនថតវីឌីអូ	Cámara de vídeo
សមុទ្រកូរ៉ូ	Mar de Koro
ពិម្ពិសារ	Bimbisara
ដូមីនិក សាវីយ៉ូ	Domingo Savio
ក្រុមបាល់ទាត់ជម្រើសជាតិកម្ពុជា	Selección de fútbol de Camboya
Seo Jae-pil	Seo Jae-pil
ព្រះសារីបុត្រ	Shariputra
ទ្រឹស្តីបទគ្រីន	Teorema de Green
ប្រាសាទអូសាកា	Castillo de Osaka
ការប្រើប្រាស់ភាសា	Lingüística aplicada
គោព្រៃ	Bos sauveli
VCD	Video CD
កម្ពុជាប្រជាធិបតេយ្យ	Kampuchea Democrática
សាលាក្ដីខ្មែរក្រហម	Tribunal de Camboya
ណាសសែរ អាល់ មូហាមមេដ អាល់ អាហ៍មេដ អាល់ អាបាហ៍	Naser Al-Mohamed Al-Ahmed Al-Sabah
ស៊ុនធិ បុណ្យ រ័តក្លិន	Sonthi Boonyaratglin
ខេត្តផុងសាលី	Provincia de Phongsali
ខេត្តបកែវ	Provincia de Bokeo
ខេត្តចំប៉ាសក្តិ	Provincia de Champasak
កិលេស	Pasión (emoción)
ព្រះបាទជ័យវរ្ម័នទី៧	Jayavarman VII
កស្សបៈ	Mahakashyapa
កាំង ហ្កិច អ៊ាវ	Kaing Guek Eav
វិសមភាពរវាងមធ្យម	Desigualdad
ស៊ឺ ម៉ាអ៉ី	Sima Yi
ចំនុចហ្គែរហ្គោន	Circunferencia inscrita
ប្រវត្តិសាស្រ្តនៃរូបថត	Historia de la fotografía
ឋានន្តរសក្ដិរាជវង្សនិងអភិជន	Título nobiliario
សឺង ង៉ុកថាញ់	Sơn Ngọc Thành
ក្រុមហ៊ុនអាកាសចរណ៍ជាតិ កម្ពុជាអង្គរអ៊ែរ	Cambodia Angkor Air
វិសមភាពនេស្ប៉ីត	Desigualdad de Nesbitt
ទ្រឹស្តីបទមេអំបៅ	Teorema de la mariposa
កន្ថឹក	Tupaia belangeri
ហេង សំរិន	Heng Samrin
ខៀវ សំផន	Khieu Samphan
ជេកខប រីស	Jacob Riis
នួន ជា	Nuon Chea
អៀង សារី	Ieng Sary
ជយវម៌្មទី៣	Jayavarman II
អជាតសត្តុ	Áyata Shatru
បន្ទាត់អយល័រ	Recta de Euler
ប្រវត្តិសាស្ត្រថៃ	Historia de Tailandia
បុណ្យសែនព្រះខែ	Fiesta del Medio Otoño
ប្រេម ទីនសូឡានុន្ទ	Prem Tinsulanonda
គុណកិរិយា	Adverbio
ឌីណាមិក HTML	HTML dinámico
នូហាក់ ភូមសៈវ៉ាន់	Nouhak Phoumsavanh
កុំផ្លិចឆ្លាស់	Conjugado (matemática)
ការកើនឡើងនៃចំនួនប្រជាជននៅលើពិភពលោក	Crecimiento poblacional
ហង់រី មូហូ	Henri Mouhot
ប្រវត្តិសាស្ត្រលាវ	Historia de Laos
ព្រះបរមរាជវាំង	Palacio Real de Nom Pen
តារាងអាំងតេក្រាល	Anexo:Integrales
ព្រាប សុវត្ថិ	Preap Sovath
បន្ទាត់សេកង់	Recta secante
ពហុកោណស្មើ	Polígono equilátero
ប្រាសាទតាកែវ	Ta Keo
សម្ដេចប៉ាបហ្វ្រង់សូ័រ	Francisco (papa)
ព្រះពុទ្ធ​២៨​ព្រះអង្គ	Anexo:Los 28 Budas
ទ្រឹស្តីបទតូលេមី	Teorema de Ptolomeo
Regional Internet registry	Registro Regional de Internet
ខ្វែងជ័យបុរី	Provincia de Sainyabuli
ខ្វែងជើងខ្វែង	Provincia de Xiangkhoang
ខេត្តឧត្តមជ័យ	Provincia de Oudomxay
ខេត្តកោះកុង	Provincia de Koh Kong
ខេត្តកណ្ដាល	Provincia de Kandal
ម៉ារី ដូមីនិក ម៉ាសារីលូ	María Mazzarello
ព្រះនាងយសោធរា	Yasodharā
អនុគមន៍បែតា	Función beta
ទ្រឹស្តីបទតង់សង់	Teorema de la tangente
លិង្គ	Lingam
ឌិត ប្រន	Dith Pran
មធ្យមនព្វន្ធ-ធរណីមាត្រ	Media aritmético-geométrica
កូម៌ៈ	Kurmá
អាស៊ីហ្គេមឆ្នាំ១៩៧៤	Juegos Asiáticos de 1974
អាកាសយានដ្ឋានអន្តរជាតិតានសូនណាត្ត	Aeropuerto Internacional de Tan Son Nhat
KAI T-50 Golden Eagle	KAI T-50 Golden Eagle
ឧបទ្វីបកូរ៉េ	Península de Corea
វីគីប្រជុំ	Wikimanía
អាស៊ីហ្គេម	Juegos Asiáticos
ទង់ជាតិសិង្ហបុរី	Bandera de Singapur
បង្អួចឆ្នាំ 2000	Windows 2000
តារាងអាំងតេក្រាលនៃអនុគមន៍សនិទាន	Anexo:Integrales de funciones racionales
តារាងអាំងតេក្រាលនៃអនុគមន៍អ៊ីពែបូលីក	Anexo:Integrales de funciones hiperbólicas
សមីការដឺក្រេទី១	Ecuación de primer grado
តារាងអាំងតេក្រាលនៃអនុគមន៍ច្រាស់អ៊ីពែបូលីក	Anexo:Integrales de funciones inversas hiperbólicas
សញ្ញាជាតិអាហ្វហ្គានីស្ថាន	Emblema nacional de Afganistán
E-commerce	Comercio electrónico
Sukhoi Superjet 100	Sukhoi Superjet 100
ច្រកខាន់ម៉ុង	Estrecho de Kanmon
អាស៊ីហ្គេមឆ្នាំ២០០២	Juegos Asiáticos de 2002
ឆកសមុទ្រលាវតុង	Bahía de Liaodong
ឆកសមុទ្របូហៃ	Bahía de Bohai
T-ARA	T-ara
អាស៊ីហ្គេមឆ្នាំ១៩៨៦	Juegos Asiáticos de 1986
អាណាស្រុកម៉ូបាល (អាល់ឡាបាម៉ា)	Condado de Mobile
ម្កាក់	Spondias dulcis
បារខែម	BarCamp
ដើមត្នោត	Borassus flabellifer
ខេត្តកំពង់ធំ	Provincia de Kompung Thom
ខេត្តព្រះវិហារ	Provincia de Preah Wijía
ខេត្ត ហួ ផាន់	Provincia de Houaphan
ខ្វែងអាចម៍ក្រពើ	Provincia de Attapeu
ខេត្តខាំមួន	Provincia de Khammouan
ខេត្តប៉ៃលិន	Ciudad de Pailín
ឆាយាលក្សសារព័ត៌មាន	Periodismo fotográfico
ឧទ្យានជាតិភ្នំគូលែន	Parque nacional Phnom Kulen
បារីសង់	Centroide
វិសមភាពប៊ូល	Desigualdad de Boole
ស៊ីសុវត្ថិ មុនីវង្ស	Sisowath Monivong
អង្គឌួង	Ang Duong
ក្រុមបាល់ទាត់ជម្រើសជាតិ កូរ៉េខាងត្បូង	Selección de fútbol de Corea del Sur
សុញ្ញតា	Shuniata
គោលនយោបាយសាធារណៈ	Políticas públicas
ឆកសមុទ្រចាការតា	Bahía de Yakarta
Xian MA60	Xian MA60
ប្រមា	Hystrix brachyura
ភូមិសាស្រ្ដនៃប្រទេសកម្ពុជា	Geografía de Camboya
នរោត្តម	Norodom
ម៉ាសែលលីន ចាមប៉ាញេត	Marcelino Champagnat
អេដូអារដូ អាម៉ាល់ឌី	Edoardo Amaldi
Chengdu J-20	Chengdu J-20
ស៊ីឡាត	Pencak Silat
តារាងអាំងតេក្រាលនៃអនុគមន៍អិចស្ប៉ូណង់ស្យែល	Anexo:Integrales de funciones exponenciales
តារាងអាំងតេក្រាលនៃអនុគមន៍អសនិទាន	Anexo:Integrales de funciones irracionales
អាំងតេក្រាលហ្វ្រេនែល	Integral de Fresnel
គោលនយោបាយសេដ្ឋកិច្ច	Política económica
ប្រាសាទភិមានអាកាស	Phimeanakas
Baskin​-Robbins បាន	Baskin Robbins
ទិវាសេរីភាពសារព័ត៌មានពិភពលោក	Día Mundial de la Libertad de Prensa
ប្រាសាទតាព្រហ្ម	Ta Prohm
អាជ្ញាធរអន្តរកាលសហប្រជាជាតិនៅកម្ពុជា	Autoridad Provisional de las Naciones Unidas en Camboya
អាំងតេក្រាលផ្ទៃ	Integral de superficie
ប្រាសាទបន្ទាយក្តី	Banteay Kdei
ប្រាសាទបន្ទាយសំរែ	Banteay Samré
រួបថតនៅក្នុងសង្គ្រាម	Fotografía de guerra
មជ្ឈិមនិកាយ	Majjhima Nikaya
ស្រះស្រង់	Srah Srang
ខេត្តតាកែវ	Provincia de Takéo
ខេត្តហ៊ីរ៉ូស៊ីម៉ា	Prefectura de Hiroshima
ព្រះសហគមន៏កាតូលិកភូមិភាគភ្នំពេញ	Vicariato apostólico de Phnom Penh
បន្ទប់រៀន	Aula
សេដ្ឋកិច្ចកម្ពុជា	Economía de Camboya
ជំរំជនភៀសខ្លួន	Campo de refugiados
ហ្គូតហ្គោល	Google Sites
ខេត្តឧត្ដរមានជ័យ	Provincia de Oddar Mean Chey
ប្រភេទស្រាទំពាំងបាយជូរពីប្រទេសបារាំង	Vino de Francia
អុក	Ajedrez tailandés
នគររាជសីមា	Khorat
ចំនួនអាកស៊ីម៉ែដ	Número de Arquímedes
សង្គ្រាមកម្ពុជា-វៀតណាម	Guerra camboyano-vietnamita
តំលៃលើការចាប់អារម្មណ៍	Costo por mil
បញ្ជីរាយនាម ជ័យលាភីរង្វាន់ណូបែលសន្តិភាព	Anexo:Ganadores del Premio Nobel de la Paz
ទ្រឹស្តីបទពីក	Teorema de Pick
ខេត្តសៀមរាប	Provincia de Siem Riep
ខេត្តមណ្ឌលគិរី	Provincia de Mondol Kirí
ខេត្តកំពង់ស្ពឺ	Provincia de Kompung Speu
ប្រាសាទបាយ័ន	Bayón
អុនសេន	Onsen
ឧត្តមស្នងការអង្គការសហប្រជាជាតិទទួលបន្ទុកសិទ្ធិមនុស្ស	Oficina del Alto Comisionado de las Naciones Unidas para los Derechos Humanos
សម រង្ស៊ី	Sam Rainsy
ត្រីតុកកែជ្រូក	Chromileptes altivelis
ជាតក	Jataka
ក្រុងហាកុណិ (ខេត្តកាណាហ្គាវ៉ា)	Hakone (Kanagawa)
ប្រវត្តិសាស្ត្រខ្មែរ	Historia de Camboya
ម៉ាជូ ពីជូ	Machu Picchu
គណនីធនាគារ	Cuenta bancaria
ខ្សែទឹកប្រេស៊ីល	Corriente del Brasil
ក្រុមអសនិក (អាកាសចរណ៍)	Escuadrilla
Pilatus PC-7	Pilatus PC-7
ត្រកៀតប៉ោង	Eichhornia crassipes
ជ្រោយណុតុ	Península de Noto
ចតុកោណចារឹកក្នុងរង្វង់	Cuadrilátero cíclico
គីឡូម៉ែត្រការ៉េ	Kilómetro cuadrado
ចេននី រីវឺរ៉ា	Jenni Rivera
ពហុកោណនិយ័ត	Polígono regular
ប្រទេសនៅអាស៊ី	Anexo:División política de Asia
ឆកសមុទ្រឡៃចូ	Bahía de Laizhou
ប្រទេសមួយ ប្រព័ន្ធពីរ	Un país, dos sistemas
ត្រកៀត	Pontederiaceae
អាស៊ីហ្គេមឆ្នាំ១៩៥៤	Juegos Asiáticos de 1954
អាស៊ីហ្គេមឆ្នាំ១៩៥៨	Juegos Asiáticos de 1958
អាស៊ីហ្គេមឆ្នាំ១៩៦៦	Juegos Asiáticos de 1966
អាស៊ីហ្គេមឆ្នាំ១៩៧៨	Juegos Asiáticos de 1978
អាស៊ីហ្គេមឆ្នាំ១៩៨២	Juegos Asiáticos de 1982
អាស៊ីហ្គេមឆ្នាំ១៩៩០	Juegos Asiáticos de 1990
អាស៊ីហ្គេមឆ្នាំ១៩៩៤	Juegos Asiáticos de 1994
អាស៊ីហ្គេមឆ្នាំ១៩៩៨	Juegos Asiáticos de 1998
Hongdu JL-8	Hongdu JL-8
ច្រកចូហរ	Estrecho de Johor
នគរលូ	Estado de Lu
ត្រីរាជ	Pangasianodon gigas
ទ្រឹស្តីបទស្តេអាត	Teorema de Stewart
Yeghishe Charents	Yeghishe Charents
Hongdu L-15	Hongdu L-15 Falcon
ភាពលំអៀង	Sesgo
CAC/PAC JF-17 Thunder	Chengdu/PAC JF-17 Thunder
ខេត្តរតនគិរី	Provincia de Ratanak Kirí
បញ្ចក្ខន្ធ	Cinco agregados
Gloomy Sunday	Gloomy Sunday
ខេត្តហ្លួងព្រះបាង	Provincia de Luang Prabang
ខេត្តកំពត	Provincia de Kompot
សង្គ្រាមឥណ្ឌូចិនលើកទី១	Guerra de Indochina
ខេត្តស្វាយរៀង	Provincia de Svay Rieng
សង្គាយនា	Concilios budistas
ISO 9362	ISO 9362
ប៉ាកាយ៉ា	Volcán de Pacaya
ខ្លែងប្រម៉ង់	Microhierax caerulescens
ទិវាអក្ខរកម្មអន្តរជាតិ	Día Internacional de la Alfabetización
ទ្រឹស្ដីបទការ៉េទាំង៤របស់ឡាហ្គ្រង់	Teorema de los cuatro cuadrados
សុត្តន្តបិដក	Sutta-pitaka
ខេត្តអូគីណាវ៉ា	Prefectura de Okinawa
លានជល់ដំរី	Terraza de los Elefantes
គណបក្សប្រជាជនកម្ពុជា	Partido Popular de Camboya
អាស៊ីខាងត្បូង	Asia del Sur
កំណាត់រង្វង់	Segmento circular
ខេត្តក្រចេះ	Provincia de Kratié
ប្រាសាទបាគង	Bakong
ប្រាសាទបន្ទាយស្រី	Banteay Srei
សមីការឌីផេរ៉ង់ស្យែលប៊ែរនូយី	Ecuación diferencial de Bernoulli
ខេត្តបាត់ដំបង	Battambang (provincia)
សង្គ្រាមផ្ទៃក្នុងកម្ពុជា	Guerra civil camboyana
ESET	ESET
អាស៊ីហ្គេមរដូវរងារ	Juegos Asiáticos de Invierno
កុសិនារា	Kushinagar
KM	Kilómetro
បញ្ជីព្រះមហាក្សត្រកម្ពុជា	Anexo:Reyes de Camboya
ផ្លូវកណ្ដាល	Camino medio
ជម្រើសអ្នកប្រើប្រាស់	Teoría del consumidor
ខេត្តពោធិ៍សាត់	Provincia de Pursat
វិស័យអប់រំនៅប្រទេសជប៉ុន	Sistema educativo de Japón
ខេត្តស្ទឹងត្រែង	Provincia de Stung Treng
ប្រព័ន្ធគោល	Base (aritmética)
ក្រុមប្រឹក្សាអូឡាំពិកអាស៊ី	Consejo Olímpico de Asia
McDonnell Douglas F-15E Strike Eagle	McDonnell Douglas F-15E Strike Eagle
តារាងអាំងតេក្រាលនៃអនុគមន៍ត្រីកោណមាត្រ	Anexo:Integrales de funciones trigonométricas
ច្រកកាលីម៉ាតា	Estrecho de Karimata
បញ្ជី ប្រទេស មានចំនួនអ្នកអានសៀវភៅ	Anexo:Países por tasa de alfabetización
សារមន្ទីរទួលស្លែង	Tuol Sleng
ខេត្តកែប	Ciudad de Kep
ទ្រឹស្តីបទវីវីអានី	Teorema de Viviani
បញ្ជីអ្នកទទួលបានជ័យលាភីណូបែលខាងរូបវិទ្យា	Anexo:Ganadores del Premio Nobel de Física
VietJet Air	VietJet Air
ក្រុងសិរីសោភ័ណ	Ciudad de Sisophon
ក្រុងកំពង់ចាម	Ciudad de Kompung Cham
សាកលវិទ្យាល័យ ចុឡាលុងករណ៍	Universidad de Chulalongkorn
Gallery of dependent territory flags	Anexo:Banderas de territorios dependientes
អនុគមន៍ស៊ីនុសកាឌីណាល់	Función sinc
ខេត្តព្រៃវែង	Provincia de Prey Veng
បញ្ជីរាយនាម សេដ្ឋវិទូ	Anexo:Economistas
អនុគមន៍ពហុហ្គាំម៉ា	Función poligamma
ទ្រឹស្តីបទកូស៊ី-អាដាម៉ា	Teorema de Cauchy-Hadamard
កប្ប	Kalpa
ខ្សែទឹកអេក្វាទ័រខាងជើង	Corriente Ecuatorial del Norte
សាធារណរដ្ឋប្រជាមានិតកម្ពុជា	República Popular de Kampuchea
នគរវ្នំ	Reino de Funán
ខេត្តកំពង់ឆ្នាំង	Provincia de Kompung Chinang
ទ្រឹស្តីបទមេដ្យាន	Teorema de Apolonio
ISO 3166-3	ISO 3166-3
ស៊ីសុវត្ថិ	Sisowath
ពោធិបក្ខិយធម៌	Bodhipakkhiya dhamma
ព្រហ្មវិហារធម៌	Brahmavihara
បាល់ទាត់កញ្ចុំផ្កាយ	Galactik Football
ការ​បញ្ចាំង​ស្លាយ	Diaporama
វីគីភីឌាភាសាខ្មែរ	Compuestos orgánicos volátiles
ប្រទេសនៅអាមេរិកខាងត្បូង	Anexo:Países de América del Sur
ចំប៉ីសៀម	Adenium
ជំនួយ:មាតិកា	Ayuda:Contenidos
ច្បាប់ប្រលេឡូក្រាម	Ley del paralelogramo
ទ្រឹស្តីបទកន្លះបន្ទាត់ពុះមុំ	Teorema de la bisectriz
AgustaWestland Apache	Westland WAH-64 Apache
សាលាប្រព័ន្ធសាលារដ្ឋស្រុកម៉ូបាល	Sistema de Escuelas Públicas del Condado de Mobile
មីក្រូម៉ែត្រការ៉េ	Anexo:Órdenes de magnitud (superficie)
ធនធានដែលមិនកកើតឡើងវិញ	Recurso no renovable
ខ្សែទឹកអៀមីងហ្គើរ	Corriente de Irminger
ជួរភ្នំដងរែក	Montes Dangrek
ប៉ាណរវដ្ឋ កិតតិករចម្រើន	Panrawat Kittikorncharoen
វិសមភាព ហាតឌី	Desigualdad de Hardy
រូបមន្តញូតុន-កូត្ស	Fórmulas de Newton–Cotes
ទីភ្នាក់ងារសហប្រតិបត្តិការអន្តរជាតិជប៉ុន	Agencia Japonesa de Cooperación Internacional
ស្វាកន្ទុយស	Pygathrix nigripes
Nanchang Q-5	Nanchang Q-5
ប្រដាល់សេរី	Prodal
សុន សេន	Son Sen
គណកម្មាធិការអូឡាំពិកជប៉ុន	Comité Olímpico Japonés
ចំនួនតេត្រាអែក	Número tetraédrico
ក្រុងកំពង់ធំ	Ciudad de Kompung Thom
ចំណុចរំពុះ	Punto de ebullición
Coats of arms of dependent territories	Anexo:Escudos de territorios dependientes
ក្រុងប៉ោយប៉ែត	Poipet
របាំព្រះរាជទ្រព្យ	Danza clásica jemer
ក្រុងកំពង់ឆ្នាំង	Ciudad de Kompung Chinang
តារាងអាំងតេក្រាលនៃអនុគមន៍ច្រាស់ត្រីកោណមាត្រ	Anexo:Integrales de funciones inversas trigonométricas
ត្រៃលក្ខណ៍	Tri-Laksana
អាកាសយានដ្ឋានអន្តរជាតិភ្នំពេញ	Aeropuerto Internacional de Nom Pen
ព្រះនិព្វាន៤ថ្នាក់	Cuatro etapas del nirvāna
សាធារណរដ្ឋខ្មែរ	República Jemer
អាកាសយានដ្ឋានអន្តរជាតិសៀមរាបអង្គរ	Aeropuerto Internacional de Angkor
បច្ចេកវិទ្យាសារពត៌មាន	Periodismo en línea
ក្មេងទំនើង	Delincuencia juvenil
តថាគត	Tathāgata
នគរឆឹន	Estado de Chen
ប្រព័ន្ធផ្សព្វផ្សាយសុក្រិត្យ	Social Media Optimization
កម្មវីធីសូនីវីហ្គាស	Sony Vegas Pro
ខ្សែទឹកអេក្វាទ័រខាងត្បូង	Corriente Ecuatorial del Sur
សិក្ខាបទ៥	Los cinco preceptos
ការប្រកួតកីឡាជើងឯកចុងបូព៌ា	Juegos del Lejano Oriente
កងទ័ពអេហ្ស៊ីប	Fuerzas Armadas de Egipto
តារាងដេរីវេ	Reglas de derivación
មេកានិច​សូលីដ	Mecánica de sólidos deformables
ការប្រកួតកីឡា កម្ពុជា	Liga C de Camboya
CAIC Z-10	CAIC WZ-10
អាំងតេក្រាលត្រីកោណមាត្រ	Integral senoidal
សមីការឌីផេរ៉ងស្យែលក្លែរ៉ូ	Ecuación diferencial de Clairaut
សាសនា សកល	Simbolismo religioso
ខ្សែទឹកណរវេយ	Corriente noruega
ទង់ព្រះពុទ្ធសាសនា	Bandera budista
មករ	Makara
សហរដ្ឋ	Unión política
អាស៊ីហ្គេមលើឆ្នេរខ្សាច់	Juegos Asiáticos de Playa
បណ្ឌិត្យ​សភា​នីតិ​អន្តរជាតិ​នៃ​ទីក្រុង​ឡាអេ	Academia de Derecho Internacional de La Haya
សម្រែកនៃដុលោរ៉េស៏	Grito de Dolores
ប្រពលវប្បកម្ម	Agricultura intensiva
សមភាពការ៉េទាំង៤របស់អឺលែរ	Identidad de los cuatro cuadrados de Euler
រូបមន្តប្រាម៉ាហ្គឹបតា	Fórmula de Brahmagupta
Shenyang J-11	Shenyang J-11
មុំក្នុង	Ángulo interior
ផលបូក រីម៉ាន	Suma de Riemann
ប្រាសាទអ៊ីវ៉ាឃឹនី	Castillo Iwakuni
មធ្យមហេរ៉ុង	Media heroniana
Kawasaki OH-1	Kawasaki OH-1
បុណ្យ តារា	Tanabata
ក្រុមមិត្តភក្តិ (Peer group)	Grupo de pares
ស្ពានឃីងតៃ	Puente Kintai
OSGeo	Open Source Geospatial Foundation
វិគីភីឌា:ស្ថានទូតខ្មែរ	Wikipedia:Embajadas
ទីឃនិកាយ	Dīgha Nikāya
អនុគមន៍ទ្រីហ្គាំម៉ា	Función trigamma
ខ្សែទឹករង្វល់របស់មហាសមុទ្រ	Giro oceánico
កូស៊ីនុសអ៊ីពែបូលីក	Coseno hiperbólico
កូស៊ីនុស	Coseno
វិទ្យុតាមអ៊ីនធើណែត	Radio Digital Terrestre
ខ្សែទឹកហ្គ្រីនលែនខាងលិច	Corriente de Groenlandia Occidental
តូនី វ៉ាការ៉ូ	Tony Vaccaro
កោះទន្សាយ	Koh Tonsay
តង់សង់អ៊ីពែបូលីក	Tangente hiperbólica
ស៊ីនុសអ៊ីពែបូលីក	Seno hiperbólico
ឈូងសមុទ្រ	Golfo
អនុគមន៍ហ្គុឌែរម៉ាន់	Función de Gudermann
មួយម៉ូនីកា	Agnes Mónica
Candies	Candies
សាកលវិទ្យាល័យហ្វឹគឹអ៊ី	Universidad de Fukui
ខ្មែរក្រោម	Baja Camboya
ទ្រឹស្តីបទកាសី	Teorema de Casey
ESET NOD32 Antivirus	ESET NOD32 Antivirus
វិគីភីឌា:Glossary	Ayuda:Glosario
នីវរណធម៌	Cinco obstáculos
ចំណាត់ថ្នាក់ក្រុម:ប្រទេសជប៉ុន	Categoría:Japón
ចំណាត់ថ្នាក់ក្រុម:ម៉ិកសិច	Categoría:México
ទ្រឹស្តីបទប្រាម៉ាហ្គឹបតា	Teorema de Brahmagupta
ចេមនិងផ្លែប៉ែសយក្ស	James and the Giant Peach
ស្ងោរជ្រក់សាច់មាន់	Caldo de pollo
ចំណាត់ថ្នាក់ក្រុម:ឥណ្ឌូនេស៊ី	Categoría:Indonesia
ចំណាត់ថ្នាក់ក្រុម:សិង្ហបុរី	Categoría:Singapur
ចំណាត់ថ្នាក់ក្រុម:រូបវិទ្យា	Categoría:Física
ចំណាត់ថ្នាក់ក្រុម:វិទ្យាសាស្រ្តធម្មជាតិ	Categoría:Ciencias naturales
ចំណាត់ថ្នាក់ក្រុម:ជីវវិទ្យា	Categoría:Biología
ចំណាត់ថ្នាក់ក្រុម:សាសនា	Categoría:Religión
ចំណាត់ថ្នាក់ក្រុម:កីឡា	Categoría:Deporte
ចំណាត់ថ្នាក់ក្រុម:វិទ្យាសាស្ត្រ	Categoría:Ciencia
ប្រជាមតិទាក់ទងនឹងឯករាជភាពរបស់ស្កុតឡែនឆ្នំា២០១៤	Referéndum para la independencia de Escocia de 2014
សំយុត្តនិកាយ	Samyutta Nikaya
សំយោជនៈ	Renacimiento (budismo)
សាសនាក្នុងប្រទេសចិន	Religión en la República Popular China
G8+5	G8+5
ចំនួនហ្គាលីលេ	Número de Galilei
ត្រីគល់រាំង	Catlocarpio siamensis
ប្រវត្តិសាស្រ្តរបស់ទូរទស្សន៍	Historia de la televisión
ប្រវត្តិវិទ្យុ	Historia de la radio
ប្រវត្តិសាស្រ្តអ្នកកាសែត	Historia del periodismo
ប្រវត្តិច្បាប់រក្សាសិទ្ធ	Historia de los derechos de autor
Honda HA-420 HondaJet	Honda HA-420 HondaJet
ទ្រឹស្ដីនៃពណ៌	Teoría del color
នពតល ប៉័ទមៈ	Noppadon Pattama
ស្ករត្នោត	Azúcar de palma
អង្គាបុស្ប	Millingtonia
Guizhou JL-9	Guizhou JL-9
កោះរុង	Koh Rong
ស្ដង់ដា	Estándar
ចំនុចកណ្ដាល	Punto medio
ខុទ្ទកនិកាយ	Khuddaka Nikaya
ប៉ាន់ រិទ្ធី	Rithy Panh
សាកលវិទ្យាល័យកម្ពុជា	Universidad de Camboya
សាកលវិទ្យាល័យភូមិន្ទភ្នំពេញ	Universidad real de Nom Pen
ទំព័រគំរូ:Dts	Plantilla:Dts
ទីក្រុងរ៉ូមបុរាណ	Antigua Roma
រឹសគូប	Raíz cúbica
នរោត្ដម សុរាម្រិត	Norodom Suramarit
Airbus A318	Airbus A318
ការវាយប្រហារដែនអាកាសនៅទីក្រុងបេកដាត ថ្ងៃទី ១២ កក្តដា ២០០៧	Ataque aéreo en Bagdad del 12 de julio de 2007
ទ្រឹស្តីបទរូទ	Teorema de Routh
ក្លឹបបាល់ទាត់ ភ្នំពេញក្រោន	Phnom Penh Crown
សញ្ញាណលោការីត	Identidades logarítmicas
វត្តភ្នំ	Wat Phnom
កោះត្រឡាច	Isla Côn Sơn
ក្រុមហ៊ុនអាកាសចរណ៏រ៉ូយ៉ាល់ខ្មែរអ៊ែរឡាញ	Royal Khmer Airlines
អាគីតា	Akita
ទ្រឹស្ដីបទវ៉ារីញ៉ុង	Teorema de Varignon
អនុគមន៍ហ្សេតាបឋម	Función zeta prima
ចំណាយរដ្ឋាភិបាល	Gasto público
សារមន្ទីរជាតិ	Museo nacional de Camboya
ឧទ្យានជាតិព្រះសុរាម្រិតកុសុមៈគិរីរម្យ	Parque nacional de Kirirom
អ្នកសារពត័មាន	Periodista
ចំណាត់ថ្នាក់ក្រុម:អូឡាំពិក	Categoría:Juegos Olímpicos
ចំណាត់ថ្នាក់ក្រុម:ព្រះពុទ្ធសាសនា	Categoría:Budismo
វប្បធម៍បារាំង	Cultura de Francia
បញ្ជីឈ្មោះអនុគមន៍គណិតវិទ្យា	Anexo:Funciones matemáticas
ប្រអប់ខ្សាច់	Sandbox
ស្ថានីយទូរទស្សន៍	Canal de televisión
ពហុកីឡដ្ឋានជាតិអូឡាំពិក	Estadio Olímpico de Nom Pen
កិច្ចតែងការ	Unidad didáctica
សាលាសាធារណៈឡូវែល	Escuelas Públicas de Lowell
ជំងឺរលាកបំពង់ក	Faringitis
កម្ពុជាសម័យលង្វែក	Lovek
អាកាសយានដ្ឋានអន្តរជាតិក្រុងព្រះសីហនុ	Aeropuerto Internacional de Sihanoukville
ឧទ្យានជាតិវីរៈជ័យ	Parque nacional Virachey
ទំព័រគំរូ:Lang-ta	Plantilla:Lang-ta
ស៊ុកូឡា	Historia del chocolate en España
អូរកែវ	Óc Eo
ពហុធាប៊ែរនូយី	Polinomios de Bernoulli
ព្រះធម្មចក្កប្បវត្តនសូត្រ	Dharmacakra Pravartana Sūtra
ខេត្តបលិខាំសៃ	Provincia de Bolikhamxai
ខណ្ឌរដ្ឋបាលសាលាភីឡាដេលផ្យា	Distrito escolar de Filadelfia
ស្ពានព្រះមុនីវង្ស	Puente Monivong
ភ្នំឧដុង្គ	Ciudad de Udong
ស្ថាបត្យករខ្មែរ	Arquitectura de Camboya
តារាងនៃស៊េរីគណិតវិទ្យា	Anexo:Series matemáticas
ចំងាយពីចំនុចមួយទៅបន្ទាត់	Distancia de un punto a una recta
ធម្មសង្គណី	Dhammasangani
ចំណូលរដ្ឋាភិបាល	Ingreso público
អភិញ្ញា៦	Abhijna
ព្រះរាជាណាចក្រកម្ពុជា (១៩៥៣-១៩៧០)	Reino de Camboya (1953-1970)
ដប់ប្រាំពីរមេសាជោគជ័យ	Dap Prampi Mesa Chokchey
បណ្តុំកន្សោមរ៉ាឌីកាល់	Radical jerarquizado
WNBT	WNBC
ប្រជាសាស្ត្រនៃកម្ពុជា	Demografía de Camboya
ភ្លេងបានដា	Bandas de viento de México
ណាយ៉ាន់ ចាន់ដា	Nayan Chanda
ទ្រឹស្តីបទអូស្រ្តូស្គី	Teorema de Ostrowski
ចំណាត់ថ្នាក់ក្រុម:ទ្វីប	Categoría:Continentes
ចំណាត់ថ្នាក់ក្រុម:ភូមិវិទ្យា	Categoría:Geología
ចំណាត់ថ្នាក់ក្រុម:យន្តហោះ	Categoría:Aeronaves
រស់ សេរីសុទ្ធា	Ros Serey Sothear
បឹងយក្សឡោម	Yak Loum
បសេនទិកោសល	Pasenadi
វ៉ិចទ័រប្រាប់ទិស	Vector director
ទំព័រគំរូ:ប្រព័ន្ធព្រះអាទិត្យ	Plantilla:Sistema Solar
វិគីភីឌា:សារ ទំព័រគំរូ/លំហឈ្មោះ ការពិភាក្សារបស់អ្នកប្រើប្រាស់	Wikipedia:Plantillas de aviso a usuario
សាលារៀនសាធារណៈស៊ីតថល	Escuelas Públicas de Seattle
បញ្ជីរាយនាមប្រទេសនៅអាស៊ីតាមចំនួនប្រជាជន	Anexo:Países de Asia por población
ដេរីវេនៃអនុគមន៍ត្រីកោណមាត្រ	Derivación de funciones trigonométricas
សេដ្ឋកិច្ចគ្រប់គ្រង	Economía gerencial
អនុរុទ្ធ	Anuruddha
ពីរ៉ាមីត	Pirámide (geometría)
ស្ពានគីហ្សូណា	Puente Kizuna
យ៉ូសែប ឆ្មារសាឡាស់	José Chhmá Salas
ស៊ីន ស៊ីសាមុត	Sinn Sisamouth
ពន្ធតែមប្រិ៍	Ley del sello
ជំនួយ:ការកត់ឈ្មោះចូល	Ayuda:Registro
កន្លះបរិមាត្រ	Semiperímetro
គ្រោះមហន្តរាយ	Desastre
វិគីភីឌា:Reference desk	Wikipedia:Consultas
ទំព័រគំរូ:Quote	Plantilla:Cita
ទំព័រគំរូ:Wikipedia languages	Plantilla:Portada:Idiomas
ទំព័រគំរូ:Location map Scotland	Plantilla:Mapa de localización de Escocia
ទំព័រគំរូ:Location map England	Plantilla:Mapa de localización de Inglaterra
ចំណាត់ថ្នាក់ក្រុម:សេដ្ឋកិច្ច	Categoría:Economía
វិគីភីឌា:សុំប្តូរអត្តនាម	Wikipedia:Cambiar el nombre de usuario
ចំណាត់ថ្នាក់ក្រុម:ជនជាតិ ភាគតិច ក្នុង ប្រទេស កម្ពុជា	Categoría:Etnias de Camboya
វិគីភីឌា:Oversight	Wikipedia:Supresores
វិគីភីឌា:IP block exemption	Wikipedia:Exento de bloqueo a IP
វិគីភីឌា:រូបយន្ត	Wikipedia:Bot
ចំណាត់ថ្នាក់ក្រុម:Hidden categories	Categoría:Wikipedia:Categorías ocultas
ទេវតា	Deva (budismo)
ទំព័រគំរូ:WP:UBS	Usuario:Userbox/Navegación
អេហ៊្សីប	Egipto
ជំនួយ:ទំព័រគំរូ	Ayuda:Plantillas
វិគីភីឌា:វិគីគម្រោង	Wikipedia:Wikiproyectos
ទំព័រគំរូ:Bot	Plantilla:Bot
វិគីភីឌា:អ្វីៗដែលវិគីភីឌាមិនអនុញ្ញាត	Wikipedia:Lo que Wikipedia no es
ឧទ្យានជាតិបុទុមសាគរ	Parque nacional de Botum Sakor
អាម៉ុក	Amok trey
កាណាដា	Canadá
ចំណាត់ថ្នាក់ក្រុម:ប្រទេសអាយឡែន	Categoría:Islandia
វិគីភីឌា:អំពីវិគីភីឌា	Wikipedia:Acerca de
ចំណាត់ថ្នាក់ក្រុម:ខ្នាតក្រលាផ្ទៃ	Categoría:Unidades de superficie
ជំនួយ:ពាក្យទិព្វ	Ayuda:Palabras mágicas
វិគីភីឌា:Database reports	Wikipedia:Informes automáticos
ទំព័រគំរូ:Flagicon	Plantilla:Bandera
ចំណាត់ថ្នាក់ក្រុម:អឺរ៉ុប	Categoría:Europa
ចំណាត់ថ្នាក់ក្រុម:ជំនួយក្នុងវិគីភីឌា	Categoría:Ayuda
វិគីភីឌា:ទំព័រអ្នកប្រើប្រាស់	Wikipedia:Página de usuario
វិគីភីឌា:ព្រឹត្តិការណ៍​ថ្មីៗ	Portal:Actualidad
ទំព័រគំរូ:Documentation	Plantilla:Documentación
វិគីភីឌា:អ្នកប្រើប្រាស់	Wikipedia:Tipos de usuarios
វិគីភីឌា:Protection policy	Wikipedia:Política de protección
វិគីភីឌា:WikiLove	Wikipedia:WikiAmor
វិគីភីឌា:Userboxes	Usuario:Userbox
វិគីភីឌា:ហត្ថលេខា	Wikipedia:Firma de usuario
វិគីភីឌា:អត្ថបទខ្លីមិនពេញលេញ	Wikipedia:Esbozo
វិគីភីឌា:លក្ខណៈវិនិច្ឆ័យនៃលុបជាបន្ទាន់	Wikipedia:Criterios para el borrado rápido
វិគីភីឌា:Most wanted articles	Wikipedia:Artículos solicitados
្ឞ្ញ ហ្សអិ-អិអៀ	Sung Jae-ki
វិគីភីឌា:Huggle	Wikipedia:Huggle
អ្នកយកការណ៍នៅទ្វីបអាស៊ី (Asian Correspondent)	Asiancorrespondent.com
ទំព័រគំរូ:Softredirect	Plantilla:Redirección suave
ទំព័រគំរូ:លុបជាបន្ទាន់	Plantilla:Destruir
ក្លោងទ្វារ:ចិន	Portal:China
វិគីភីឌា:វិគីគម្រោង ជីវប្រវត្តិ	Wikiproyecto:Biografías
ទំព័រគំរូ:Succession	Plantilla:Sucesión
ឫសទី១២នៃ២	Raíz duodécima de dos
សាវ័កព្រះពុទ្ធ	Savakabuda
កោះរុងសន្លឹម	Koh Rong Samlon
ឃុំភ្នំដី	Phnom Dei
ឧទ្យានជាតិកែប	Parque nacional de Kep
ឧទ្យានជាតិមុនីវង្យបូកគោ	Parque nacional de Preah Monivong
ទឹកជ្រោះប៊ូស្រា	Cascada Bou Sra
ឧទ្យានជាតិព្រះសីហនុរាម	Parque nacional de Ream
ប៉ែន រ៉ន	Pan Ron
Moon OS	MoonOS
ចំណាត់ថ្នាក់ក្រុម:ភាសា	Categoría:Lenguas
ចំណាត់ថ្នាក់ក្រុម:វេយ្យាករណ៍	Categoría:Gramática
ចំណាត់ថ្នាក់ក្រុម:វិគីភីឌា	Categoría:Wikipedia
វិគីភីឌា:ការបដិសេធ ទូទៅ	Wikipedia:Limitación general de responsabilidad
ជំនួយ:ចំណាត់ថ្នាក់ក្រុម	Ayuda:Categoría
វិគីភីឌា:អសង្ស័យកម្ម	Wikipedia:Manual de estilo
Portal:Contents/Portals	Portal:Portada
ទំព័រគំរូ:Navbox	Plantilla:Navegación
ជំនួយ:រូបមន្ត	Ayuda:Uso de TeX
ជំនួយ:តំណភ្ជាប់	Ayuda:Anclas
ទំព័រគំរូ:Citation needed	Plantilla:Cita requerida
តំបន់ពាណិជ្ជកម្មសេរី	Tratado de libre comercio
ទំព័រគំរូ:Error	Plantilla:Error
ទំព័រគំរូ:!	Plantilla:!
ចំណាត់ថ្នាក់ក្រុម:Flag templates	Categoría:Wikipedia:Plantillas de banderas
ទំព័រគំរូ:((	Plantilla:((
ទំព័រគំរូ:))	Plantilla:))
ទំព័រគំរូ:=	Plantilla:=
ទំព័រគំរូ:Navbar	Plantilla:Navbar
ទំព័រគំរូ:Loop	Plantilla:Loop
ទំព័រគំរូ:Key press	Plantilla:Tecla
ទំព័រគំរូ:Okina	Plantilla:Okina
ទំព័រគំរូ:Transclude	Plantilla:Transcluir
ទំព័រគំរូ:Sc	Plantilla:Versalita
ទំព័រគំរូ:Small	Plantilla:Small
ទំព័រគំរូ:Clear	Plantilla:Clear
ទំព័រគំរូ:Trim	Plantilla:Trim
ទំព័រគំរូ:Color	Plantilla:Color
ទំព័រគំរូ:Nowrap	Plantilla:Nowrap
ទំព័រគំរូ:Abbr	Plantilla:Abreviatura
វិគីភីឌា:វិគីគម្រោង ទំព័រគំរូ	Wikiproyecto:Plantillas
ចំណាត់ថ្នាក់ក្រុម:ខ្សែកោង	Categoría:Curvas
ទំព័រគំរូ:Babel	Plantilla:Babel
ទំព័រគំរូ:Commons	Plantilla:Commons
ទំព័រគំរូ:Link GA	Plantilla:Bueno
ទំព័រគំរូ:Reflist	Plantilla:Listaref
ទំព័រគំរូ:NavPeriodicTable	Plantilla:Ficha de elemento químico/minitabla periódica
វិគីភីឌា:Citing sources	Wikipedia:Verificabilidad (propuesta)
ទំព័រគំរូ:អត្ថបទខ្លីមិនពេញលេញ	Plantilla:Esbozo
ទំព័រគំរូ:See also	Plantilla:VT
ខណ្ឌសាលារៀនសាមគ្គីឡងប៊ិច	Distrito Escolar Unificado de Long Beach
ទំព័រគំរូ:Location map/Info	Plantilla:Mapa de localización/Info
ចំណាត់ថ្នាក់ក្រុម:Navigational boxes	Categoría:Wikipedia:Plantillas de navegación
ទំព័រគំរូ:ទិន្នន័យ នៃប្រទេសតាជីគីស្ថាន	Plantilla:Geodatos Tayikistán
ចំណាត់ថ្នាក់ក្រុម:អាស៊ី	Categoría:Asia
ចំណាត់ថ្នាក់ក្រុម:User uk-N	Categoría:Wikipedia:Wikipedistas con nivel nativo de ucraniano
ទំព័រគំរូ:Intricate template	Plantilla:Plantilla compleja
ទំព័រគំរូ:Lang-ja	Plantilla:Lang-ja
ទំព័រគំរូ:Football squad player	Plantilla:Jugador de fútbol
ទំព័រគំរូ:ទិន្នន័យប្រទេស គុយវ៉ែត	Plantilla:Geodatos Kuwait
ទំព័រគំរូ:Now Commons	Plantilla:EnCommons
ទំព័រគំរូ:គម្រោងវិគីជាបងប្អូន	Plantilla:Portada:Proyectos
ចំណាត់ថ្នាក់ក្រុម:External link templates	Categoría:Wikipedia:Plantillas de enlaces externos
ទំព័រគំរូ:ទិន្នន័យប្រទេស ស្លូវ៉ាគី	Plantilla:Geodatos Eslovaquia
ចំណាត់ថ្នាក់ក្រុម:ទំព័រគំរូសំរាប់កូអរដោនេ	Categoría:Wikipedia:Plantillas de coordenadas
ទំព័រគំរូ:Country flagnavy	Plantilla:Banderanavalpaís
ទំព័រគំរូ:USA	Plantilla:USA
ទំព័រគំរូ:ទិន្នន័យប្រទេស អេត្យូពី	Plantilla:Geodatos Etiopía
ទំព័រគំរូ:ទិន្នន័យប្រទេស ឆេក	Plantilla:Geodatos República Checa
ទំព័រគំរូ:ទិន្នន័យ នៃប្រទេសថៃ	Plantilla:Geodatos Tailandia
ទំព័រគំរូ:ទិន្នន័យប្រទេស គុយបា	Plantilla:Geodatos Cuba
ទំព័រគំរូ:ទិន្នន័យប្រទេស អាល់បានី	Plantilla:Geodatos Albania
ទំព័រគំរូ:ទិន្នន័យ នៃប្រទេសប៉េរូ	Plantilla:Geodatos Perú
ទំព័រគំរូ:ទិន្នន័យ នៃប្រទេសម៉ាកាវ	Plantilla:Geodatos Macao
ទំព័រគំរូ:User wikipedia	Usuario:Userbox/Usuario wikipedista
ទំព័រគំរូ:ទិន្នន័យប្រទេស សាធារណរដ្ឋចិន	Plantilla:Geodatos República de China
ទំព័រគំរូ:ទិន្នន័យ នៃប្រទេសអ៊ូបេគីស្ថាន	Plantilla:Geodatos Uzbekistán
ចំណាត់ថ្នាក់ក្រុម:User ms	Categoría:Wikipedia:Wikipedistas con conocimientos de malayo
ទំព័រគំរូ:Months	Plantilla:Mes
ទំព័រគំរូ:ទិន្នន័យ នៃប្រទេសឡាតវី	Plantilla:Geodatos Letonia
ទំព័រគំរូ:Football kit	Plantilla:Uniforme
ទំព័រគំរូ:ទិន្នន័យ នៃប្រទេសម៉ាល់តា	Plantilla:Geodatos Malta
ទំព័រគំរូ:ទិន្នន័យ នៃប្រទេសម៉ូណាកូ	Plantilla:Geodatos Mónaco
ទំព័រគំរូ:ទិន្នន័យ នៃប្រទេសដាណឺម៉ាក	Plantilla:Geodatos Dinamarca
ទំព័រគំរូ:Wikiatlas	Plantilla:Wikiatlas
ទំព័រគំរូ:ទិន្នន័យ នៃប្រទេសប៉ូឡូញ	Plantilla:Geodatos Polonia
ចំណាត់ថ្នាក់ក្រុម:User fr-1	Categoría:Wikipedia:Wikipedistas con nivel básico de francés
ទំព័រគំរូ:ទិន្នន័យ នៃប្រទេសណ័រវ៉េ	Plantilla:Geodatos Noruega
ទំព័រគំរូ:ទិន្នន័យប្រទេស ហ្សកហ៊្សី	Plantilla:Geodatos Georgia
ទំព័រគំរូ:Wikiquote	Plantilla:Wikiquote
ទំព័រគំរូ:Country showdata	Plantilla:Mostrar geodatos
ទំព័រគំរូ:Image label	Plantilla:Etiqueta imagen
ទំព័រគំរូ:ទិន្នន័យប្រទេស ស្រីលង្កា	Plantilla:Geodatos Sri Lanka
ទំព័រគំរូ:ទិន្នន័យ នៃប្រទេសមិចសិច	Plantilla:Geodatos México
ទំព័រគំរូ:ទិន្នន័យប្រទេស ក្រិច	Plantilla:Geodatos Grecia
ទំព័រគំរូ:ទិន្នន័យ នៃប្រទេសអារ៉ាប៊ីសាអូឌីត	Plantilla:Geodatos Arabia Saudita
ទំព័រគំរូ:ទិន្នន័យប្រទេស ក្រូអាត	Plantilla:Geodatos Croacia
ទំព័រគំរូ:ប្រអប់ព័ត៌មាន អ្នកនិពន្ធ	Plantilla:Ficha de escritor
ទំព័រគំរូ:Ja icon	Plantilla:Ja
ទំព័រគំរូ:ទិន្នន័យ នៃប្រទេសសហភាពអារ៉ាប់អេមីរ៉េត	Plantilla:Geodatos Emiratos Árabes Unidos
ទំព័រគំរូ:Infobox television	Plantilla:Ficha de serie de televisión
ទំព័រគំរូ:Geographic location	Plantilla:Ubicación geográfica
ទំព័រគំរូ:Infobox musical artist	Plantilla:Ficha de artista musical
ទំព័រគំរូ:ទិន្នន័យប្រទេស Serbia	Plantilla:Geodatos Serbia
ទំព័រគំរូ:Collapsible list	Plantilla:Lista desplegable
ទំព័រគំរូ:ទិន្នន័យ នៃប្រទេសអូស្រ្តាលី	Plantilla:Geodatos Australia
ទំព័រគំរូ:ទិន្នន័យ​នៃប្រទេសប៉ាឡេស្ទីន	Plantilla:PSE
ទំព័រគំរូ:Subatomic particle	Plantilla:SubatomicParticle
ទំព័រគំរូ:Sidebar	Plantilla:Navegación vertical
ទំព័រគំរូ:In use	Plantilla:En uso
ទំព័រគំរូ:ទិន្នន័យ នៃប្រទេសបារាំង	Plantilla:Geodatos Francia
ទំព័រគំរូ:Ambox	Plantilla:Metaplantilla de avisos
ទំព័រគំរូ:Update	Plantilla:Desactualizado
ទំព័រគំរូ:ប្រអប់ព័ត៌មាន មន្ទីរពេទ្យ	Plantilla:Ficha de hospital
ទំព័រគំរូ:ប្រអប់ព័ត៌មាន ភ្លេងជាតិ	Plantilla:Ficha de himno
ទំព័រគំរូ:Very long	Plantilla:Largo
ទំព័រគំរូ:ទិន្នន័យ​នៃប្រទេសគាហ្គីស្ថាន	Plantilla:KGZ
ទំព័រគំរូ:ប្រអប់ព័ត៌មាន សាលារៀន	Plantilla:Ficha de escuela
ទំព័រគំរូ:Fossil range/bar	Plantilla:Rango fósil/barra
ទំព័រគំរូ:Userboxbottom	Usuario:Userbox/Userboxbottom
ទំព័រគំរូ:Font color	Plantilla:Fontcolor
ទំព័រគំរូ:ប្រអប់ព័ត៌មាន ប្រទេស	Plantilla:Ficha de país
ទំព័រគំរូ:Max	Plantilla:Max
ទំព័រគំរូ:Infobox software	Plantilla:Ficha de software
ទំព័រគំរូ:ទិន្នន័យប្រទេស ឡាវ	Plantilla:Geodatos Laos
ទំព័រគំរូ:Infobox airline	Plantilla:Ficha de aerolínea
ទំព័រគំរូ:Wide image	Plantilla:Panorama
ទំព័រគំរូ:ទិន្នន័យ នៃប្រទេសអូទ្រីស	Plantilla:Geodatos Austria
ទំព័រគំរូ:ប្រអប់ព័ត៌មាន ជម្លោះយោធា	Plantilla:Ficha de conflicto
ទំព័រគំរូ:Redirect4	Plantilla:Str left
ទំព័រគំរូ:ទិន្នន័យ នៃប្រទេសនេប៉ាល់	Plantilla:Geodatos Nepal
ទំព័រគំរូ:Pagelist	Plantilla:Lista de enlaces
ទំព័រគំរូ:Px	Plantilla:Px
ទំព័រគំរូ:Resolved	Plantilla:Hecho
ទំព័រគំរូ:Str sub long	Plantilla:Str sub
ទំព័រគំរូ:ទិន្នន័យ នៃប្រទេសហ្វាំងឡង់	Plantilla:Geodatos Finlandia
ទំព័រគំរូ:Flatlist	Plantilla:Lista plana
ទំព័រគំរូ:ទិន្នន័យ​នៃប្រទេសហ្វីលីពីន	Plantilla:FIL
ទំព័រគំរូ:ទិន្នន័យ នៃប្រទេសអេស៊ីប	Plantilla:Geodatos Egipto
ទំព័រគំរូ:ទិន្នន័យ នៃប្រទេសលីថូនី	Plantilla:Geodatos Lituania
ទំព័រគំរូ:ប្រអប់ព័ត៌មាន គណបក្សនយោបាយ	Plantilla:Ficha de partido político
ទំព័រគំរូ:ទិន្នន័យប្រទេស ជប៉ុន	Plantilla:Geodatos Japón
ទំព័រគំរូ:ទិន្នន័យ នៃប្រទេសហូឡង់	Plantilla:Geodatos Países Bajos
ទំព័រគំរូ:Navbox with columns	Plantilla:Navegación con columnas
ទំព័រគំរូ:ប្រអប់ព័ត៌មាន ល្បែងវីដេអូ	Plantilla:Ficha de videojuego
ទំព័រគំរូ:S-start	Plantilla:S-inicio
ទំព័រគំរូ:IsLeapYear	Plantilla:Es bisiesto
ទំព័រគំរូ:Age in years and days	Plantilla:Edad en años y días
ទំព័រគំរូ:Nom	Plantilla:Nominado
ទំព័រគំរូ:Facebook	Plantilla:Facebook
ទំព័រគំរូ:ប្រអប់ព័ត៌មាន សាកលវិទ្យាល័យ	Plantilla:Ficha de universidad
ទំព័រគំរូ:Cite journal	Plantilla:Cita publicación
ទំព័រគំរូ:ទិន្នន័យប្រទេស អាស៊ែបៃហ្សង់	Plantilla:Geodatos Azerbaiyán
ទំព័រគំរូ:ទិន្នន័យ​នៃប្រទេសប្រ៊ុយណេ	Plantilla:BRN
ទំព័រគំរូ:វិគីសៀវភៅ	Plantilla:Wikilibros
ទំព័រគំរូ:Image	Plantilla:Imagen
ទំព័រគំរូ:User browser:Firefox	Usuario:Userbox/Usuario Firefox
ទំព័រគំរូ:Time ago	Plantilla:Edad en tiempo
ទំព័រគំរូ:Familytree	Plantilla:Árbol genealógico
ទំព័រគំរូ:ទិន្នន័យប្រទេស វៀតណាម	Plantilla:Geodatos Vietnam
ទំព័រគំរូ:Featured article	Plantilla:Artículo destacado
ទំព័រគំរូ:ទិន្នន័យ នៃប្រទេសរុស្ស៊ី	Plantilla:Geodatos Rusia
ចំណាត់ថ្នាក់ក្រុម:User en-4	Categoría:Wikipedia:Wikipedistas con nivel experto de inglés
ចំណាត់ថ្នាក់ក្រុម:User en	Categoría:Wikipedia:Wikipedistas con conocimientos de inglés
ចំណាត់ថ្នាក់ក្រុម:User zh	Categoría:Wikipedia:Wikipedistas con conocimientos de chino
ចំណាត់ថ្នាក់ក្រុម:User zh-N	Categoría:Wikipedia:Wikipedistas con nivel nativo de chino
ចំណាត់ថ្នាក់ក្រុម:User en-2	Categoría:Wikipedia:Wikipedistas con nivel intermedio de inglés
ទំព័រគំរូ:ប្រអប់ព័ត៌មាន	Plantilla:Ficha
ទំព័រគំរូ:Infobox instrument	Plantilla:Ficha de instrumento musical
ទំព័រគំរូ:TOC right	Plantilla:TOC derecha
ទំព័រគំរូ:Main other	Plantilla:Main other
ទំព័រគំរូ:Lang-kk	Plantilla:Lang-kk
ទំព័រគំរូ:Legend	Plantilla:Leyenda
ទំព័រគំរូ:ប្រអប់ព័ត៌មាន បណ្ណាល័យ	Plantilla:Ficha de biblioteca
ទំព័រគំរូ:Cite web	Plantilla:Cita web
ទំព័រគំរូ:YouTube	Plantilla:YouTube
ទំព័រគំរូ:ទិន្នន័យ នៃប្រទេសអ៊ីតាលី	Plantilla:Geodatos Italia
ទំព័រគំរូ:Current	Plantilla:Evento actual
ទំព័រគំរូ:ទិន្នន័យប្រទេស	Plantilla:Geodatos
ទំព័រគំរូ:Won	Plantilla:Ganador
ទំព័រគំរូ:Coor URL	Plantilla:Coor URL
ទំព័រគំរូ:Min	Plantilla:Min
ទំព័រគំរូ:Wiktionary	Plantilla:Wikcionario
ទំព័រគំរូ:ទិន្នន័យ នៃប្រទេសស៊ុយអែត	Plantilla:Geodatos Suecia
ទំព័រគំរូ:Bar box	Plantilla:Barras
ទំព័រគំរូ:Chem	Plantilla:Fquim
ទំព័រគំរូ:Language icon	Plantilla:En idioma
ទំព័រគំរូ:Lang-sr	Plantilla:Lang-sr
ទំព័រគំរូ:Admin	Plantilla:Biblio
ទំព័រគំរូ:IPA	Plantilla:AFI
ទំព័រគំរូ:អត្ថន័យដទៃទៀត	Plantilla:Otros usos
ទំព័រគំរូ:SeptemberCalendar	Plantilla:Septiembre
ទំព័រគំរូ:ទិន្នន័យប្រទេស សហភាពសូវៀត	Plantilla:Geodatos Unión Soviética
ទំព័រគំរូ:ទិន្នន័យ នៃប្រទេសឥណ្ឌា	Plantilla:Geodatos India
ទំព័រគំរូ:Language with name	Plantilla:LangWithName
ទំព័រគំរូ:Navbox subgroup	Plantilla:Navegación/subgrupo
ទំព័រគំរូ:ប្រអប់ព័ត៌មាន ក្រុមជនជាតិ	Plantilla:Ficha de grupo étnico
ទំព័រគំរូ:Archive box	Plantilla:Caja de archivos
ទំព័រគំរូ:MONTHNAME	Plantilla:Nombre mes
ទំព័រគំរូ:Calendar/MonthStartSat	Plantilla:Calendario/MesInicioSáb
វិគីភីឌា:Text of GNU Free Documentation License	Wikipedia:Texto de la Licencia de documentación libre de GNU
ទំព័រគំរូ:Sisterlinks	Plantilla:Info
ទំព័រគំរូ:ទិន្នន័យប្រទេស អង់ដូរ៉ា	Plantilla:Geodatos Andorra
ទំព័រគំរូ:ប្រអប់ព័ត៌មាន តំបន់ការពារ	Plantilla:Ficha de espacio natural
ទំព័រគំរូ:Border	Plantilla:Borde
ទំព័រគំរូ:ទិន្នន័យប្រទេស ព័រទុយហ្គាល់	Plantilla:Geodatos Portugal
ទំព័រគំរូ:MONTHNUMBER	Plantilla:Número mes
ទំព័រគំរូ:ទិន្នន័យប្រទេស បុរីវ៉ាទីកង់	Plantilla:Geodatos Ciudad del Vaticano
ទំព័រគំរូ:Top icon	Plantilla:Icono en título
ទំព័រគំរូ:Icon	Plantilla:Icono
ចំណាត់ថ្នាក់ក្រុម:Template:Country data templates	Categoría:Wikipedia:Plantillas de geodatos
ទំព័រគំរូ:Birth category header	Plantilla:Nacidos por año
ទំព័រគំរូ:Namespace detect	Plantilla:Detecta espacio de nombres
ចំណាត់ថ្នាក់ក្រុម:ជ័យលាភីរង្វាន់ណូបែល ផ្នែករូបវិទ្យា	Categoría:Premio Nobel de Física
ចំណាត់ថ្នាក់ក្រុម:ជ័យលាភីរង្វាន់ណូបែល ផ្នែកគីមីវិទ្យា	Categoría:Premio Nobel de Química
ទំព័រគំរូ:GeoGroup	Plantilla:Mapa lista de coordenadas
ទំព័រគំរូ:ទិន្នន័យប្រទេស ចិន	Plantilla:Geodatos China
ទំព័រគំរូ:Wikify	Plantilla:Wikificar
ទំព័រគំរូ:ទិន្នន័យ នៃ ប្រទេស អង់គ្លេស	Plantilla:Geodatos Inglaterra
ទំព័រគំរូ:ទិន្នន័យ នៃប្រទេសទួរគី	Plantilla:Geodatos Turquía
ទំព័រគំរូ:ទិន្នន័យ នៃប្រទេសស្វីស	Plantilla:Geodatos Suiza
ទំព័រគំរូ:ទិន្នន័យ នៃប្រទេសហ្វីលីពីន	Plantilla:Geodatos Filipinas
ទំព័រគំរូ:ទិន្នន័យ នៃប្រទេសម៉ាឡេស៊ី	Plantilla:Geodatos Malasia
ទំព័រគំរូ:ទិន្នន័យប្រទេស អាមេនី	Plantilla:Geodatos Armenia
ទំព័រគំរូ:Infobox OS	Plantilla:Ficha de sistema operativo
ទំព័រគំរូ:ទិន្នន័យ នៃប្រទេសតៃវ៉ាន់	Plantilla:Geodatos Taiwán
ទំព័រគំរូ:ទិន្នន័យប្រទេស វៀតណាមខាងត្បូង	Plantilla:Geodatos Vietnam del Sur
ទំព័រគំរូ:ទិន្នន័យ នៃប្រទេសឈីលី	Plantilla:Geodatos Chile
ទំព័រគំរូ:The Original Barnstar	Wikipedia:Wikiestrellas/Original
ទំព័រគំរូ:ទិន្នន័យប្រទេស លីបង់	Plantilla:Geodatos Líbano
ទំព័រគំរូ:ទិន្នន័យប្រទេស ចិនតៃប៉ិ	Plantilla:Geodatos China Taipéi
ទំព័រគំរូ:ប្រអប់ព័ត៌មាន សៀវភៅ	Plantilla:Ficha de libro
ទំព័រគំរូ:Tlc	Plantilla:Epc
ទំព័រគំរូ:Lang-fa	Plantilla:Lang-fa
ទំព័រគំរូ:ICD10	Plantilla:CIE-10
ទំព័រគំរូ:ទិន្នន័យ​នៃប្រទេសម៉ាឡេស៊ី	Plantilla:MYS
ទំព័រគំរូ:Infobox website	Plantilla:Ficha de sitio web
ទំព័រគំរូ:Globalize	Plantilla:Globalizar
ទំព័រគំរូ:Image label end	Plantilla:Etiqueta imagen fin
ទំព័រគំរូ:Documentation subpage	Plantilla:Subpágina de documentación
ទំព័រគំរូ:Uncategorized	Plantilla:Categorízame
ទំព័រគំរូ:ទិន្នន័យ​នៃប្រទេសឥណ្ឌូនេស៊ី	Plantilla:IDN
ទំព័រគំរូ:Talk header for guidelines	Plantilla:Encabezado discusión
ទំព័រគំរូ:Quote box	Plantilla:Caja de cita
ទំព័រគំរូ:Rtl-lang	Plantilla:Rtl-lang
ទំព័រគំរូ:ប្រអប់ព័ត៌មានទីកន្លែងកេរដំណែលពិភពលោក	Plantilla:Ficha de Patrimonio de la Unesco
ទំព័រគំរូ:Str len	Plantilla:Str len
ទំព័រគំរូ:Purge	Plantilla:Purgar
ទំព័រគំរូ:Lang-de	Plantilla:Lang-de
ទំព័រគំរូ:Empty category	Plantilla:Categoría vacía
ទំព័រគំរូ:Lang-la	Plantilla:Lang-la
ទំព័រគំរូ:ប្រអប់ព័ត៌មាន អាគារ	Plantilla:Ficha de edificio
ទំព័រគំរូ:'	Plantilla:'
ទំព័រគំរូ:Location map USA	Plantilla:Mapa de localización de Estados Unidos
ទំព័រគំរូ:Lang-el	Plantilla:Lang-el
ទំព័រគំរូ:Chessgames player	Plantilla:Chessgames jugador
ទំព័រគំរូ:ទិន្នន័យ​នៃប្រទេសអារ៉ាប៊ីសាអូឌីត	Plantilla:SAU
ទំព័រគំរូ:User page	Plantilla:Página usuario
ទំព័រគំរូ:DE	Plantilla:DEU
ទំព័រគំរូ:Lang-my	Plantilla:Lang-my
ទំព័រគំរូ:Infobox Christian leader	Plantilla:Ficha de líder religioso
ទំព័រគំរូ:User	Plantilla:U
ទំព័រគំរូ:Spoken Wikipedia	Plantilla:Wikipedia grabada
ទំព័រគំរូ:Clarify	Plantilla:Qué
ទំព័រគំរូ:Refimprove	Plantilla:Referencias
ទំព័រគំរូ:Lorem ipsum	Plantilla:Lorem ipsum
ទំព័រគំរូ:ស្នើសុំប្ដូរឈ្មោះ	Plantilla:Renombrar usuario
ទំព័រគំរូ:Image label small	Plantilla:Etiqueta imagen pequeña
ទំព័រគំរូ:Nihongo	Plantilla:Nihongo
ទំព័រគំរូ:Th icon	Plantilla:Th
ទំព័រគំរូ:Tag	Plantilla:Tag
ទំព័រគំរូ:Infobox former country	Plantilla:Ficha de estado desaparecido
ទំព័រគំរូ:IPA-en	Plantilla:AFI-en
ទំព័រគំរូ:JPN	Plantilla:JPN
ទំព័រគំរូ:Merge from	Plantilla:Fusionar desde
ជំនួយ:តារាង	Ayuda:Tablas
ទំព័រគំរូ:User wikipedia/Checkuser	Usuario:Userbox/Checkuser
ទំព័រគំរូ:ទិន្នន័យ​នៃប្រទេសប៉ាគីស្ថាន	Plantilla:PAK
ទំព័រគំរូ:Age in days nts	Plantilla:Edad en días
ទំព័រគំរូ:Guideline	Plantilla:Convención
ទំព័រគំរូ:JULIANDAY	Plantilla:JULIANDAY
ទំព័រគំរូ:Disagree	Plantilla:En contra
ទំព័រគំរូ:DNB portal	Plantilla:DNB-Portal
ទំព័រគំរូ:Talkarchive	Plantilla:Archivo discusión
ទំព័រគំរូ:Lt	Plantilla:Lt
ទំព័រគំរូ:ទិន្នន័យ​នៃប្រទេសអ៊ីរ៉ង់	Plantilla:IRN
ទំព័រគំរូ:ទិន្នន័យ​នៃប្រទេសហ្សកដង់	Plantilla:JOR
ទំព័រគំរូ:Bibleverse	Plantilla:Biblia
ទំព័រគំរូ:ទិន្នន័យ​នៃប្រទេសហុងកុង	Plantilla:HKG
ទំព័រគំរូ:ទិន្នន័យ​នៃប្រទេសកូរ៉េខាងជើង	Plantilla:PRK
ទំព័រគំរូ:Infobox continent	Plantilla:Ficha de territorio
ទំព័រគំរូ:BHU	Plantilla:BTN
ទំព័រគំរូ:ទិន្នន័យ​នៃប្រទេសសិង្ហបុរី	Plantilla:SGP
ទំព័រគំរូ:ទិន្នន័យ​នៃប្រទេសឥណ្ឌា	Plantilla:IND
ទំព័រគំរូ:ទិន្នន័យ​នៃប្រទេសម៉ាកាវ	Plantilla:MAC
ទំព័រគំរូ:To do	Plantilla:Parahacer
ទំព័រគំរូ:CURRENTJULIANDAY	Plantilla:CURRENTJULIANDAY
ទំព័រគំរូ:Nobold	Plantilla:Sin negrita
ចំណាត់ថ្នាក់ក្រុម:User ja-N	Categoría:Wikipedia:Wikipedistas con nivel nativo de japonés
ទំព័រគំរូ:Multicol-break	Plantilla:Nueva columna
ទំព័រគំរូ:PDFlink	Plantilla:Enlace PDF
ទំព័រគំរូ:Ca icon	Plantilla:Ca
ទំព័រគំរូ:ទិន្នន័យ នៃប្រទេសអាល្លឺម៉ងខាងកើត	Plantilla:Geodatos Alemania Occidental
ទំព័រគំរូ:Lang-ru	Plantilla:Lang-ru
ទំព័រគំរូ:Br separated entries	Plantilla:Br separated entries
ទំព័រគំរូ:Infobox saint	Plantilla:Ficha de santo
ទំព័រគំរូ:FebruaryCalendar	Plantilla:Febrero
ទំព័រគំរូ:URL	Plantilla:URL
ទំព័រគំរូ:ណែនាំ	Plantilla:Desambiguación
ទំព័រគំរូ:ទិន្នន័យ នៃប្រទេសហុងកុង	Plantilla:Geodatos Hong Kong
ទំព័រគំរូ:DEFAULTSORT	Plantilla:ORDENAR
ទំព័រគំរូ:No	Plantilla:No
ចំណាត់ថ្នាក់ក្រុម:ទំព័រគំរូ ប្រអប់ព័ត៌មាន	Categoría:Wikipedia:Fichas
ចំណាត់ថ្នាក់ក្រុម:Lists of flags	Categoría:Anexos:Banderas
ទំព័រគំរូ:ទិន្នន័យប្រទេស Nazi Germany	Plantilla:Geodatos Alemania nazi
ទំព័រគំរូ:Plainlist	Plantilla:Lista simple
ចំណាត់ថ្នាក់ក្រុម:ហិរញ្ញវត្ថុសាធារណៈ	Categoría:Finanzas públicas
ចំណាត់ថ្នាក់ក្រុម:អ្នកថតរូប	Categoría:Fotografía
ទំព័រគំរូ:Para	Plantilla:Parámetro
ចំណាត់ថ្នាក់ក្រុម:យន្តហោះយោធា	Categoría:Aeronaves militares
ទំព័រគំរូ:LAO	Plantilla:LAO
ទំព័រគំរូ:GRC	Plantilla:GRC
ទំព័រគំរូ:PRT	Plantilla:PRT
ទំព័រគំរូ:ទិន្នន័យ​នៃប្រទេសបង់ក្លាដែស្ស	Plantilla:BGD
ទំព័រគំរូ:Osmrelation	Plantilla:Relación OSM
ចំណាត់ថ្នាក់ក្រុម:អង្គការមិនរកប្រាក់កំរៃ	Categoría:Organizaciones sin ánimo de lucro
ទំព័រគំរូ:Lang-uk	Plantilla:Lang-uk
ទំព័រគំរូ:KHM	Plantilla:KHM
ទំព័រគំរូ:ប្រអប់ព័ត៌មាន អង្គការ	Plantilla:Ficha de organización
ទំព័រគំរូ:MNE	Plantilla:MNE
ទំព័រគំរូ:Thumbs up	Plantilla:Aprobado
ទំព័រគំរូ:Resize	Plantilla:Tamaño
ទំព័រគំរូ:IPA-fr	Plantilla:AFI-fr
ទំព័រគំរូ:Fix	Plantilla:Solicitud de referencias
ទំព័រគំរូ:Lang-nl	Plantilla:Lang-nl
ទំព័រគំរូ:ទិន្នន័យ​នៃប្រទេសមីយ៉ាន់ម៉ា	Plantilla:MMR
ទំព័រគំរូ:Lang-id	Plantilla:Lang-id
ទំព័រគំរូ:MONTHDAYS	Plantilla:Días mes
ទំព័រគំរូ:ទិន្នន័យ​នៃប្រទេសកូរ៉េខាងត្បូង	Plantilla:KOR
ទំព័រគំរូ:EMedicine2	Plantilla:EMedicine2
ទំព័រគំរូ:Chinese name	Plantilla:Nombre chino
ទំព័រគំរូ:លំហឈ្មោះ	Plantilla:Espacios de nombres
ចំណាត់ថ្នាក់ក្រុម:User gsw-1	Categoría:Wikipedia:Wikipedistas con nivel básico de alemán suizo
ទំព័រគំរូ:ទិន្នន័យប្រទេស កាតារ	Plantilla:Geodatos Catar
ទំព័រគំរូ:Lang-fr	Plantilla:Lang-fr
ទំព័រគំរូ:Superimpose	Plantilla:Sobrepuesto
ទំព័រគំរូ:FRA	Plantilla:FRA
ទំព័រគំរូ:Age	Plantilla:Edad
ទំព័រគំរូ:Wrap	Plantilla:Wrap
ទំព័រគំរូ:Flagicon image	Plantilla:Bandera imagen
ទំព័រគំរូ:Pending	Plantilla:Pendiente
ទំព័រគំរូ:Infobox person	Plantilla:Ficha de persona
ទំព័រគំរូ:ទិន្នន័យ នៃប្រទេសអ៊ីស្រាអែល	Plantilla:Geodatos Israel
ទំព័រគំរូ:Number table sorting	Plantilla:Nts
ទំព័រគំរូ:ទិន្នន័យប្រទេស កូឡុំប៊ី	Plantilla:Geodatos Colombia
ទំព័រគំរូ:ទិន្នន័យ នៃប្រទេសប៉ាគីស្ថាន	Plantilla:Geodatos Pakistán
ទំព័រគំរូ:ទិន្នន័យប្រទេស Ghana	Plantilla:Geodatos Ghana
ទំព័រគំរូ:ទិន្នន័យប្រទេស កូរ៉េខាងត្បូង	Plantilla:Geodatos Corea del Sur
ទំព័រគំរូ:Legend-line	Plantilla:Leyenda línea
ចំណាត់ថ្នាក់ក្រុម:ព្រះមហាក្សត្រខ្មែរ	Categoría:Reyes de Camboya
ទំព័រគំរូ:Coord	Plantilla:Coord
ទំព័រគំរូ:POV	Plantilla:No neutralidad
ទំព័រគំរូ:Citation/make link	Plantilla:Obra citada/enlace
ចំណាត់ថ្នាក់ក្រុម:20th-century births	Categoría:Nacidos en el siglo XX
ទំព័រគំរូ:Dmoz	Plantilla:Dmoz
ចំណាត់ថ្នាក់ក្រុម:ពហុកោណ	Categoría:Polígonos
ទំព័រគំរូ:Fide	Plantilla:Fide
ទំព័រគំរូ:ទិន្នន័យប្រទេស បារ៉ែន	Plantilla:Geodatos Baréin
ចំណាត់ថ្នាក់ក្រុម:ឯកសារអំពី ទំព័រគំរូ	Categoría:Wikipedia:Indicaciones para el uso de plantillas
ចំណាត់ថ្នាក់ក្រុម:User pdc	Categoría:Wikipedia:Wikipedistas con conocimientos de Deitsch
ចំណាត់ថ្នាក់ក្រុម:User et	Categoría:Wikipedia:Wikipedistas con conocimientos de estonio
ចំណាត់ថ្នាក់ក្រុម:User fr	Categoría:Wikipedia:Wikipedistas con conocimientos de francés
ចំណាត់ថ្នាក់ក្រុម:User id	Categoría:Wikipedia:Wikipedistas con conocimientos de indonesio
ចំណាត់ថ្នាក់ក្រុម:User ja	Categoría:Wikipedia:Wikipedistas con conocimientos de japonés
ចំណាត់ថ្នាក់ក្រុម:User km	Categoría:Wikipedia:Wikipedistas con conocimientos de jemer
ចំណាត់ថ្នាក់ក្រុម:User la	Categoría:Wikipedia:Wikipedistas con conocimientos de latín
ចំណាត់ថ្នាក់ក្រុម:User li	Categoría:Wikipedia:Wikipedistas con conocimientos de limburgués
ចំណាត់ថ្នាក់ក្រុម:User sv	Categoría:Wikipedia:Wikipedistas con conocimientos de sueco
ចំណាត់ថ្នាក់ក្រុម:User th	Categoría:Wikipedia:Wikipedistas con conocimientos de tailandés
ចំណាត់ថ្នាក់ក្រុម:User fr-3	Categoría:Wikipedia:Wikipedistas con nivel avanzado de francés
ចំណាត់ថ្នាក់ក្រុម:User it-3	Categoría:Wikipedia:Wikipedistas con nivel avanzado de italiano
ចំណាត់ថ្នាក់ក្រុម:User ja-3	Categoría:Wikipedia:Wikipedistas con nivel avanzado de japonés
ចំណាត់ថ្នាក់ក្រុម:User tr-3	Categoría:Wikipedia:Wikipedistas con nivel avanzado de turco
ចំណាត់ថ្នាក់ក្រុម:User pdc-1	Categoría:Wikipedia:Wikipedistas con nivel básico de Deitsch
ចំណាត់ថ្នាក់ក្រុម:User et-1	Categoría:Wikipedia:Wikipedistas con nivel básico de estonio
ចំណាត់ថ្នាក់ក្រុម:User li-1	Categoría:Wikipedia:Wikipedistas con nivel básico de limburgués
ចំណាត់ថ្នាក់ក្រុម:User nl-1	Categoría:Wikipedia:Wikipedistas con nivel básico de neerlandés
ចំណាត់ថ្នាក់ក្រុម:User tr-1	Categoría:Wikipedia:Wikipedistas con nivel básico de turco
ចំណាត់ថ្នាក់ក្រុម:User ko-4	Categoría:Wikipedia:Wikipedistas con nivel experto de coreano
ចំណាត់ថ្នាក់ក្រុម:User fr-4	Categoría:Wikipedia:Wikipedistas con nivel experto de francés
ចំណាត់ថ្នាក់ក្រុម:User it-4	Categoría:Wikipedia:Wikipedistas con nivel experto de italiano
ចំណាត់ថ្នាក់ក្រុម:User fr-2	Categoría:Wikipedia:Wikipedistas con nivel intermedio de francés
ចំណាត់ថ្នាក់ក្រុម:User it-2	Categoría:Wikipedia:Wikipedistas con nivel intermedio de italiano
ចំណាត់ថ្នាក់ក្រុម:User ja-2	Categoría:Wikipedia:Wikipedistas con nivel intermedio de japonés
ចំណាត់ថ្នាក់ក្រុម:User la-2	Categoría:Wikipedia:Wikipedistas con nivel intermedio de latín
ចំណាត់ថ្នាក់ក្រុម:User tr-2	Categoría:Wikipedia:Wikipedistas con nivel intermedio de turco
ចំណាត់ថ្នាក់ក្រុម:User fr-N	Categoría:Wikipedia:Wikipedistas con nivel nativo de francés
ចំណាត់ថ្នាក់ក្រុម:User it-N	Categoría:Wikipedia:Wikipedistas con nivel nativo de italiano
ចំណាត់ថ្នាក់ក្រុម:User nl-N	Categoría:Wikipedia:Wikipedistas con nivel nativo de neerlandés
ចំណាត់ថ្នាក់ក្រុម:User ru-N	Categoría:Wikipedia:Wikipedistas con nivel nativo de ruso
ចំណាត់ថ្នាក់ក្រុម:User it-5	Categoría:Wikipedia:Wikipedistas con nivel profesional de italiano
ចំណាត់ថ្នាក់ក្រុម:កំសាន្ត	Categoría:Entretenimiento
ទំព័រគំរូ:Sister-inline	Plantilla:Sister-inline
ចំណាត់ថ្នាក់ក្រុម:Image insertion templates	Categoría:Wikipedia:Plantillas de iconos
ទំព័រគំរូ:IncreaseNegative	Plantilla:Creciente negativo
ចំណាត់ថ្នាក់ក្រុម:User af	Categoría:Wikipedia:Wikipedistas con conocimientos de afrikaans
ចំណាត់ថ្នាក់ក្រុម:User af-1	Categoría:Wikipedia:Wikipedistas con nivel básico de afrikáans
ចំណាត់ថ្នាក់ក្រុម:User de	Categoría:Wikipedia:Wikipedistas con conocimientos de alemán
ទំព័រគំរូ:Calendar/MonthStartSun	Plantilla:Calendario/MesInicioDom
ទំព័រគំរូ:ប្រតិទិន/MonthStartFri	Plantilla:Calendario/MesInicioVie
ទំព័រគំរូ:Calendar/MonthStartMon	Plantilla:Calendario/MesInicioLun
ទំព័រគំរូ:Calendar/MonthStartWed	Plantilla:Calendario/MesInicioMié
ទំព័រគំរូ:Calendar/MonthStartTue	Plantilla:Calendario/MesInicioMar
ចំណាត់ថ្នាក់ក្រុម:User de-2	Categoría:Wikipedia:Wikipedistas con nivel intermedio de alemán
ទំព័រគំរូ:Calendar/MonthStartThu	Plantilla:Calendario/MesInicioJue
ចំណាត់ថ្នាក់ក្រុម:User de-3	Categoría:Wikipedia:Wikipedistas con nivel avanzado de alemán
ចំណាត់ថ្នាក់ក្រុម:User de-4	Categoría:Wikipedia:Wikipedistas con nivel experto de alemán
ចំណាត់ថ្នាក់ក្រុម:User de-N	Categoría:Wikipedia:Wikipedistas con nivel nativo de alemán
ចំណាត់ថ្នាក់ក្រុម:User el	Categoría:Wikipedia:Wikipedistas con conocimientos de griego antiguo
ចំណាត់ថ្នាក់ក្រុម:User en-3	Categoría:Wikipedia:Wikipedistas con nivel avanzado de inglés
ចំណាត់ថ្នាក់ក្រុម:User en-N	Categoría:Wikipedia:Wikipedistas con nivel nativo de inglés
ចំណាត់ថ្នាក់ក្រុម:User es	Categoría:Wikipedia:Wikipedistas con conocimientos de español
ចំណាត់ថ្នាក់ក្រុម:User es-1	Categoría:Wikipedia:Wikipedistas con nivel básico de español
ចំណាត់ថ្នាក់ក្រុម:User es-2	Categoría:Wikipedia:Wikipedistas con nivel intermedio de español
ចំណាត់ថ្នាក់ក្រុម:User es-4	Categoría:Wikipedia:Wikipedistas con nivel experto de español
ចំណាត់ថ្នាក់ក្រុម:User es-N	Categoría:Wikipedia:Wikipedistas con nivel nativo de español
ចំណាត់ថ្នាក់ក្រុម:User gsw	Categoría:Wikipedia:Wikipedistas con conocimientos de alemán suizo
ទំព័រគំរូ:N/a	Plantilla:No anunciado
ទំព័រគំរូ:ទិន្នន័យ នៃប្រទេសអាល្លឺម៉ង់	Plantilla:Geodatos Alemania
ទំព័រគំរូ:Multiple image	Plantilla:Imagen múltiple
ទំព័រគំរូ:ទិន្នន័យប្រទេស ចក្រភពអង់គ្លេស	Plantilla:Geodatos Reino Unido
ចំណាត់ថ្នាក់ក្រុម:ធរណីមាត្រ	Categoría:Geometría
ទំព័រគំរូ:ប្រអប់ព័ត៌មាន រោគ-ជំងឺ	Plantilla:Ficha de enfermedad
ទំព័រគំរូ:The Working Wikipedian's Barnstar	Wikipedia:Wikiestrellas/Trabajador
ទំព័រគំរូ:User wikipedia/Administrator	Usuario:Userbox/Bibliotecario
ទំព័រគំរូ:Weather box	Plantilla:Clima
ចំណាត់ថ្នាក់ក្រុម:User it	Categoría:Wikipedia:Wikipedistas con conocimientos de italiano
ចំណាត់ថ្នាក់ក្រុម:User it-1	Categoría:Wikipedia:Wikipedistas con nivel básico de italiano
ចំណាត់ថ្នាក់ក្រុម:User ja-1	Categoría:Wikipedia:Wikipedistas con nivel básico de japonés
ចំណាត់ថ្នាក់ក្រុម:User ko	Categoría:Wikipedia:Wikipedistas con conocimientos de coreano
ចំណាត់ថ្នាក់ក្រុម:User la-1	Categoría:Wikipedia:Wikipedistas con nivel básico de latín
ទំព័រគំរូ:Multiple issues	Plantilla:Problemas artículo
ទំព័រគំរូ:Cite doi	Plantilla:Cite doi
ទំព័រគំរូ:ប្រអប់ព័ត៌មាន រូបិយវត្ថុ	Plantilla:Ficha de moneda
ទំព័រគំរូ:Sup	Plantilla:Exp
ទំព័រគំរូ:Lang-vi	Plantilla:Lang-vi
ទំព័រគំរូ:Translation	Plantilla:Traducción
ទំព័រគំរូ:Distinguish	Plantilla:Distinguir
ទំព័រគំរូ:Infobox programming language	Plantilla:Ficha de lenguaje de programación
ទំព័រគំរូ:He icon	Plantilla:He
បញ្ជីរាយនាម ជ័យលាភីរង្វាន់ណូបែល ផ្នែកអក្សរសាស្ត្រ	Anexo:Ganadores del Premio Nobel de Literatura
វិគីភីឌា:Maintenance	Wikipedia:Mantenimiento
ចំណាត់ថ្នាក់ក្រុម:User ru-1	Categoría:Wikipedia:Wikipedistas con nivel básico de ruso
ទំព័រគំរូ:TOC limit	Plantilla:Contenido
វិគីភីឌា:បាបេល	Wikipedia:Babel
ទំព័រគំរូ:Expand list	Plantilla:Lista incompleta
ទំព័រគំរូ:Tdeprecated	Plantilla:Plantilla en desuso
ទំព័រគំរូ:Infobox particle	Plantilla:Ficha de partícula
ចំណាត់ថ្នាក់ក្រុម:1900s births	Categoría:Nacidos en los años 1900
ទំព័រគំរូ:Wikipedia how to	Plantilla:Guía
ទំព័រគំរូ:NovemberCalendar	Plantilla:Noviembre
ចំណាត់ថ្នាក់ក្រុម:សមុទ្រ	Categoría:Mares
ទំព័រគំរូ:FishBase genus	Plantilla:FishBase genus
ទំព័រគំរូ:MayCalendar	Plantilla:Mayo
ទំព័រគំរូ:User OS:Microsoft Windows	Usuario:Userbox/Usuario Windows
ទំព័រគំរូ:FishBase family	Plantilla:FishBase family
ទំព័រគំរូ:IPA-all	Plantilla:AFI2
ទំព័រគំរូ:Lang-ko	Plantilla:Lang-ko
ទំព័រគំរូ:Lang-it	Plantilla:Lang-it
ទំព័រគំរូ:Sect1911	Plantilla:Enciclopedia Británica 1911
ជំនួយ:Archiving a talk page	Ayuda:Cómo archivar una página de discusión
ទំព័រគំរូ:ទិន្នន័យ នៃប្រទេសប្រេស៊ីល	Plantilla:Geodatos Brasil
វិគីភីឌា:WikiProject Computing	Wikiproyecto:Terminología Informática
ចំណាត់ថ្នាក់ក្រុម:អង្គការអន្តរជាតិ	Categoría:Organizaciones internacionales
ទំព័រគំរូ:Sfn	Plantilla:Harvnp
ជំនួយ:សៀវភៅ	Ayuda:Libros
ចំណាត់ថ្នាក់ក្រុម:សមីការឌីផេរ៉ង់ស្យែល	Categoría:Ecuaciones diferenciales
ចំណាត់ថ្នាក់ក្រុម:ខេត្តក្រុងខ្មែរ	Categoría:Provincias de Camboya
ទំព័រគំរូ:Lang-lo	Plantilla:Lang-lo
ទំព័រគំរូ:Release date and age	Plantilla:Fecha de lanzamiento
ទំព័រគំរូ:Ms icon	Plantilla:Ms
ទំព័រគំរូ:Omega Chess diagram	Plantilla:Diagrama de ajedrez Omega
ចំណាត់ថ្នាក់ក្រុម:ឧទ្ធម្ភាគចក្រ	Categoría:Helicópteros
ចំណាត់ថ្នាក់ក្រុម:នាយករដ្ឋមន្ត្រី	Categoría:Primeros ministros
ចំណាត់ថ្នាក់ក្រុម:វិទ្យាសាស្ត្រសង្គម	Categoría:Ciencias sociales
ឈាន	Dhyana
ទំព័រគំរូ:ទិន្នន័យ នៃប្រទេសហុងគ្រី	Plantilla:Geodatos Hungría
ទំព័រគំរូ:JanuaryCalendar	Plantilla:Enero
ចំណាត់ថ្នាក់ក្រុម:ឆ្នាំកំណើត ១៩៥១	Categoría:Nacidos en 1951
ទំព័រគំរូ:Zh icon	Plantilla:Zh icon
ទំព័រគំរូ:Advert	Plantilla:Publicidad
ទំព័រគំរូ:Infobox government agency	Plantilla:Ficha de organismo oficial
វិគីភីឌា:Tools	Ayuda:Enlaces útiles
ចំណាត់ថ្នាក់ក្រុម:User ru	Categoría:Wikipedia:Wikipedistas con conocimientos de ruso
ចំណាត់ថ្នាក់ក្រុម:User ru-2	Categoría:Wikipedia:Wikipedistas con nivel intermedio de ruso
ចំណាត់ថ្នាក់ក្រុម:User ru-3	Categoría:Wikipedia:Wikipedistas con nivel avanzado de ruso
ចំណាត់ថ្នាក់ក្រុម:វត្តអារាមព្រះពុទ្ធសាសនា	Categoría:Templos budistas
ចំណាត់ថ្នាក់ក្រុម:User tr	Categoría:Wikipedia:Wikipedistas con conocimientos de turco
ចំណាត់ថ្នាក់ក្រុម:User tr-4	Categoría:Wikipedia:Wikipedistas con nivel experto de turco
ចំណាត់ថ្នាក់ក្រុម:User tr-N	Categoría:Wikipedia:Wikipedistas con nivel nativo de turco
បញ្ជីរាយនាម នាយករដ្ឋមន្ត្រីកម្ពុជា	Primer ministro de Camboya
ទំព័រគំរូ:En icon	Plantilla:En
ទំព័រគំរូ:Alice chess diagram	Plantilla:Diagrama de ajedrez doble
ទំព័រគំរូ:Spaces	Plantilla:Spaces
ទំព័រគំរូ:ប្រអប់ភាសា	Plantilla:Lang
ទំព័រគំរូ:FishBase species alt	Plantilla:FishBase species
ទំព័រគំរូ:ទិន្នន័យប្រទេស Russian SFSR	Plantilla:Geodatos República Socialista Federativa Soviética de Rusia
ទំព័រគំរូ:In-universe	Plantilla:Ficticio
ទំព័រគំរូ:ទិន្នន័យប្រទេស តួកម៉េនីស្ថាន	Plantilla:Geodatos Turkmenistán
ទំព័រគំរូ:Str index	Plantilla:Str index
ទំព័រគំរូ:TakeNote	Plantilla:Información
ទំព័រគំរូ:AugustCalendar	Plantilla:Agosto
ចំណាត់ថ្នាក់ក្រុម:ធរណីមាត្រត្រីកោណ	Categoría:Geometría del triángulo
ទំព័រគំរូ:BLP	Plantilla:BPV
ទំព័រគំរូ:Bar percent	Plantilla:Barras/contenido
ទំព័រគំរូ:Str find	Plantilla:Str find
ទំព័រគំរូ:Fr icon	Plantilla:Fr
ទំព័រគំរូ:Twitter	Plantilla:Twitter
ទំព័រគំរូ:Ko icon	Plantilla:Ko
ទំព័រគំរូ:Lang-hi	Plantilla:Lang-hi
ចំណាត់ថ្នាក់ក្រុម:Image with comment templates	Categoría:Wikipedia:Plantillas de comentarios
ទំព័រគំរូ:EST	Plantilla:EST
ទំព័រគំរូ:Football squad end	Plantilla:Equipo de fútbol fin
ទំព័រគំរូ:IAFD name	Plantilla:IAFD nombre
ទំព័រគំរូ:Weather box/cold	Plantilla:Clima/cold
ទំព័រគំរូ:ទិន្នន័យ​នៃប្រទេសរុស្ស៊ី	Plantilla:RUS
ទំព័រគំរូ:Fossil range/marker	Plantilla:Rango fósil/marcador
ទំព័រគំរូ:ICD9	Plantilla:CIE-9
ទំព័រគំរូ:CHL	Plantilla:CHL
ទំព័រគំរូ:User information templates	Plantilla:Plantillas de enlaces internos a nombres de usuario
ទំព័រគំរូ:Campaign	Plantilla:Campaña militar
ទំព័រគំរូ:ប្រអប់យុទ្ធនាការសង្គ្រាមឥណ្ឌូចិន	Plantilla:Guerras de Indochina
ទំព័រគំរូ:ទិន្នន័យ​នៃប្រទេសស៊ីរី	Plantilla:SYR
ទំព័រគំរូ:Familytree/step2	Plantilla:Árbol genealógico/step2
ទំព័រគំរូ:OctoberCalendar	Plantilla:Octubre
ទំព័រគំរូ:ENG	Plantilla:ENG
ទំព័រគំរូ:Citation	Plantilla:Obra citada
ទំព័រគំរូ:Citation/core	Plantilla:Obra citada/núcleo
ទំព័រគំរូ:ប្រអប់ព័ត៌មាន ភាសា/family-color	Plantilla:Ficha de idioma/colores
ទំព័រគំរូ:Grey	Plantilla:Gris
ចំណាត់ថ្នាក់ក្រុម:អាំងតេក្រាល	Categoría:Integrales
ចំណាត់ថ្នាក់ក្រុម:រូបវិទូ	Categoría:Físicos por país
ចំណាត់ថ្នាក់ក្រុម:គមនាគមន៍នៅប្រទេសជប៉ុន	Categoría:Transporte de Japón
ចំណាត់ថ្នាក់ក្រុម:ប្រទេសហ្សំប៊ី	Categoría:Zambia
ទំព័រគំរូ:ទិន្នន័យប្រទេស យូហ៊្គោស្លាវី	Plantilla:Geodatos Yugoslavia
ទំព័រគំរូ:Calm talk	Plantilla:Discusión sosegada
ចំណាត់ថ្នាក់ក្រុម:ការអប់រំនៅប្រទេសជប៉ុន	Categoría:Educación en Japón
ចំណាត់ថ្នាក់ក្រុម:ការអប់រំនៅកម្ពុជា	Categoría:Educación en Camboya
ចំណាត់ថ្នាក់ក្រុម:Disambiguation and redirection templates	Categoría:Wikipedia:Plantillas de desambiguaciones y redirecciones
ការពិភាក្សារបស់អ្នកប្រើប្រាស់:វ័ណថារិទ្ធ/រូបភាពប្រចាំថ្ងៃ	Wikipedia:Recurso del día
ចំណាត់ថ្នាក់ក្រុម:User nl	Categoría:Wikipedia:Wikipedistas con conocimientos de neerlandés
ទំព័រគំរូ:Unbulleted list	Plantilla:Lista sin viñetas
ចំណាត់ថ្នាក់ក្រុម:User zh-1	Categoría:Wikipedia:Wikipedistas con nivel básico de chino
ចំណាត់ថ្នាក់ក្រុម:មេកានិច	Categoría:Mecánica
ចំណាត់ថ្នាក់ក្រុម:រូបវិទូអាល្លឺម៉ង់	Categoría:Físicos de Alemania
ចំណាត់ថ្នាក់ក្រុម:រូបវិទូអ៊ីតាលី	Categoría:Físicos de Italia
ចំណាត់ថ្នាក់ក្រុម:រូបវិទូបារាំង	Categoría:Físicos de Francia
ចំណាត់ថ្នាក់ក្រុម:សេវាសាធារណៈ	Categoría:Servicios públicos
ចំណាត់ថ្នាក់ក្រុម:អិចស្ប៉ូណង់ស្យែល	Categoría:Exponenciales
ចំណាត់ថ្នាក់ក្រុម:ព្រឹត្តិការណ៍កីឡាចំរុះ	Categoría:Eventos multideportivos
ចំណាត់ថ្នាក់ក្រុម:គណិតវិទូអាល្លឺម៉ង់	Categoría:Matemáticos de Alemania
ទំព័រគំរូ:ទិន្នន័យប្រទេស វៀតណាមខាងជើង	Plantilla:Geodatos Vietnam del Norte
ចំណាត់ថ្នាក់ក្រុម:ចំនួនគត់រឺឡាទីប	Categoría:Números enteros
ចំណាត់ថ្នាក់ក្រុម:ត្រីកោណមាត្រ	Categoría:Trigonometría
ចំណាត់ថ្នាក់ក្រុម:ទ្រឹស្តីបទ	Categoría:Teoremas
ចំណាត់ថ្នាក់ក្រុម:ទ្រឹស្តីបទគណិតវិទ្យា	Categoría:Teoremas de matemáticas
ចំណាត់ថ្នាក់ក្រុម:អាកាសយានដ្ឋាន	Categoría:Aeropuertos
ចំណាត់ថ្នាក់ក្រុម:រូបវិទូអាមេរិក	Categoría:Físicos de Estados Unidos
ចំណាត់ថ្នាក់ក្រុម:រូបវិទូអង់គ្លេស	Categoría:Físicos de Inglaterra
ចំណាត់ថ្នាក់ក្រុម:អ្នកនិពន្ធល្បី	Categoría:Escritores de Camboya
ចំណាត់ថ្នាក់ក្រុម:នាយករដ្ឋមន្ត្រីសិង្ហបុរី	Categoría:Primeros ministros de Singapur
ចំណាត់ថ្នាក់ក្រុម:រង្វាន់ណូបែល	Categoría:Premio Nobel
ចំណាត់ថ្នាក់ក្រុម:ប្រទេសកម្ពុជា	Categoría:Camboya
ចំណាត់ថ្នាក់ក្រុម:អ្នកនយោបាយប៉ាគីស្ថាន	Categoría:Políticos de Pakistán
ទំព័រគំរូ:Lang-hy	Plantilla:Lang-hy
ចំណាត់ថ្នាក់ក្រុម:អ្នកនយោបាយខ្មែរ	Categoría:Políticos de Camboya
ចំណាត់ថ្នាក់ក្រុម:អ្នករុករកជនជាតិបារាំង	Categoría:Exploradores de Francia
ចំណាត់ថ្នាក់ក្រុម:ស្រីលង្កា	Categoría:Sri Lanka
ចំណាត់ថ្នាក់ក្រុម:ទំព័រគំរូឈ្មោះភាសា	Categoría:Wikipedia:Plantillas de soporte de idiomas
ចំណាត់ថ្នាក់ក្រុម:ទំព័រគំរូក្នុងរូបវិទ្យា	Categoría:Wikipedia:Plantillas de física
ទំព័រគំរូ:ISO 639 name	Plantilla:Obtener idioma
ទំព័រគំរូ:ទិន្នន័យប្រទេស Wales	Plantilla:Geodatos Gales
ចំណាត់ថ្នាក់ក្រុម:អុនសេន	Categoría:Aguas termales
ចំណាត់ថ្នាក់ក្រុម:ពហុធា	Categoría:Polinomios
ចំណាត់ថ្នាក់ក្រុម:ពិជគណិតថ្នាក់ដំបូង	Categoría:Álgebra elemental
ចំណាត់ថ្នាក់ក្រុម:អនុគមន៍	Categoría:Funciones
ចំណាត់ថ្នាក់ក្រុម:ភាសាជប៉ុន	Categoría:Idioma japonés
ចំណាត់ថ្នាក់ក្រុម:មធ្យម	Categoría:Medias
ចំណាត់ថ្នាក់ក្រុម:ចតុកោណ	Categoría:Cuadriláteros
ចំណាត់ថ្នាក់ក្រុម:ត្រីកោណ	Categoría:Triángulos
ចំណាត់ថ្នាក់ក្រុម:សំភារៈ​សំណង់	Categoría:Materiales de construcción
ចំណាត់ថ្នាក់ក្រុម:សមីការ	Categoría:Ecuaciones
ចំណាត់ថ្នាក់ក្រុម:ស្ពាននៅប្រទេសជប៉ុន	Categoría:Puentes de Japón
ចំណាត់ថ្នាក់ក្រុម:សិទ្ធិ	Categoría:Derechos
ទំព័រគំរូ:Hexadecimal	Plantilla:Hexadecimal
ចំណាត់ថ្នាក់ក្រុម:វិភាគគណិតវិទ្យា	Categoría:Análisis matemático
ចំណាត់ថ្នាក់ក្រុម:វិសមភាព	Categoría:Desigualdades
ចំណាត់ថ្នាក់ក្រុម:ឧទ្យានជាតិ	Categoría:Parques nacionales
ចំណាត់ថ្នាក់ក្រុម:កោះស៊ូម៉ាត្រា	Categoría:Sumatra
ចំណាត់ថ្នាក់ក្រុម:មីក្រូសេដ្ឋកិច្ច	Categoría:Microeconomía
ចំណាត់ថ្នាក់ក្រុម:HTML	Categoría:HTML
ចំណាត់ថ្នាក់ក្រុម:អាស៊ីហ្គេម	Categoría:Juegos Asiáticos
ចំណាត់ថ្នាក់ក្រុម:អេឡិចត្រូស្តាទិច	Categoría:Electrostática
ចំណាត់ថ្នាក់ក្រុម:អាកាសចរណ៍	Categoría:Transporte
ចំណាត់ថ្នាក់ក្រុម:គណិតវិទ្យាថ្នាក់ដំបូង	Categoría:Matemática elemental
ចំណាត់ថ្នាក់ក្រុម:ទ្រឹស្តីបទលេខ	Categoría:Teoría de números
ទំព័រគំរូ:ប្រអប់ព័ត៌មាន ភាសា	Plantilla:Ficha de idioma
ទំព័រគំរូ:Wikiversity	Plantilla:Wikiversidad
ទំព័រគំរូ:Quickindexnav	Wikipedia:Índice alfabético/Navegación
ចំណាត់ថ្នាក់ក្រុម:ភាសាអ៊ីតាលី	Categoría:Idioma italiano
ចំណាត់ថ្នាក់ក្រុម:ភាសាអេស្ប៉ាញ	Categoría:Idioma español
ចំណាត់ថ្នាក់ក្រុម:រថក្រោះ	Categoría:Carros de combate
ទំព័រគំរូ:Usbk	Plantilla:Usbk
ចំណាត់ថ្នាក់ក្រុម:កោះរបស់ឥណ្ឌូនេស៊ី	Categoría:Archipiélagos e islas de Indonesia
ទំព័រគំរូ:Update after	Plantilla:Actualizar
ទំព័រគំរូ:WPBannerMeta	Plantilla:PR
ខេត្តលង់ហោរ	Vĩnh Long
ចំណាត់ថ្នាក់ក្រុម:ភ្នំពេញ	Categoría:Nom Pen
ចំណាត់ថ្នាក់ក្រុម:ទំព័រគំរូសំរាប់ទង់ជាតិ	Categoría:Wikipedia:Plantillas de etiquetas de país
ចំណាត់ថ្នាក់ក្រុម:ឧទ្យានជាតិនៃព្រះរាជាណាចក្រកម្ពុជា	Categoría:Parques nacionales de Camboya
ទំព័រគំរូ:Split	Plantilla:Separar
កម្វុ	Kambu Svayambhuva
ចំណាត់ថ្នាក់ក្រុម:ធរណីមាត្រអ៊ីពែបូលីក	Categoría:Geometría hiperbólica
ទំព័រគំរូ:CompactTOC8	Plantilla:Índice
ចំណាត់ថ្នាក់ក្រុម:ក្រលាផ្ទៃ	Categoría:Área
ទំព័រគំរូ:File title	Plantilla:Título de archivo
ចំណាត់ថ្នាក់ក្រុម:លោការីត	Categoría:Logaritmos
ទំព័រគំរូ:CURRENTMINUTE	Plantilla:CURRENTMINUTE
ទំព័រគំរូ:ទិន្នន័យ​នៃប្រទេសអ៊ូបេគីស្ថាន	Plantilla:UZB
ទំព័រគំរូ:OnHold	Plantilla:En espera
ទំព័រគំរូ:Question	Plantilla:Pregunta
បញ្ជីរាយនាម ជ័យលាភីរង្វាន់ណូបែល ផ្នែកគីមីវិទ្យា	Anexo:Ganadores del Premio Nobel de Química
ទំព័រគំរូ:ទិន្នន័យ នៃប្រទេសអេស្ប៉ាញ	Plantilla:Geodatos España
ទំព័រគំរូ:Pad	Plantilla:Pad
ទំព័រគំរូ:ទិន្នន័យប្រទេស កាណាដា	Plantilla:Geodatos Canadá
ទំព័រគំរូ:Cookbook	Plantilla:Librodecocina
ទំព័រគំរូ:Flag	Plantilla:Bandera2
ទំព័រគំរូ:ទិន្នន័យប្រទេស ម៉ាល់ឌីវ	Plantilla:Geodatos Maldivas
ទំព័រគំរូ:ទិន្នន័យ នៃប្រទេសសិង្ហបុរី	Plantilla:Geodatos Singapur
ទំព័រគំរូ:ទិន្នន័យប្រទេស យេម៉ែន	Plantilla:Geodatos Yemen
ទំព័រគំរូ:Lang-pl	Plantilla:Lang-pl
ទំព័រគំរូ:DANFS	Plantilla:DANFS
ទំព័រគំរូ:Unreliable sources	Plantilla:Fuentes no fiables
ទំព័រគំរូ:Str right	Plantilla:Str right
ទំព័រគំរូ:Diff	Plantilla:Diff
ចំណាត់ថ្នាក់ក្រុម:ភាសាអង់គ្លេស	Categoría:Idioma inglés
យាយ ម៉ៅ	Yeay Mao
ទំព័រគំរូ:Infobox country Olympics	Plantilla:Ficha de país en los Juegos Olímpicos
ទំព័រគំរូ:Number of portals	Wikiproyecto:Portales/Número
ទំព័រគំរូ:PDB	Plantilla:PDB
ទំព័រគំរូ:OMIM2	Plantilla:OMIM2
ទំព័រគំរូ:Lang-th	Plantilla:Lang-th
ទំព័រគំរូ:Lang-sq	Plantilla:Lang-sq
ទំព័រគំរូ:Lang-es	Plantilla:Lang-es
ទំព័រគំរូ:Lang-ca	Plantilla:Lang-ca
ទំព័រគំរូ:Lang-az	Plantilla:Lang-az
ទំព័រគំរូ:AprilCalendar	Plantilla:Abril
ទំព័រគំរូ:JuneCalendar	Plantilla:Junio
ទំព័រគំរូ:MarchCalendar	Plantilla:Marzo
ទំព័រគំរូ:DiseasesDB2	Plantilla:DiseasesDB2
ចំណាត់ថ្នាក់ក្រុម:នាមត្រូលជនជាតិជប៉ុន	Categoría:Apellidos japoneses
ចំណាត់ថ្នាក់ក្រុម:ក្រុមហ៊ុនអាកាសចរណ៍	Categoría:Aviones comerciales
ចំណាត់ថ្នាក់ក្រុម:ពិជគណិត	Categoría:Álgebra
ចំណាត់ថ្នាក់ក្រុម:មុំ	Categoría:Ángulos
ចំណាត់ថ្នាក់ក្រុម:នព្វន្ធ	Categoría:Aritmética
ចំណាត់ថ្នាក់ក្រុម:ស្ពាននៅអាស៊ី	Categoría:Puentes de Asia
ចំណាត់ថ្នាក់ក្រុម:ស្ពាននៅកម្ពុជា	Categoría:Puentes de Camboya
ទំព័រគំរូ:Multicol	Plantilla:Columnas
សិទ្ធិកុមារ	Derechos del niño
ចំណាត់ថ្នាក់ក្រុម:អាស៊ីខាងកើត	Categoría:Asia Oriental
ទំព័រគំរូ:Chess diagram 6x6	Plantilla:Diagrama de ajedrez 6x6
ចំណាត់ថ្នាក់ក្រុម:អេឡិចត្រូម៉ាញ៉េទិច	Categoría:Electromagnetismo
ទំព័រគំរូ:Lang-mn	Plantilla:Lang-mn
ទំព័រគំរូ:Lang-sa	Plantilla:Lang-sa
ទំព័រគំរូ:Lang-sv	Plantilla:Lang-sv
វិគីភីឌា:វិគីគម្រោងប្រវត្តិសាស្ត្រ	Wikiproyecto:Historia
វិគីភីឌា:WikiProject Education	Wikiproyecto:Educación
វិគីភីឌា:វិគីគម្រោង សាកលវិទ្យាល័យ	Wikiproyecto:Universidades
ចំណាត់ថ្នាក់ក្រុម:សិទ្ធិមនុស្សនៅកម្ពុជា	Categoría:Derechos humanos en Camboya
ចំណាត់ថ្នាក់ក្រុម:បណ្ណាល័យ	Categoría:Bibliotecas
ចំណាត់ថ្នាក់ក្រុម:មេរថក្រោះសមរភូមិ	Categoría:Tanques de combate principal
ជំនួយ:អសង្ស័យកម្ម	Ayuda:Desambiguación
វិគីភីឌា:Link color	Ayuda:Color del enlace
ចំណាត់ថ្នាក់ក្រុម:យន្តហោះយោធាគ្រូបណ្តុះបណ្តាល	Categoría:Aeronaves de entrenamiento militar
ទំព័រគំរូ:ទិន្នន័យ​នៃប្រទេសម៉ុងហ្គោល	Plantilla:MNG
ចំណាត់ថ្នាក់ក្រុម:ចំនួនកុំផ្លិច	Categoría:Números complejos
ចំណាត់ថ្នាក់ក្រុម:គ្រោង​វិភាគ	Categoría:Análisis estructural
ចំណាត់ថ្នាក់ក្រុម:ទំព័រគំរូTOC	Categoría:Wikipedia:Plantillas de índices
ទំព័រគំរូ:Image label begin	Plantilla:Etiqueta imagen inicio
ចំណាត់ថ្នាក់ក្រុម:រង្វង់និងស៊្វែរ	Categoría:Círculos
ទំព័រគំរូ:Bg icon	Plantilla:Bg
ចំណាត់ថ្នាក់ក្រុម:កងកម្លាំងអាកាស	Categoría:Fuerzas aéreas
ចំណាត់ថ្នាក់ក្រុម:សាកលវិទ្យាល័យនៅប្រទេសជប៉ុន	Categoría:Universidades de Japón
ចំណាត់ថ្នាក់ក្រុម:គ្រឹះស្ថានឧត្តមសិក្សានៅកម្ពុជា	Categoría:Universidades de Camboya
ចំណាត់ថ្នាក់ក្រុម:វប្បធម៌ខ្មែរ	Categoría:Cultura de Camboya
ចំណាត់ថ្នាក់ក្រុម:User en-1	Categoría:Wikipedia:Wikipedistas con nivel básico de inglés
ចំណាត់ថ្នាក់ក្រុម:Calendar templates	Categoría:Wikipedia:Plantillas de calendarios
ចំណាត់ថ្នាក់ក្រុម:User de-1	Categoría:Wikipedia:Wikipedistas con nivel básico de alemán
ទំព័រគំរូ:Nowrap begin	Plantilla:Nowrap begin
ទំព័រគំរូ:Chaturanga diagram	Plantilla:Diagrama de chaturanga
ទំព័រគំរូ:ែដលកំពុងរឺកចំេរីន	Plantilla:En desarrollo
ទំព័រគំរូ:December calendar	Plantilla:Diciembre
ទំព័រគំរូ:JulyCalendar	Plantilla:Julio
វិគីភីឌា:WikiProject Council/Directory	Wikipedia:Wikiproyectos/Directorio
វិគីភីឌា:Tutorial/Keep in mind	Ayuda:Tutorial (políticas)
ចំណាត់ថ្នាក់ក្រុម:កោះជ្វា	Categoría:Java
ទំព័រគំរូ:Frac	Plantilla:Fracción
ទំព័រគំរូ:Ntsh	Plantilla:Ntsh
ជំនួយ:របារឧបករណ៍កែប្រែ	Ayuda:Barra de herramientas de edición
ទំព័រគំរូ:Start date	Plantilla:Fecha
វិគីភីឌា:Contributing to Wikipedia	Ayuda:Cómo puedes colaborar
ចំណាត់ថ្នាក់ក្រុម:ការធ្វើសេចក្ដីរាយការណ៏ពត៌មាន	Informe
ទំព័រគំរូ:SMS	Plantilla:SMS
ទំព័រគំរូ:Free	Plantilla:Free
ទំព័រគំរូ:Iblist name	Plantilla:Iblist nombre
វិគីភីឌា:Owl	Plantilla:Búho
ទំព័រគំរូ:Isfdb name	Plantilla:Isfdb nombre
វិគីភីឌា:Tutorial/Wrap-up and more info	Ayuda:Tutorial (para terminar)
វិគីភីឌា:Project namespace	Wikipedia:Espacio de nombres Wikipedia
វិគីភីឌា:ពានរង្វាន់	Wikipedia:Premios
វិគីភីឌា:Hatnotes	Wikipedia:Véase también
ទំព័រគំរូ:Loc	Plantilla:Loc
ទំព័រគំរូ:Month3	Plantilla:Mes3
ទំព័រគំរូ:Infobox file format	Plantilla:Ficha de formato de archivo
ទំព័រគំរូ:Db-g12	Plantilla:Plagio
វិគីភីឌា:Version 1.0 Editorial Team	Wikipedia:Wikipedia en CD
វិគីភីឌា:Birthday Committee	Wikipedia:Cumpleaños
ទំព័រគំរូ:EC number	Plantilla:EC
វិគីភីឌា:WikiProject Buddhism	Wikiproyecto:Budismo
ទំព័រគំរូ:Raumschach diagram	Plantilla:Diagrama de Raumschach
ទំព័រគំរូ:Location map Malaysia peninsula	Plantilla:Mapa de localización de Malasia peninsular
ទំព័រគំរូ:Nuttall	Plantilla:Nuttall
ទំព័រគំរូ:TVQ	Plantilla:TVQ
វិគីភីឌា:Help namespace	Wikipedia:Espacio de nombres Ayuda
ទំព័រគំរូ:Dynamic list	Plantilla:Lista ampliable
ទំព័រគំរូ:Infobox Chinese	Plantilla:Ficha de concepto oriental
ទំព័រគំរូ:Location map many	Plantilla:Mapa de localización múltiple
ទំព័រគំរូ:Worldcat id	Plantilla:Worldcat id
ទំព័រគំរូ:Location map/decdeg	Plantilla:Mapa de localización/decdeg
ចំណាត់ថ្នាក់ក្រុម:យន្តហោះប្រដេញ	Categoría:Cazas
ទំព័រគំរូ:Weather box/colh	Plantilla:Clima/colh
ទំព័រគំរូ:Weather box/colpastel	Plantilla:Clima/colpastel
ទំព័រគំរូ:Noitalic	Plantilla:Sin cursiva
ទំព័រគំរូ:Google+	Plantilla:Google+
ទំព័រគំរូ:Indian Rupee	Plantilla:INR
ទំព័រគំរូ:MSW3 Groves	Plantilla:MSW3 Groves
រូបភាពដែលបាត់បង់	The Missing Picture (película de 2013)
ទំព័រគំរូ:Cite comic	Plantilla:Cita historieta
ទំព័រគំរូ:Infobox អាកាសធាតុ/line	Plantilla:Clima/line
ទំព័រគំរូ:Weather box/colp	Plantilla:Clima/colp
ទំព័រគំរូ:Weather box/colt	Plantilla:Clima/colt
វិគីភីឌា:Userboxes/WikiProjects	Usuario:Userbox/Wikiproyectos
ជំនួយ:ការប្តូរទីតាំងទំព័រ	Ayuda:Redirección
ទំព័រគំរូ:Project header	Plantilla:Proyecto
ទំព័រគំរូ:Weather box/cols	Plantilla:Clima/cols
វិគីភីឌា:សារ ទំព័រគំរូ/General	Wikipedia:Plantillas generales
ទំព័រគំរូ:Subatomic particle/list	Plantilla:SubatomicParticle/list
វិគីភីឌា:Userboxes/Userboxes	Usuario:Userbox/Userboxes
ទំព័រគំរូ:ទិន្នន័យប្រទេស អូម៉ង់	Plantilla:Geodatos Omán
ទំព័រគំរូ:ទិន្នន័យប្រទេស កាមេរូន	Plantilla:Geodatos Camerún
អាកាសចរណ៍ឡាវ ជើងហោះហើរ លេខ៣០១	Vuelo 301 de Lao Airlines
ព្យុះហៃយ៉ាន	Tifón Haiyan
ពិសេស:បំលាស់ប្ដូរថ្មីៗ	Especial:CambiosRecientes
Module:Citation/CS1	Módulo:Citas
Module:HtmlBuilder	Módulo:HtmlBuilder
Module:Coordinates	Módulo:Coordenadas
Call of Duty: Advanced Warfare	Call of Duty: Advanced Warfare
