Naakaii Łizhiní Bikéyah	África
Binaʼadaałtzózí Dinéʼiʼ Bikéyah	Japón
Bitsiighaʼ Łichííʼí Bikéyah	Irlanda
Hángewii	Hungría
Dibé Diníí Bikéyah	España
Wááshindoon Bikéyah Ałhidadiidzooígíí	Estados Unidos
Bélgii Bikéyah	Bélgica
Látsębooʼ	Luxemburgo
Yágháhookáán	Universo
Nahasdzáán	Tierra
Nahoditsʼǫʼłání	Finlandia
Déinish Dineʼé Bikéyah	Dinamarca
Póolish Dineʼé Bikéyah	Polonia
Łitʼoowę́ęya	Lituania
Ídelii	Italia
Swis Bikéyah	Suiza
Óóswiya	Austria
Gwíík Dineʼé Bikéyah	Grecia
Tʼóok Bikéyah	Turquía
Béésh Bichʼahníí Bikéyah	Europa
(*@@@u0026asia")	Asia
Shádiʼááhjí kéyah yistinígíí	Antártida
Kéyah Wóyahgo Siʼánígíí	Países Bajos
Béésh bee akʼeʼelchíhí tʼáá bí nitsékeesígíí	Computadora
Hastiin alą́ąjįʼ dahsidáhígíí Barack Obama	Barack Obama
Táłtłʼááh Chʼosh Bitooh (Kéyah Dah Siʼánígíí)	Uruguay
Bilasáana	Manzana
Méhigo	México
Akééháshį́į́h Hahoodzo	California
Máaz	Marte (planeta)
Kénya	Kenia
Iithiyópya	Etiopía
Gáana	Ghana
Náshdóítsoh bitsiijįʼ daditłʼooígíí	Panthera leo
Dáághahii Dinéʼiʼ Bikéyah	Francia
Łééchąąʼí	Canis lupus familiaris
Tótaʼ Dinéʼiʼ Bikéyah	Reino Unido
Mósí	Felis silvestris catus
Dáághahii bizaad	Idioma francés
Łóóʼ	Pisces
Bwazííl	Brasil
Biʼééʼ Łichííʼí Bikéyah	Rusia
Łóóʼtsoh dóó Tééh hóyáanii	Cetacea
Élábéemah Hahoodzo	Alabama
Béésh Bichʼahii Bikéyah	Alemania
Bééshbichʼahii bizaad	Idioma alemán
Tin Bikéyah	Islandia
Ééstii Bikéyah	Estonia
Séetin	Saturno (planeta)
Didzéchííʼ	Cereza
Chidí naatʼaʼí	Avión
Hastiin alą́ąjįʼ dahsidáhígíí George W. Bush	George W. Bush
Létbiiya	Letonia
Yóókwein	Ucrania
Chek Bikéyah	República Checa
Słóbaʼ Bikéyah	Eslovaquia
Słobíín Bikéyah	Eslovenia
Wooméiniya	Rumania
Bálgaa Bikéyah	Bulgaria
Dziłigaii Bikéyah	Albania
Haʼaʼaahjí Hakʼaz Dineʼé Bikéyah	Groenlandia
Kwóóʼad Bikéyah	Croacia
Bosna dóó Hetsog Bikéyah	Bosnia y Herzegovina
Azééwii Bikéyah	Azerbaiyán
Andówa	Andorra
Béésh Łichíiʼii Bikéyah	Chipre
Jóojah (Kéyah)	Georgia
Kʼazah Bikéyah	Kazajistán
Dziłizhin Bikéyah	Montenegro
Bádikin Sídii	Ciudad del Vaticano
San Mawínoo Bikéyah	San Marino
Kyóoba	Cuba
Hashkʼaan Bikéyah	Barbados
Indoníízha	Indonesia
Tʼóok bizaad	Idioma turco
Kéyah Naakai Łizhinii Bikéyah Shádiʼááhjí Siʼánígíí	Sudáfrica
Aljííya	Argelia
Ózbeʼ Bikéyah	Uzbekistán
Tó	Agua
Níłchʼi naalkidí	Televisión
Chíilii	Chile
Doodaatsaahii (Jíísas)	Jesús de Nazaret
Mókiwii	Mercurio (planeta)
Ákáʼátʼįįł (béésh ntsékeesígíí álʼíní)	Apple
Biinis	Venus (planeta)
Jíbitoo	Júpiter (planeta)
Yoowéinis	Urano (planeta)
Néʼtoon	Neptuno (planeta)
Sį́ʼgaboo	Singapur
Tłóotoo	Plutón (planeta enano)
Łííhtensain	Liechtenstein
Dágháilchįįh	Adolf Hitler
Naaltsoos biniiʼ	Facebook
Naaki góneʼ yéigo daʼahijoogą́ą́ʼ	Segunda Guerra Mundial
Ałhíʼayiiltááh	Matemáticas
Aooméénii Bikéyah	Armenia
Ooljééʼ	Luna
Nahatʼeʼiitsoh Bikéyah	Australia
Béésh Łigaii Bikéyah	Argentina
Kolíya Bikéyah Náhookǫsjí Siʼánígíí	Corea del Norte
Naayééʼ	Dinosauria
Bilasáana bitseeʼ nineezígíí	Pyrus
Naturalis Historia of Pliny the Elder	Naturalis historia
Encyclopædia Britannica	Enciclopedia Británica
Tó yaʼnidaʼaazgééd	Acueducto
Chʼil łitsooí díkʼǫ́zhígíí	Citrus × limon
Sǫʼ	Estrella
Jóhonaaʼéí	Sol
Háájiʼjin	Hidrógeno
Níłchʼi Ászólí	Helio
Haʼaʼaahjí Tíímow	Timor Oriental
Séwes	Ceres (planeta enano)
Haʼooméya	Haumea (planeta enano)
Maakiimaakii	Makemake (planeta enano)
Ééwis	Eris (planeta enano)
Káábin	Carbono
Níłchʼi Yáʼátʼéehii	Oxígeno
Hadoh dóó hakʼaz neiłkidígíí	Termómetro
Níłchʼi Łitsxooí	Neón
Chihuahua Hahoodzo	Chihuahua
Soodin	Sodio
Béésh Łikoní	Magnesio
Béésh Ászólí	Aluminio
Tó Wónaanídę́ę́ʼ Bitsįʼ Yishtłizhii Bikéyah	India
Tʼoobááloo	Tuvalu
Béésh (Fe)	Hierro
Tʼónga	Tonga
Łeetsoii	Azufre
Samóa	Samoa
Sólomon Tó Bináhaazyínígíí	Islas Salomón
Banoʼáátʼoo	Vanuatu
Páápowa Bigíní Ániidí	Papúa Nueva Guinea
Níłchʼi Dootłʼizhí	Argón
Eʼeʼaahjí Tónteel bikáaʼgi Kéyah Yázhí dah Ndaaʼeełgo Ałhidadiidzooígíí	Estados Federados de Micronesia
Káálsiiyin	Calcio
Dilyį́hí	Plomo
Kílíbas	Kiribati
Chʼah Diʼilii Bikéyah	Mongolia
Fííjii	Fiyi
Béésh doo Ńdiniichxíihii	Titanio
Táłkááʼ Bighan Dineʼé Bikéyah	Venezuela
Méíin Hahoodzo	Maine
Łį́į́ʼ	Equus ferus caballus
Naaldeehii	Animalia
Sówinam	Surinam
Kéyah Nahasdzáán Ałníiʼgi Siʼánígíí	Ecuador
Kolámbiya	Colombia
Béésh Łibáhí	Cobalto
Bolíbiya	Bolivia
Béésh Łichíiʼii	Cobre
Niihémpshoo Hahoodzo	Nuevo Hampshire
Chʼosh doo yitʼíinii dláádí dóó Ábishjaaʼ	Fungi
Jaméíkʼa	Jamaica
Méésíchóoshish Hahoodzo	Massachusetts
Kanédikiʼ Hahoodzo	Connecticut
Naaʼahóóhai	Gallus gallus domesticus
Antíígwa dóó Hashkʼaan Bikéyah Yázhí	Antigua y Barbuda
Kéyah Ałkéé Nitį́įgo Dah Ndaaʼeełí	Hawái
Damóo Bikéyah	Dominica
Domingo Bikéyah	República Dominicana
Bisóodi	Sus scrofa domestica
Héítii	Haití
Iiwą́ą́	Irán
Iiwááʼ	Irak
Hakʼaz Dineʼé Bikéyah Hahoodzo	Alaska
Ízrel Bikéyah	Israel
Shádiʼááhjí Ásáí Bikéyah	Yemen
Jóoʼdan	Jordania
Gah Bikeeʼ Taahíʼahí	Florida
Kíígiz Bikéyah	Kirguistán
Hoozdo Hahoodzo	Arizona
Kóóweiʼ	Kuwait
Lááʼos	Laos
Łíbanoo	Líbano
Óogin Hahoodzo	Oregón
Naakaii Dootłʼizhí Bikéyah Yázhí (Tó Bináhaazyínígíí)	Maldivas
Kéyah dah siʼánígíí	América
Áshįįh Biiʼtó Hahoodzo	Utah
Béégashii	Bos primigenius taurus
Maléízha	Malasia
Dziłgaiitsoh Honeezkʼazii Bikéyah	Nepal
Omą́ą́	Omán
Eʼeʼaahjí Naakaii Dootłʼizhí Bikéyah	Pakistán
Kʼatár	Catar
Ásáí Bikéyah Saʼoodí	Arabia Saudita
Swii Lankʼa	Sri Lanka
Sííwiya	Siria
Tʼajiʼ Bikéyah	Tayikistán
Tʼáí Bikéyah	Tailandia
Kǫʼ naʼałbąąsii diné bee nágéhéʼ	Tren
Tʼóokmen Bikéyah	Turkmenistán
Ásáí Bikéyah Yázhí Ałhidadiidzooígíí	Emiratos Árabes Unidos
Biʼednam	Vietnam
Kolíya Bikéyah Shádiʼááhjí Siʼánígíí	Corea del Sur
Óola	Oro
Naʼałkaahí	Científico
Bangla Bikéyah	Bangladés
Angóola	Angola
Iiʼniʼ Tłʼiishtsoh Bikéyah	Bután
Bwoonéí	Brunéi
Tʼanzanííya	Tanzania
Béésh Tózháanii	Mercurio (elemento)
Kéyah Dańlíinii	Filipinas
Naakaii Łizhinii Bikéyah Beʼałnííʼ	República Centroafricana
Hastiin Albert Einstein	Albert Einstein
Tʼóogo	Togo
Hooghan Tsé Bee Ádaalyaaí Bikéyah	Zimbabue
Shádiʼááhjí Soodą́ą	Sudán del Sur
Tswana Dineʼé Bikéyah	Botsuana
Wóndii Dineʼé Bikéyah	Burundi
Ooljééʼ Bikéyah Yázhí	Comoras
Kéyah Káango Náhookǫsjí Siʼánígíí	República del Congo
Kéyah Káango Shádiʼááhjí Siʼánígíí	República Democrática del Congo
Jibótii	Yibuti
Gíní Nahasdzáán Ałníiʼgi Siʼánígíí	Guinea Ecuatorial
Gabǫ́ǫ́ (Kéyah)	Gabón
Géémbiya	Gambia
Gíní	Guinea
Gíní Bisó	Guinea-Bisáu
Chį́į́h Yee Adilohii Bideeʼ Tónteel Bibąąh	Costa de Marfil
Táłtłʼááh Chʼosh Daadánígíí Bitooh (Łizhinii Bikéyahdi)	Camerún
Tónteel Bibąąh Dootłʼizhí	Cabo Verde
Sotho Dineʼé Bikéyah	Lesoto
Łíbya	Libia
Madaʼgéésgáá	Madagascar
Malááwii	Malaui
Moowitéínya	Mauritania
Moroko	Marruecos
Namííbya	Namibia
Yogénda	Uganda
Wánda Dineʼé Bikéyah	Ruanda
Seishel	Seychelles
Náshdóítsoh Bitsiijįʼ Daditłʼooʼígíí Bidził	Sierra Leona
Soomáálii Bikéyah	Somalia
Soodą́ą	Sudán
Swáazi Dineʼé Bikéyah	Suazilandia
Nahasdzáán Bikáaʼgi Kéyah Naaznilgo Ałhidadiidzooígíí	Organización de las Naciones Unidas
Nidaashchʼąąʼígíí	Color
Béésh Łigaii	Plata
Béésh Dildǫʼí	Estaño
Łéétsoh	Uranio
Hastiin alą́ąjįʼ dahsidáhígíí Bill Clinton	Bill Clinton
Míshigin Hahoodzo	Míchigan
Tó Nitsaa Nílį́bąąh Hahoodzo	Illinois
Náhookǫsjí Dzígaii	Dakota del Norte
Ałnííʼjí Dzígaii	Dakota del Sur
Ayání Naakaii Hahoodzo	Montana
Tóʼííbézhí	Wyoming
Nímasii Kʼidadilyéhé	Idaho
Ahééhałtį́į́h Hahoodzo	Washington (estado)
Naʼazhǫǫsh Hahoodzo	Nevada
Kayíbíyinsíí (tónteel)	Mar Caribe
Dibé Nitsaa Hahoodzo	Colorado
Naakaii bizaad	Idioma español
Naʼashjéʼii	Araneae
Chʼosh bijáád tseebíhígíí	Arachnida
Chʼosh bideeʼ ádaadinígíí	Chelicerata
Chʼosh bijáád dahólónígíí	Arthropoda
Béeso	Dinero
Bijíniyah Hahoodzo	Virginia
Eʼeʼaahjí Bijiniyah Hahoodzo	Virginia Occidental
Kin Yótʼááh Deezʼá Hahoodzo	Nueva York (estado)
Wóód Áalin Hahoodzo	Rhode Island
Chʼosh bijáád hastání	Insecta
Méelin Hahoodzo	Maryland
Déláwee Hahoodzo	Delaware
Oohááyoo Hahoodzo	Ohio
Pénsówéíniyah Hahoodzo	Pensilvania
Niijéízii Hahoodzo	Nueva Jersey
Índíʼyéenah Hahoodzo	Indiana
Chidí	Automóvil
Jóojah Hahoodzo	Georgia (Estados Unidos)
Akałii Bikéyah	Texas
Náhookǫsjí Kééláanah Hahoodzo	Carolina del Norte
Shádiʼááhjí Kééláanah Hahoodzo	Carolina del Sur
Méhigoʼ sídii	México, D. F.
Bilasáana diwozhí	Ananas comosus
Mísísípii Hahoodzo	Misisipi
Ténésii Hahoodzo	Tennessee
Yootó Hahoodzo	Nuevo México
Mínisóodah Hahoodzo	Minnesota
Wiskaansin Hahoodzo	Wisconsin
Haʼaʼaahjí Dzígaii	Iowa
Nabeeskah Hahoodzo	Nebraska
Shádiʼááhjí Dzígaii	Kansas
Tó Dzígaii Nílį́	Misuri
Tónteel Chʼínílį́	Luisiana
Kentákii Hahoodzo	Kentucky
Dził Biiʼ Dzígaii	Arkansas
Halgai Hóteel Hahoodzo	Oklahoma
Ho Chi Min Sídii	Ciudad Ho Chi Minh
Bilagáana bizaad	Idioma inglés
Náhookǫsjí Hakʼaz Dineʼé Bikéyah	Nunavut
1901 – 1950	1902
Tłʼiish	Serpentes
1951 – 2000	1979
Pope Benedict XVI	Benedicto XVI
Maʼii Ashkii	Gerónimo
Tsin naaʼeeł táłtłʼááh naagháhígíí	Submarino
Tahoniigááh	Gripe
Tłʼízí	Capra aegagrus hircus
Kǫʼ	Fuego
Tʼááłáhági átʼéego:Templates	Categoría:Wikipedia:Plantillas
Dloziłchííʼ	Sciurus vulgaris
Tʼááłáhági átʼéego:Bideeʼtsʼinígíí	Categoría:Bovidae
Tʼááłáhági átʼéego:Ndaaʼnaʼii	Categoría:Squamata
Tiníléítsoh	Varanus komodoensis
Chʼosh bijáád neeznánígíí	Decapoda
Aymara bizaad	Idioma aimara
Łeeyiʼ chʼoshtsoh binááʼ hólónígíí	Gymnophiona
Tʼááłáhági átʼéego:Dééł dóó Tóidoozohii	Categoría:Gruiformes
Médíwííyin Sii	Mar Mediterráneo
Jóojah (Ałtsʼáʼáztiin)	Georgia (desambiguación)
Alóós	Arroz
Tsídii	Aves
Kéłánii bikágí yilzhólígíí	Onychophora
Kéchwa bizaad	Lenguas quechuas
Ínsadoobíídiiya	Enciclopedia
Íiyisíí Naaltsoos	Wikipedia:Portada
Dziłgaiitsoh Honeezkʼazii	Himalaya
Tʼááłáhági átʼéego:Candidates for speedy deletion	Categoría:Wikipedia:Borrar (definitivo)
Chʼil ahwééh	Té
Adijiłii	Erinaceinae
Kéyah Sahééwa Eʼeʼaahjí Siʼánígíí	Sahara Occidental
1801 – 1850	1815
Łį́į́ʼ Bideeʼłáaʼii	Unicornio
Hastiin Hernán Cortés	Hernán Cortés
Tsʼíʼii daʼaneezí	Culicidae
Dibé	Ovis orientalis aries
Łóóʼ hashkéhé	Selachimorpha
Ghą́ą́ʼaskʼidii	Camelus
Bidił Daazdoígíí dóó Daʼałtʼoʼígíí	Mammalia
Mágí dóó Mágí Ndahalinígíí	Primates
(*wálá-)	Formicidae
Tsísʼná	Anthophila
Jiłtʼoʼí	Rheum rhabarbarum
Sęęschʼil	Brassica oleracea var. botrytis
Ayęęzhii yiltʼąąʼí	Solanum melongena
Naalʼeełí	Anatidae
Yas	Nieve
Jádí dághaaʼígíí	Connochaetes
1851 – 1900	1865
Biʼééʼ Łichííʼí bizaad	Idioma ruso
1751 – 1800	1784
Bááh	Pan
Bee Hazʼą́ą Ił Chʼétʼaah	Declaración Universal de los Derechos Humanos
Kéyah haʼdéísná	Terremoto
Tó nitéél nitságoʼ atságáá	Tsunami
Níyoltsoh	Tornado
Saad bee alʼį́į́hni	Sistema de escritura
Tʼááłáhági átʼéego:Dáághahii	Categoría:Francia
Mąʼii łitsooí	Vulpes vulpes
Naaltéʼ	Esclavitud
Ahwééh	Café
Abeʼ	Leche
Dził	Montaña
Doo Nidahałtingóó	Desierto
Cryptographic	Criptografía
Guadalajara	Guadalajara (México)
Tsídii naʼałkʼaiʼí	Spheniscidae
Kolíya Dineʼé bizaad	Idioma coreano
Tó niteel	Océano
Hodíłchʼil Níłtsánígíí	Selva
HiTSʼezh	IPod
Hazéí	Sciuridae
Hazéí naatʼáʼii	Pteromyini
Ééʼ néíshoodí	Iglesia católica
Kwį́į́n Elizabeth II	Isabel II del Reino Unido
Hastiin alą́ąjįʼ dahsidáhígíí Ronald Reagan	Ronald Reagan
Hastiin Emperor Yongle	Yongle
Naʼashjéʼiitsoh	Lycosidae
Naaldlooshii dadichʼízhii	Reptilia
Tsin Deigházhígíí	Rodentia
Hasbídí	Columbidae
Tééh hóyáanii	Phocoenidae
Biyáázh Tsʼǫʼasánígíí (Táyiʼ dóó Niʼkáágóó Ndaakaaígíí)	Amphibia
Géeso	Queso
Chʼil naʼatłʼoʼii (chʼiyáán)	Uva
Tsísʼná bitłʼizh	Miel
Atsįʼ	Carne
Naʼashjéʼii tsiizisí	Pholcidae
Nímasii	Solanum tuberosum
Áshįįh łikan	Azúcar
Haʼałtsédii	Nuez (fruto)
Wááshindoon bisiláołtsooí	Fuerzas armadas de los Estados Unidos
Naʼiiniʼ bá Hooghantsoh	World Trade Center
Áshįįh	Sal
Wááshindoondi bee hazʼáanii ádeiłʼíní	Congreso de los Estados Unidos
Tsin naaʼeeł	Buque
Nidaʼąnyéézh	Riego
Naadą́ą́ʼ	Zea mays
Naʼashchʼąąʼ	Pintura
Wótáahgoo ałnaaʼáłtʼahiʼ	Astronauta
Azhish	Danza
Naʼashjéʼii nahachaʼígíí	Salticidae
Kéyah Daʼnaaznilígíí	Anexo:Países
Shash	Ursidae
Hastiin alą́ąjįʼ dahsidáhígíí John Adams	John Adams
Hastiin alą́ąjįʼ dahsidáhígíí Thomas Jefferson	Thomas Jefferson
Hastiin alą́ąjįʼ dahsidáhígíí Andrew Jackson	Andrew Jackson
Ńdíshchííʼ	Pinus
Tłʼoh naadą́ą́ʼ	Triticum
Naałniih yichʼą́ą́h naabaahígíí bąąh dahooʼaahgo	Sida
Abeʼ bee neezmasí	Crepe
Jéíʼádįįh	Tuberculosis
Łóódtsoh	Viruela
Zelda bahaneʼ	The Legend of Zelda
Naakáí dinéʼiʼ biempire Méhigodi	Mexica
Łéétsoh bee atsiniltłʼish álʼį́	Energía nuclear
Łéétsoh beeʼeldǫǫhtsoh beeʼalį́į́h	Arma nuclear
Chidí naaʼnaʼí beeʼeldǫǫh bikááʼ dah naaznilígíí	Tanque (desambiguación)
Dah woozh	Fragaria × ananassa
Jalisco Hahoodzo	Jalisco
Mágí bichʼiyąʼ	Cocos nucifera
Dzidzétsoh	Prunus persica
Chʼil łitsxooí	Citrus × sinensis
Chʼil dootłʼizhí díkʼǫ́zhígíí	Lima (fruta)
Abeʼ yistiní	Helado
Méhigo bizaad	Náhuatl
Diné bizaad	Idioma navajo
Jeeʼiighááh	Dermaptera
Tenochtitlan	México-Tenochtitlan
Ásáí Bizaad	Idioma árabe
Honeezílígi	Clima subtropical
Atʼaʼ yiltʼąąʼí	Arecaceae
Niłchiis	Gulo gulo
Tsin yilátah ayání	Giraffa camelopardalis
Naalʼeełídaaʼí	Ornithorhynchus anatinus
Naʼashǫ́ʼii	Lacertilia
Béésh bee akʼeʼelchí áłtsisígíí	Computadora personal
Wikiibíídiiya:Naaltsoos nizhónígo ádaalyaaígíí	Wikipedia:Artículos destacados
Bee álnééhí:Link FA	Plantilla:Destacado
Bimááʼ Hahoodzo	Vermont
Hoozdoh	Phoenix
Tʼáyaałchííʼ	Colaptes auratus
Táłkááʼ tsʼin bíchį́į́hnézí	Gavialis gangeticus
Tsin naaʼeeł chidí naatʼaʼí bee nágéhéʼ	Portaviones
Tsídiitsoh	Struthio camelus
Kolíya bikéyah (Ałtsʼáʼáztiin)	Corea
Mąʼiitsoh	Canis lupus
Chʼídeeldlóohiitsoh	Balaeniceps rex
Hodíłchʼilgi dlǫ́ʼiitsoh	Paradoxurus hermaphroditus
Tóidoozohii bidaaʼ łichííʼígíí	Gallinula chloropus
Táłtłʼááh yilcháazhii	Porifera
Tónteel naʼashjéʼii	Pycnogonida
Séigoʼ bíláshgaanézí	Amblypygi
Naʼashjéʼii jáádnézí	Opiliones
Séigoʼchilí bitseeʼ ádinígíí	Pseudoscorpionida
Séigoʼ	Scorpiones
Zahalchíʼii	Solifugae
Hastiin Emperor Qianlong	Emperador Qianlong
Séigoʼ bitseeʼ áłtsʼózígíí	Uropygi
Yaaʼ doo yitʼíinii	Acari
Tsídii doo ndaatʼáʼii	Ratitae
Hodíłchʼilgi naaʼahóóhai	Tinamidae
Tłʼiishkʼosí (tsídii)	Anhingidae
Télii	Equus africanus asinus
Náshdóítsoh noodǫ́zígíí	Panthera tigris
Kʼíneeshbízhiinééz	Espagueti
Chʼosh yoołgai bitsʼaʼígíí	Ostreidae
Azeeʼ hókániitsoh	Cirsium vulgare
Táłkáaʼgi Tsídii	Anseriformes
Tązhii dóó Naaʼahóóhai Ndahalinígíí	Galliformes
Naalʼeełii keelóól	Podicipedidae
Tsídii Deílʼésígíí	Ciconiiformes
Daʼałtʼoʼígíí Biyęęzhii Deiłchíhígíí	Monotremata
Adijiłii bíchį́į́hnézí	Tachyglossidae
Biyázhí neiyéhé	Didelphidae
Hazéítsʼósii	Tamias
Chidí bikʼah	Petróleo
Chéłchaaʼ	Coleoptera
Łį́į́ʼ ałchiní	Equus ferus przewalskii
Dlǫ́ʼii yił aheełtʼéhii noodǫ́zígíí	Mungos mungo
Naʼastsʼǫǫsíʼniiʼí	Peramelidae
Shash naʼazísí	Vombatidae
Nahatʼeʼiitsohchilí	Potoroidae
Náʼagéédí łichíiʼii	Chrysochloridae
Bįįh Danilínígíí	Cervidae
Tin	Hielo
Tłʼohchin díchʼííʼí	Allium sativum
Taʼneeskʼání áłtsʼóózígíí	Cucumis sativus
Tłʼohchin (chʼil daadánígíí)	Allium cepa
Chʼil łichxíʼí	Solanum lycopersicum
Béésh Łichíiʼii Bikéyah Náhookǫsjígo Siʼanígíí	República Turca del Norte de Chipre
Naʼazhǫǫsh Hátsoh	Las Vegas
Náshdóí dilwoʼí	Acinonyx jubatus
Tsékǫʼ	Carbón
Néʼéshjaaʼ	Strigiformes
Bíígháán Dahólónígíí	Vertebrata
Kʼishchííʼ	Betula
Ǫǫbǫʼii	Upupa epops
Náshdóí Ndahalinígíí	Felidae
Yádiłhił yiiyídíʼ nahosdzáán yináádáłiʼ	Estación Espacial Internacional
Tó wónaanídę́ę́ʼ toohjįʼ noołnahii	Ardea cinerea
Hashkʼaan dijéʼé	Phoenix dactylifera
Wááshindoon (Ałtsʼáʼáztiin)	Washington
Bidił Daazdoígíí dóó Daʼalghałígíí	Carnivora
Chʼoshtsoh	Blattodea
Dlǫ́ʼii yázhí	Mustela nivalis
Tsʼíʼii dóó Tséʼédǫ́ʼii	Diptera
Biniiʼłigaii (néʼéshjaaʼ)	Tyto alba
Mąʼii Ndahalinígíí	Canidae
Bijáád Ádaadinígíí	Mollusca
Chʼosh łitsxooí dóó Chʼosh łichííʼí	Coccinellidae
Táłkááʼ naalzheehí	Pandion haliaetus
Bizaʼazis Dahólónígíí	Marsupialia
Dlǫ́ʼiiłgaii	Mustela erminea
Naalʼeełí bitsiiʼ dootłʼizhí	Anas platyrhynchos
Sǫʼ łóóʼ	Asteroidea
Giníłbáhí	Accipiter gentilis
Tʼádootłʼizhii	Garrulus glandarius
Zhį́ʼii	Corvus corax
Táłkááʼ tsʼin Danilínígíí	Crocodilia
Chʼosh bikágí dantłʼizí	Crustacea
Dééł	Gruidae
Chʼosh bitsʼaʼígíí	Bivalvia
Atsá dóó Giní Ndahalinígíí	Falconiformes
Łóóʼ ooshgę́ęzhii	Chondrichthyes
Tániilʼáí	Odonata
Wóláchííʼ yildeełí bikágí ntłʼizí	Manis
Gah Danilínígíí	Lagomorpha
Tsísʼnátsoh	Bombus
Hazéí yiltseeʼí	Achillea millefolium
Chʼosh bikǫʼí	Lampyridae
Zéédzísgaii	Phasianus colchicus
Dlǫ́ʼii Ndahalinígíí	Mustelidae
Tsin yiłkaałii	Picidae
Bideeʼtsʼinígíí	Bovidae
Dééł dóó Tóidoozohii Ndahalinígíí	Gruiformes
Gáagii dóó Joogii Ndahalinígíí	Corvidae
Chʼiltaatʼagii	Circus cyaneus
Tsin naaʼeeł diné bee nágéhéʼ	Transbordador
Gad	Juniperus
Jááłánii	Myriapoda
Biishchʼid Dahólónígíí	Placentalia
Chʼosh Deildeełii	Insectivora
Tó wónaanídę́ę́ʼ naalʼeełítsoh łibáhígíí	Anser anser
Tónteel dóó Tábąąhgi Tsídii	Charadriiformes
Ńdíshchíitah dlǫ́ʼii	Martes martes
Biyaatsʼiin Dahólónígíí	Gnathostomata
Tooh łéʼétsoh	Ondatra zibethicus
Chaatʼíní	Rumex acetosa
Łóóʼ hashkéhé dootłʼizhígíí	Prionace glauca
Wóʼatsʼǫǫsii Ádaatʼéhígíí	Hemiptera
Atsáłgaii	Buteo lagopus
Béégashiiʼilí	Bos mutus
Tó wónaanídę́ę́ʼ dlǫ́ʼii	Mustela putorius
Tsxį́į́łnaalkʼįhii	Apodidae
Dziłditłʼoii Bił Hahoodzo	Condado de San Juan (Utah)
Hakʼaz naalʼeełí	Somateria mollissima
Naalʼeełítsoh bitsiiʼ halzhinígíí	Branta canadensis
Chʼó	Picea
Łóóʼtsoh łizhin dóó łigaígíí	Orcinus orca
Jáádtsʼósí	Recurvirostridae
Téél dzítsooii dóó Tsétah chʼosh	Carabidae
Naalʼeełítsoh diłhiłígíí	Branta bernicla
Tábąąh dlǫ́ʼii	Neovison vison
Dlǫ́ʼii bitéél halgaií	Martes foina
Tábąąstííntsoh łibáhígíí	Halichoerus grypus
Naakaii Łizhiní Bikéyahdi Hadahóólįįdígíí	Afrotheria
Diné Nááhódlóonii bizaad	Lenguas atabascanas
Łį́į́ʼ bitsísʼná	Oestridae
Tónteel tsídii	Laridae
Hazaʼaleehtsoh (dííshjį́ ááłjiní)	Apium graveolens
Kʼaalógii dóó Iichʼąhii	Lepidoptera
Díłdánii yił aheełtʼéhii	Coturnix coturnix
Chʼałdą́ą́ʼ / Jádí nátʼoh (chʼil daadánígíí)	Asparagus officinalis
Tséʼédǫ́ʼii dootłʼizhí	Calliphoridae
Jaaʼabaní Danilínígíí	Chiroptera
Wóónałchídii	Elateridae
Tsídii bidaanézí	Ciconiidae
Dlǫ́ʼii	Mustela
Lókʼaaʼ	Phragmites australis
Tsídiiłbáhí	Passeridae
Biłʼeʼeliníʼ	Levadura química
Táłtłʼááh chʼoshchilí	Euphausiacea
Tsiiʼyiishbizhí Dinéʼiʼ Bikéyah	China (región)
Naalʼeełí binááʼ łitsooígíí	Bucephala clangula
Tábąąstíín	Lutra lutra
Jélii łóóʼ	Medusa (animal)
Náshdóíłgaii łikizhígíí	Panthera uncia
Tábąąstííntsoh Danilínígíí	Pinnipedia
Dlǫ́ǫ́ʼ	Cynomys
Náshdóí bijaałizhiní	Caracal caracal
Chʼóhojilyééh	Datura stramonium
Chʼah Diʼilii Bikéyahdę́ę́ʼ naalʼeełítsoh	Anser cygnoides
Tsídii yáłtiʼí	Psittaciformes
Tééh łį́į́ʼ	Cebra
Náshdóí łikizhígíí	Leopardus pardalis
Dííłdzid jeeshóóʼ	Neophron percnopterus
Tʼáadoo leʼé danílʼį́ bił hazʼą́	Museo
Shash łizhin dóó łigaígíí	Ailuropoda melanoleuca
Shash łigaígíí	Ursus maritimus
Gaantsʼosí	Crinoidea
Hastiin alą́ąjįʼ dahsidáhígíí Theodore Roosevelt	Theodore Roosevelt
Neeshchʼííłgai	Anacardium occidentale
Dilní bee Nidaʼanéhígíí	Instrumento musical
Dééłgai	Cygnus (género)
Bikááʼ náʼoobałí	Helicóptero
Dziʼizítsoh	Motocicleta
Tééhoołtsódii	Hippopotamus amphibius
Séí	Arena
Naakaii Łizhiní Bikéyahdę́ę́ʼ náshdóítsoh łikizhígíí	Panthera pardus
Déélgééd	Rhinocerotidae
Beeʼeldííl Dahsinil	Albuquerque
Hashkʼaan dootłʼizhí (babáayah)	Carica papaya
Chʼil łigaii (atʼééké bijish)	Brassica oleracea var. capitata
Náshdóítsoh	Puma concolor
Ásáí dinéʼiʼ	Pueblo árabe
Deeteel	Alces alces
Shádiʼááhdę́ę́ʼ náshdóítsoh łikizhígíí	Panthera onca
Lókʼaatsoh	Bambuseae
Káango (Ałtsʼáʼáztiin)	Congo
Kʼaiʼ	Salix
Shash bizaʼazis hólóní	Phascolarctos cinereus
Náshdóí kʼos bee naashchʼąąʼígíí	Neofelis nebulosa
Shashtsoh	Ursus arctos
Łéʼétsoh	Rattus
Akʼáán	Harina
Mágítsoh	Gorilla
Bitsįʼ yishtłizhii	Indígenas de América
Chʼil akʼahí	Persea americana
Neeshchʼííłbáhí	Arachis hypogaea
Dzidzétsoh díkʼǫ́ǫzhii	Prunus armeniaca
Naʼashǫ́ʼii łahgo ánééhé	Chamaeleonidae
Yootó	Santa Fe (Nuevo México)
Łééchąąłgaii	Galgo inglés
Nahatʼeʼiitsoh Bikéyahdę́ę́ʼ łééchąąʼí ałchiní	Canis lupus dingo
Chʼééhjiyáán	Citrullus lanatus
Teide	Teide
Naʼastsʼǫǫsí	Mus (animal)
Hakʼaz bįįh	Rangifer tarandus
Chʼosh doo yitʼínii	Microorganismo
Táshchozhii	Hirundinidae
Neeshchʼííʼ hááheeshchiiʼí	Prunus dulcis
Łóóʼ bigaan tseebíí	Octopoda
Chʼosh bikágí ntłʼizí	Brachyura
Tábąąstííntsoh bideeʼ hólónígíí	Odobenus rosmarus
Mágí diʼilí	Pongo
Atsátsoh	Aquila chrysaetos
Łóóʼtʼą́hí atsiniltłʼish ííłʼínígíí	Torpediniformes
Chʼil łitsxooí ntsxaaígíí	Citrus × paradisi
Kʼíníjíłʼahí (dííshjį́ ááłjiní)	Ribes uva-crispa
Kʼaalógiiłgaígíí	Pieridae
Naʼastsʼǫǫsí binááʼ áłtsʼíísígíí	Soricidae
Dzaanééz	Mula (animal)
Tsinlátah shash łichíʼígíí	Ailurus fulgens
Tsídii jáádnézí	Phoenicopterus
Tééh łééchąąʼí	Hyaenidae
Łóóʼtsoh dootłʼizhígíí	Balaenoptera musculus
Sóól	Acer (planta)
Aghaaʼ	Lana
Deesdoigi	Zona intertropical
Shádiʼááhdę́ę́ʼ tłʼízí	Lama glama
Mósíʼilí	Gato persa
Lókʼaatah mósí ałchiní	Felis chaus
Náátsʼózídę́ę́ʼ mósíłkizhii ałchinígíí	Prionailurus bengalensis
Náshdóítʼą́ʼí łikizhígíí	Leptailurus serval
Tábąąh béégashii	Bubalus bubalis
Béégashiitsoh naʼałkǫ́ǫ́ʼígíí	Trichechus
Hastiin Leiw Éíwiksson	Leif Eriksson
Akágí yitsʼǫǫsii	Hirudinea
Anáʼálwoʼ:TʼAN (FAQ)	Ayuda:Preguntas frecuentes
Táłkááʼ tsʼin	Crocodylidae
Chidítsoh	Camión
Dlǫ́ʼiitsoh áłtsʼózígíí	Genetta
Gáagii	Corvus
Tó wónaanídę́ę́ʼ náshdóí	Lynx lynx
Jááłánii (bitsiitsʼiin nteelígíí)	Chilopoda
Giní	Falco
Dahiitį́hii	Trochilidae
Tsídii biyęęzhtsohígíí	Apteryx
Tązhii	Meleagris
Chʼosh (Bíígháán Ádaadinígíí)	Invertebrado
Gáagii naashchʼąąʼígíí	Coraciidae
Mąʼii	Canis latrans
Dah Naatʼaʼí Sǫʼ bił Sinil	The Star-Spangled Banner
Akʼah sisíʼí tsin	Eucalyptus
Mááya dinéʼiʼ	Pueblo maya
Gahtsoh	Lepus
Bisóodi bíchį́į́h nineezí	Orycteropus afer
Sonora Hahoodzo	Sonora
Nahakʼízii	Gryllidae
Chaaʼ	Castor
Chʼilzooł	Brassica oleracea italica
Kááʼtsʼiní	Dasypodidae
Atsʼiis naałdzid	Cáncer de pulmón
Yágháhoníkáángóó ałánátʼahí	Transbordador STS
Béésh náábałí atsiniltłʼish ííłʼínígíí	Aerogenerador
Méhigo tééh	Valle de México
Shą́ą́ʼnahalghałí (naaldeehii)	Hyracoidea
Nahatʼeʼiitsoh łichíiʼii	Macropus rufus
Azeeniłchin	Lamiaceae
Chʼał	Anura
Tsxilghááh	Caudata
Shádiʼááhdę́ę́ʼ atsátsoh	Harpia harpyja
Shádiʼááhdę́ę́ʼ chʼał kʼaasdáhígíí	Dendrobatidae
Chʼał niłtólí	Centrolenidae
Chʼał dichʼízhí	Bufonidae
Tónteel tsídiitsoh	Diomedeidae
Chidí nadlééh	Descapotable
Chʼał atʼąąʼ nahalinii	Megophryidae
Naashgalí	Mescalero
Bisóodi ałchiní	Sus scrofa
Naʼastsʼǫǫsí dóó Łéʼétsoh Danilínígíí	Muroidea
Mariner 10	Mariner 10
Sǫʼ łóóʼ bigaanézí	Ophiuroidea
Dághaałóóʼ	Siluriformes
Łóóʼtʼą́hí	Pleuronectiformes
Toohjįʼ ndiigaii	Egretta thula
Kʼaalógii bitseeʼ hólóní	Papilionidae
Mágí binááʼtsohígíí	Tarsius
Chiiłchin	Rhus aromatica
Ndoochííʼ	Pterospora andromedea
Tó wónaanídę́ę́ʼ dlǫ́ʼiiłkizhii	Vormela peregusna
Díłdánii	Odontophoridae
Táłtłʼááh łį́į́ʼ	Hippocampus
Łóóʼ bíígháántsiighąąʼ ádaadinígíí	Myxini
Béésh Sinil	Winslow (Arizona)
Achʼįʼ Náhiłtį́į́	Safford (Arizona)
Tó wónaanídę́ę́ʼ dzeeh	Cervus elaphus
Tsézhin Deezʼáhí	St. Johns (Arizona)
Béésh Bá Hooghan	Globe (Arizona)
Kinłání (Hoozdoh Hahoodzo)	Flagstaff
Michoacán Hahoodzo	Michoacán
Tʼiisyaakin	Holbrook (Arizona)
Naʼníʼá Hótsaa	Page (Arizona)
Táłtłʼááh chʼosh daadánígíí	Caridea
Mágíshzhin	Pan (animal)
Łóóʼntsxaaí łikizhígíí	Rhincodon typus
Dlǫ́ʼii yił Aheedaałtʼéhígíí	Herpestidae
Béésh Bichʼahníí Bikéyahdę́ę́ʼ ayání	Bison bonasus
Łóóʼtsoh bitsiiʼ dikʼání	Physeter macrocephalus
Waaʼ (dííshjį́ ááłjiní)	Spinacia oleracea
Néʼéshjaatsoh	Bubo virginianus
Shádiʼááhdę́ę́ʼ tłʼízíʼilí	Vicugna pacos
Chʼosh ditłʼooí	Oruga (larva)
Łóóʼ bigaan neeznání	Teuthida
Bijáád noodǫ́ǫzii	Okapia johnstoni
Méhigo Hahoodzo	Estado de México
Ayání	Bison bison
Mąʼiiłgaii	Alopex lagopus
Gólízhii Danilínígíí	Mephitidae
Táłtłʼááh adijiłii	Echinoidea
Nahachagii	Caelifera
Tsídiitsoh ditsʼozígíí	Dromaius novaehollandiae
Ałhaʼdeetʼaah	Contrato
Naayééʼ tsídii	Archaeopteryx
Tsísʼná (bitłʼizh ííłʼínígíí)	Apis (género)
Chééwokii dinéʼiʼ	Cheroqui
Tsin naaʼeeł hééł bee nágéhéʼ	Buque de carga
Ałtį́į́ jikʼáshí áłtsʼózígíí (chʼil)	Equisetum arvense
Yéigo ałhoshii	Gliridae
Naʼashjéʼii bijéí dah łichíiʼii	Latrodectus mactans
Mágí dághaaʼígíí	Saguinus imperator
Didzéłchííʼ	Ilex
Naałání	Comanche (etnia)
Oozéí / Ayahkinii	Hopi
Toohjįʼ noołnahiitsoh	Ardea goliath
Bidááʼ Haʼaztʼiʼ Tsékooh	Gran Cañón
Táłtłʼááh naʼashjéʼii	Argyroneta aquatica
Táłtłʼááh tsisteełtsoh	Dermochelys coriacea
Nahatʼeʼii	Dipodomys
Tsídii yáłtiʼí yázhí	Melopsittacus undulatus
Tábąąh mąʼii	Procyon lotor
Hołchʼíʼí	Urtica
Tsįdláád	Usnea
Dáághahii dinéʼiʼ	Pueblo francés
Shash łizhinígíí	Ursus americanus
Náshdóí bizaʼazis hólóní	Thylacinus cynocephalus
Shash bitéélgaígíí	Ursus thibetanus
Chʼoshtʼą́hí	Platyhelminthes
Hashtłʼish jeeshóóʼ	Gypaetus barbatus
Jádí bíchį́į́htsohígíí	Saiga tatarica
Táłtłʼááh chʼoshtsoh chʼééh digháhii	Holothuroidea
Tsísʼná bizǫ́ǫ́z ádinígíí	Meliponini
Chidí naatʼaʼí dilwoʼí	Avión de caza
Bíchį́į́h naatsʼǫǫdí	Tapirus
Tó wónaanídę́ę́ʼ mąʼii	Canis aureus
Chʼóshgai (tsin)	Picea glauca
Łóóʼ Bigaan Dahólónígíí	Cephalopoda
Naʼashǫ́ʼii łóóʼ	Anguilliformes
Dahbaʼ (tsin)	Fraxinus
Łóóʼ hashkéhétsoh	Carcharodon carcharias
Neeshchʼííłchííʼ	Castanea
Chį́į́hnézí nahatʼeʼígíí	Macroscelidea
Táłtłʼááh ayání	Dugong dugon
Dibé Diníí Bikéyahdę́ę́ʼ náshdóí	Lynx pardinus
Dził Ditłʼooí (Áshįįh Biiʼtó Hahoodzo)	Sierra de Abajo
Maadíséloo	Monticello (Utah)
Kʼaiʼ Bił Hahazteel	Kanab (Utah)
Toohjįʼ ndiigaiitsoh	Ardea alba
Wóóneeshchʼįįdii	Cicadidae
Dééshzhiin	Cygnus atratus
Naakaii náásééł	Mantodea
Dlǫ́ǫ́ʼ ntsxaaígíí	Hydrochoerus hydrochaeris
Mąʼii bijaaʼtsohí	Fennecus zerda
Dilchaʼ	Marmota
Náshdóí łibáhígíí	Lynx rufus
Chʼilhaatʼaʼii	Falco columbarius
Tééh hóyáaniitsoh	Delphinapterus leucas
Jádí bideeʼ yisdizígíí	Aepyceros melampus
Náátsʼózídę́ę́ʼ mąʼiiłchííʼ	Cuon alpinus
Łóóʼtsoh bighą́ą́ʼ yílkʼidígíí	Megaptera novaeangliae
Ghą́ą́ʼnaakiskʼidii	Camelus bactrianus
Tábąąh mąʼiiniiʼí	Nyctereutes procyonoides
Naʼazhǫǫsh (ndajiné dóó adazhdikaʼgi)	Casino de juego
Ndikʼąʼ	Gossypium hirsutum
Dlǫ́tʼą́ʼí	Suricata suricatta
Azeeʼ hókániitsoh (chʼil daadánígíí)	Cynara scolymus
Kéchwa dinéʼiʼ	Quechua (etnia)
Mąʼii bizaʼazis hólóní	Sarcophilus harrisii
Shash bítááʼłgaígíí	Tremarctos ornatus
Jádítsoh	Tragelaphus strepsiceros
Naatʼáanii Moctezuma II	Moctezuma Xocoyotzin
Biwooʼ Ádaałtsʼíísígíí	Pilosa
Ásáí dinéʼiʼ bikéyah	Mundo árabe
Shash yázhí	Helarctos malayanus
Shash ndilnaʼii	Melursus ursinus
Teeł	Typha
Chʼódeenínii	Picea pungens
Łéʼétsoh yiljaaʼí	Ranunculus
Hakʼaz náshdóí	Lynx canadensis
Mąʼii yił Ałhidanoolinígíí Yázhí	Procyonidae
Béésh Bichʼahii beʼakétłʼóól dijoolí	Brassica oleracea gongyloides
Nahooyéí (chʼil naʼatłʼoʼii)	Convolvulus
Tłʼoh waaʼí nahalinígíí	Trifolium repens
Tábąąstííntsoh dághaaʼígíí	Erignathus barbatus
Naakáí łizhiní	Cultura de África
Atʼééké bijish yázhí	Brassica oleracea var. gemmifera
Tsékooh	Cañón (geomorfología)
Noodah	Agave
Łeeʼdoolʼeezí	Orobanchaceae
Kinteel Bił Hahoodzo	Condado de San Juan (Nuevo México)
Beeʼeldííl Dahsinil Bił Hahoodzo	Condado de Bernalillo
Aniłtʼánii	Neuroptera
Kʼaalógii bijáád dį́įʼii	Nymphalidae
Nímasii yiyání	Leptinotarsa decemlineata
Awééʼchíʼí (chʼil)	Campanula
Taʼaghálii	Astragalus
Naaʼołí yiltʼąąʼí	Lathyrus
Azeeʼ ndootʼeezhí łibáhígíí	Marrubium vulgare
Hastóí tsiiyéélí	Clematis
Chʼilátah atsʼos	Epilobium
Kʼish	Alnus incana
Dééłjáád	Rumex crispus
Shį́náldzidí (chʼil bilátah hózhóón)	Antirrhinum
Kʼįįʼ	Rhus
Naaztání	Gleditsia triacanthos
Táłkááʼbéésh	Sagittaria
Tsinyaa tłʼoh	Poa
Tłʼééʼ yiigáhii	Oenothera
Tłʼoh deeskʼidí	Amaranthus retroflexus
Ndootʼeezhí	Monarda
Wóóseekʼidii	Sphingidae
Dzílí bíláshgaan	Erodium cicutarium
Díkʼǫ́ǫ́zhí (chʼil)	Atriplex
Tʼąąʼdoolghasí	Argentina anserina
Teełikaní	Triglochin maritima
Láʼashdlaʼ	Parthenocissus quinquefolia
Tséghániłchʼi	Portulaca oleracea
Zééʼiilwoʼii	Alopecurus
Chéchʼil ntłʼizí yiltʼąąʼí	Berberis aquifolium
Tólchiintsoh	Stachys palustris
Tséyaa hataałí	Brassica napobrassica
Tłʼohtsʼózí	Juncus
Tłʼoh dichʼíízh	Carex
Shashdą́ą́ʼ	Berberis
Tłʼoh waaʼítsoh	Melilotus albus
Díkʼǫ́ǫ́zhí yiltʼąąʼí	Chenopodium album
Bįįh yildeeʼí	Physalis
Kʼaalógii bitʼaʼ ndikʼąʼ nahalinígíí	Lycaenidae
Hosh niteelí	Opuntia
Teeł bitʼąąʼłánígíí	Scirpus
Chʼał nineezí	Lithobates catesbeianus
Tééh hóyáanii bíchį́į́htsahí	Monodon monoceros
Mágí bíchį́į́htsohígíí	Papio
Bįįh łikizhígíí (Béésh Bichʼahníí Bikéyahdę́ę́ʼígíí)	Dama dama
Tábąąh ayání	Syncerus caffer
Nátʼostsoh	Verbascum thapsus
Teeł náyizí	Juncus balticus
Tólchiin (chʼil)	Mentha arvensis
Dibé diníí dinéʼiʼ	Pueblo español
Táłkááʼ dah yikał	Nasturtium
Binaʼadaałtzózí	Pueblo japonés
Kʼįįshzhíní	Prunus virginiana
Chʼil awoshí	Salsola kali
Chʼil naamaasii	Amaranthus albus
Naʼashjéʼiichʼil	Androsace septentrionalis
Ahaditʼáán	Rumex maritimus
Yéʼiibeʼetsʼos	Bromus tectorum
Kʼaiʼ łichíʼii	Cornus sericea
Naazkaadí	Amaranthus blitoides
Tsáʼásziʼ nteelí	Yucca gloriosa
Ostseʼ yiltʼąąʼí	Sisymbrium sophia
Azeediilchʼílii	Lupinus angustifolius
Toohjįʼhotso (chʼil)	Heliotropium curassavicum
Bikétłʼóól názbąs	Epilobium ciliatum
Dzidzé ditʼódí	Amelanchier alnifolia
Gad yił aheełtʼéhígíí	Tamarix
Łóóʼ bíchį́į́h nineezí	Xiphias gladius
Łį́į́ʼ Ndahalinígíí	Equidae
Binááʼ Ádaałtsʼózí bichʼil łigaií	Brassica rapa pekinensis
Azeedíchʼííʼ	Chile (pimiento)
Kolíya Tááʼ Bikéyahą́ą	Tres Reinos de Corea
Iiʼnótʼį́į́	Infección
Chʼah Diʼilii Bikéyahdę́ę́ʼ mósí ałchinígíí	Otocolobus manul
Tááʼyaʼniiltʼóshiiłbáhígíí	Cardinalis sinuatus
Jááłánii (bikágí ntłʼizígíí)	Diplopoda
Iichʼąhii ntsxaaígíí	Attacus atlas
Łóóʼ ńdídzihígíí	Dipnoi
Chʼíshiibeezhii	Paridae
Giní jáádnézí	Sagittarius serpentarius
Hakʼaz néʼéshjaaʼ	Bubo scandiacus
Shádiʼááhdę́ę́ʼ jeeshóóʼ	Vultur gryphus
Chidí naatʼaʼítsoh beeʼeldǫǫh bikǫʼ neiyéhé	Bombardero
Shash bighą́ąʼgi hadzíbáhí	Ursus arctos horribilis
Kǫʼ naʼałbąąsii	Locomotora de vapor
Ndíyíliitsoh	Helianthus annuus
Naaʼahóóhaiłkizhígíí	Numididae
Tłʼiish yighání	Mellivora capensis
Dadilhóni aheltłʼidígíí	Granada de mano
Naakaii Łizhiní Bikéyahdę́ę́ʼ łééchąąʼí ałchiní	Lycaon pictus
Aniłtʼánii (tʼááłaʼajínígoʼígíí)	Ephemeroptera
Ayánítsoh bighą́ą́ʼaskʼidígíí	Bos gaurus
Niinahnízaad	Nenahnezad (Nuevo México)
Máaz yikááʼ nandahí Spirit	Spirit
Naʼníʼá Hótsaadi atsiniltłʼish bá hooghan	Navajo Generating Station
Hakʼaz giníłgaii	Falco rusticolus
Tsétah jeeshóóʼ łibáhí	Gyps fulvus
Tééh łééchąąʼí łikizhígíí	Crocuta crocuta
Tłʼízí ałchiní	Capra aegagrus
Yaaʼ dóó chʼosh bíchį́į́h dadichʼízhí	Acanthocephala
Beeʼeldǫǫh	Mosquete
Chʼosh bitsʼaʼígíí bigaan dahólónígíí	Brachiopoda
Tʼąąʼdoolghasí (daadánígíí)	Cichorium endivia
Dlǫ́ʼii (bílaʼashdlaʼii bilį́į́ʼ)	Mustela putorius furo
Łóóʼtsoh łibáhígíí	Eschrichtius robustus
Chʼah Diʼilii Bikéyahdę́ę́ʼ atsátsoh	Aquila nipalensis
Yiisnááh	Prisionero de guerra
Dzeeh	Cervus canadensis
Tsinlátahgi tsídii nahatʼeʼígíí	Coliidae
Nátʼoh (chʼil)	Nicotiana tabacum
Tsé Nitsaa Deezʼáhí	Rock Point (Arizona)
Tsin naaʼeeł bee daʼahijighánígíí	Acorazado
Tsísʼná yiyání	Meropidae
Bisóodi bizęęs dį́įʼii	Phacochoerus africanus
Dlǫ́ʼiitsoh naalzheehígíí	Cryptoprocta ferox
Nahachagii biyázhí	Aphidoidea
Naalkʼįhiitsoh	Dermoptera
Łóóʼ naatʼaʼí	Exocoetidae
Hakʼaz ayání	Ovibos moschatus
Tsétah gah	Ochotona
Mąʼiitsoh bikʼos bineʼdę́ę́ʼ łizhinígíí	Chrysocyon brachyurus
Iichʼąhiitsʼósí	Trichoptera
Kéyah Dańlínídę́ę́ʼ atsátsoh	Pithecophaga jefferyi
Tábąąstííntsoh bíchį́į́htsohígíí	Mirounga
Łóóʼntsxaaí díníchʼahii	Cetorhinus maximus
Chʼosh yighání	Proteles cristata
Mágí bitseeʼ noodǫ́zígíí	Lemur catta
Táyiʼ chʼoshnézí	Nemertea
Dlǫ́tsʼósí łibáhígíí	Mungotictis decemlineata
Tó naagoʼ	Gota de agua
Dlǫ́ʼiitsoh Danilínígíí	Viverridae
Mágí bigaanézí	Hylobatidae
Bílaneezii	Daubentonia madagascariensis
Séí mąʼii	Vulpes corsac
Naalʼeełítsoh bitéél halchíʼí	Branta ruficollis
Tłʼízí bideeʼ yisdizígíí	Capra falconeri
Jádí	Antilocapra americana
Wónikǫsí	Phasmatodea
Łóóʼ biyaatsʼiin ádaadinígíí	Hyperoartia
Tééh łééchąąʼí noodǫ́zígíí	Hyaena hyaena
Tsídiiłchxoní	Opisthocomus hoazin
Táłtłʼááh chʼoshtʼą́hí bikááʼtsʼinígíí	Polyplacophora
Mąʼii bighą́ąʼgi hadzíjiní	Canis mesomelas
Naakaii Łizhiní Bikéyahdę́ę́ʼ mąʼiiłchííʼ	Canis simensis
Tsétah dibé	Ovis canadensis
Dibé dóó Tłʼízí Ndahalinígíí	Caprinae
Mágí bíchį́į́h dootłʼizhígíí	Mandrillus sphinx
Tó wónaanídę́ę́ʼ dibé ałchiní	Ovis orientalis orientalis
Tsiighájíłchí	Cuscuta
Bįįhyázhí biwooʼnézí	Moschus moschiferus
Dzeeh łikizhígíí	Cervus nippon
Tábąąh mósí ałchiní	Prionailurus viverrinus
Chį́į́h yee achʼiishíhii	Pristiformes
Shádiʼááhdę́ę́ʼ hodíłchʼil mąʼii	Speothos venaticus
Hakʼaz mágí	Macaca fuscata
Tsé Biiʼ Ndzisgaii	Valle de los Monumentos
Mágí bíchį́į́h niilyoolígíí	Nasalis larvatus
Shádiʼááhdę́ę́ʼ tsídiitsoh	Rhea americana
Dáádílí łibáhígí	Epinephelus marginatus
Náátsʼózídę́ę́ʼ mósíłtsxooí ałchinígíí	Catopuma temminckii
Łóóʼnteeltsoh	Mola mola
Gaanłáníchilí dóó Gaanłání doo yitʼíinii	Hydra (animal)
Atłʼóóh	Tejeduría
Chʼoshkʼaaʼ	Chaetognatha
Tábąąh bįįh	Hydropotes inermis
Hodíłchʼil jeeshóóʼ	Sarcoramphus papa
Dlǫ́ǫ́ʼ bitseetłʼooígíí	Chinchilla (animal)
Néʼéshjaaʼ bíńdáhii	Surnia ulula
Bitseeʼ yee adiłhałii	Alligator mississippiensis
Jádítsoh noodǫ́zígíí	Tragelaphus eurycerus
Níyolgi naatʼaʼígíí (tónteel tsídii)	Hydrobatidae
Tádídíín yiyání	Chrysomelidae
Tsídiidaashiyishí	Threskiornithinae
Yílnoodii (łóóʼ)	Sphyraena
Shádiʼááhdę́ę́ʼ łéʼétsoh bitseeʼ ádinígíí	Dasyprocta
Chʼosh bitsʼaʼłáaʼii	Monoplacophora
Naʼashǫ́ʼii łóóʼ hashkéhé	Chlamydoselachus anguineus
Jeeshóóʼ	Gymnogyps californianus
Táłkááʼ chʼó	Berula erecta
Chʼosh dilwoʼígíí	Cicindelinae
Chʼosh doo yitʼíinii bee nílʼíní	Microscopio
Tsin ditʼinii	Spermophilus
Joogii	Cyanocitta cristata
Náátsʼózídę́ę́ʼ naalʼeełí	Aix galericulata
Mąʼii bijaaʼabanígíí	Otocyon megalotis
Yéʼii bitsáʼásziʼ	Yucca elata
Tsídiitsoh bikʼos dootłʼizhí	Casuarius
Atsiniltłʼish ííłʼíinii (naʼashǫ́ʼii łóóʼ)	Electrophorus electricus
Dįʼ	Tetraoninae
Łeeyiʼ tłʼiish áłtsʼíísígíí	Scolecophidia
Niicháadii (łóóʼ)	Tetraodontidae
Tééhoołtsódiichilí	Choeropsis liberiensis
Kʼiiznoodǫ́ǫzii (tsin yigházhígíí)	Cuniculus
Wóláchííʼ yildeełítsoh	Myrmecophaga tridactyla
Dibéʼniiʼí	Sayornis saya
Níłtsą́goʼ (bideeneezígíí)	Cerambycidae
Tséʼédǫ́ʼii bitsiinézí	Mecoptera
Tłʼohtahgi díłdánii yił aheełtʼéhii	Turnicidae
Łóóʼyiniʼįįhí (tónteel tsídii)	Stercorariidae
Shádiʼááhdę́ę́ʼ tó hóyáanii	Inia geoffrensis
Naʼashǫ́ʼiitsoh	Iguana (género)
Binaʼadaałtsózí dinéʼi	Oriente
Łóóʼ adishishí	Dasyatidae
Tsin yąąh dzootʼihí	Sittidae
Atʼaʼ yiltʼąąʼí dah sidáhígíí (chʼosh ntsxaaígíí)	Birgus latro
Yółeehii	Lophiiformes
Tiníléí	Heloderma suspectum
Dijádídlǫ́ʼí	Eremophila alpestris
Tłʼoh	Césped
Dinas	Arctostaphylos uva-ursi
Mąʼii bikʼiizgi hadzíjiní	Canis adustus
Yadiizį́įgo ayání	Litocranius walleri
Télii bijáád noodǫ́zí	Equus africanus
Bitsʼáá bidaʼhodiʼniil	Tierra quemada
Mágíłchííʼ	Leontopithecus rosalia
Dááʼadeeʼii	Plateinae
Łóóʼ hashkéhé bitsiiʼ dikʼání	Sphyrnidae
Taahilnoodii	Sulidae
Kʼíneedlíshii adiłhashígíí	Lucanidae
Łééh yidi tóʼígíí	Capa freática
Naʼashǫ́ʼiitsoh naʼałkǫ́ʼígíí	Amblyrhynchus cristatus
Tsídiisháshii	Bombycillidae
Naakétłʼáhí	Pueblo pima
Yaaʼ bitsʼaʼígíí	Coccoidea
Daateel	Cochlearius cochlearius
Tééh łééchąąʼí ditsʼozígíí	Hyaena brunnea
Tsétaʼ łį́į́ʼ	Mustang (caballo)
Kénézí	Jacanidae
Neeshchʼííʼ	Piñón
Naalʼeełítsoh yił aheełtʼéhii łizhin dóó łigaiígíí	Anseranas semipalmata
Mąʼii chʼil	Solidago
Tsídii disxǫsígíí	Galbulidae
Náátsʼózídę́ę́ʼ mósíłchíiʼii ałchinígíí	Pardofelis badia
Shádiʼááhdę́ę́ʼ tsétah mósí ałchinígíí	Leopardus jacobitus
Tsinlátahgi dlǫ́ʼiitsoh	Arctictis binturong
Jeeshóóʼ łizhinígíí	Coragyps atratus
Naałʼashí	Theraphosidae
Dééłdą́ą́ʼ	Pteridium aquilinum
Hashkʼaan yildeełígíí (tsídii)	Musophagidae
Łį́į́chilí	Poni de las Shetland
Daakʼį́į́ʼ	Numenius
Mąʼiiłtsooí łibáhígíí	Urocyon cinereoargenteus
Naʼashǫ́ʼiitsoh dootłʼizhígíí	Iguana iguana
Chidí bikéíjį́ʼ adeizʼááhígíí	Pickup
Bįįh bitseełgaiígíí	Odocoileus virginianus
Wónitłʼizí	Oniscidea
Díʼdikii (jádí)	Madoqua
Hakʼaz mąʼiitsoh	Canis lupus arctos
Dark Ages	Años oscuros
Ndikʼąʼ biyaʼ	Anthonomus grandis
Tłʼoh naadą́ą́ʼ biyaʼ	Sitophilus granarius
Łeeyiʼ jááłániichilí	Pauropoda
Aniłtʼánii (bikʼosnézí)	Raphidioptera
Naaʼołí biyaʼ	Bruchinae
Ááhooshtʼįįh	Capitulación (rendición)
Tséʼédǫ́ʼii dishooí	Syrphidae
Tééh tsisteeł	Chelonioidea
Bichʼah Dootłʼizhii	Fuerzas de paz de las Naciones Unidas
Dlǫ́ʼii łizhin dóó łitsooígíí	Martes flavigula
Chʼosh ałchozhii (chéłchaaʼ)	Dermestidae
Łeʼesoołii (bitseeʼ naakiígíí)	Diplura
Dlǫ́ʼátsoh	Marmota monax
Chʼééh digháhii dóó Tsisteeł	Testudines
Tááʼyaʼniiltʼóshii	Cardinalidae
Łóóʼ bigaanłánígo bitsʼaʼígíí	Nautilina
Łeʼesoołii (bitseeʼ tááʼígíí)	Thysanura
Tłʼézhii	Tabanidae
Tániilʼáítsʼóóz	Zygoptera
Naashtʼézhí	Zuñi
Aniłtʼániitsʼóóz	Myrmeleontidae
Tó wónaanídę́ę́ʼ hazéí bíchį́į́hnézí	Scandentia
Hakʼaz gah	Lepus arcticus
Bįįh łikizhígíí (Naakaii Dootłʼizhii Bikéyahdę́ę́ʼígíí)	Axis axis
Nahashchʼidí (naaldeehii)	Taxidea taxus
Bisóodi bideeʼ názhahígíí	Babyrousa
Tsídii bichʼahtsooígíí	Buceros bicornis
Shádiʼááhdę́ę́ʼ bisóodi diʼilígíí	Tayassuidae
Náʼagéédí bizaʼazis hólóní	Notoryctidae
Bilagáana	Blanco (persona)
Tłʼézhiiłbáhí	Tachinidae
Shash nátʼoh	Tribulus terrestris
Jádítsoh diłhiłígíí	Tragelaphus angasii
Jádítsoh bideeʼ shiyishígíí	Hippotragus niger
Dlǫ́ʼiitsoh łikizhígíí	Civettictis civetta
Tsinaʼayąʼii yildeełí	Myrmecobius fasciatus
Tsétah tłʼízí	Oreamnos americanus
Jááłániichilí bighádzígaiígíí	Symphyla
Gahchilí	Brachylagus idahoensis
Tsiishgaii	Sitta pygmaea
Cháʼoł bidahtsʼaaʼ	Arceuthobium
Dééłgai bitsiiʼ halzhinígíí	Cygnus melancoryphus
Chʼosh nahachagii	Cicadellidae
Hóółtseiigi naʼastsʼǫǫsí	Gerbillinae
Gaanłání	Ceriantharia
Dibédą́ą́ʼ	Shepherdia
Laanaa Yáʼátʼéehgo Késhmish	We Wish You a Merry Christmas
Naʼazǫ́ǫzii	Mutillidae
Jáád neishoodí (naʼashjéʼii haalzheehígíí)	Pompilidae
Naalʼeełí bidaatsʼózí	Mergus
Naalʼeełí łizhinígíí	Melanitta
Nahatʼeʼiitsoh Bikéyahdę́ę́ʼ naalʼeełítsoh łibáhígíí	Cereopsis novaehollandiae
Dahsánítsoh	Hystrix cristata
Naʼastsʼǫǫsí bitseeʼ dichʼízhí	Acomys
Tsétah nahatʼeʼiitsoh	Petrogale
Akáshtʼóózh biyaʼ	Psocoptera
Łeʼesoołii (bideeʼ ádinígíí)	Protura
Ąąʼąʼii	Pica (género)
Jádí bideeʼ dį́įʼii	Tetracerus quadricornis
Táłtłʼááh chʼosh ntsxaaígíí	Macrocheira kaempferi
Mósí ałchiní bitsiiʼtʼąhígíí	Prionailurus planiceps
Naakaii Łizhiní Bikéyahdę́ę́ʼ naalʼeełítsoh dibéłchíʼígíí	Alopochen aegyptiaca
Hosh aditsahiitsoh	Carnegiea gigantea
Tʼáá łichíʼígo náʼagéédí	Heterocephalus glaber
Tsisteeł łizhinígíí	Chelonoidis carbonaria
Tééh jeeshóóʼ	Gyps africanus
Atʼąąʼ nahalinii	Phylliidae
Ghą́ą́ʼnoodǫ́ǫzii (tsin yigházhígíí)	Dinomys branickii
Tsáʼásziʼ bideeʼí	Yucca baccata
Łéʼétsoh beeniʼíhoniitaahígíí	Cavia
Naʼashǫ́ʼii dichʼízhii	Phrynosoma
Chéłchaaʼ bikʼosnézí	Trachelophorus giraffa
Ásaaʼ neiyéhii	Meloidae
Naʼashǫ́ʼiitsoh łitsooígíí	Conolophus subcristatus
Shádiʼááhdę́ę́ʼ tiníléí	Heloderma horridum
Sahdii Bisí (Tsé Nástánii)	Parque nacional del Bosque Petrificado
Tsé Bighánílíní	Cañón del Antílope
Naakaii Dootłʼizhii bimósí ałchinígíí	Prionailurus rubiginosus
Naʼashǫ́ʼiiłchííʼ dootłʼizhígíí	Agama mwanzae
Kʼaabizhii	Mammillaria
Dahiitį́hídą́ą́ʼtsoh	Castilleja
Dlǫ́ʼbéʼézhóóʼ	Aristida
Chʼil abeʼéntsxaaí	Asclepias tuberosa
Jádí yildeeʼí	Asclepias asperula
Ndilkal (chʼil)	Cucurbita foetidissima
Chʼįdą́ą́ʼ	Ceanothus
Dlǫ́ʼii nátʼoh	Nicotiana attenuata
Jáád neishoodí (łeyiʼdi bighanígíí)	Avispa excavadora
Dáʼághálii	Crotalaria
Chʼil abeʼétsoh	Asclepias speciosa
Chʼał bikʼos ádinígíí	Nasikabatrachus sahyadrensis
Jéí náyoogisii	Echinocereus
Tłʼiish bideeʼtsʼóóz	Asclepias verticillata
Tłʼohtah náshdóí	Leopardus pajeros
Tsídii naʼałkǫ́ʼígíí	Fratercula
Tsisteeł diyogí	Chelus fimbriatus
Haʼagizh	Abiquiú
Łóóʼ adishishí ntsxaaígíí	Manta birostris
Tónteel bibąąh hóyáanii	Neophocaena phocaenoides
Naakaii Łizhiní Bikéyahdę́ę́ʼ tsétah dibé	Ammotragus lervia
Náhookǫsdę́ę́ʼ dlǫ́ʼii	Martes americana
Naalʼeełí naashchʼąąʼígíí	Aix sponsa
Tsinlátah nahatʼeʼiitsoh	Dendrolagus
Tsin naaʼeeł łóó beeʼháʼhaalʼééłiʼ	Arrastrero
Chʼosh biyaʼ	Strepsiptera
Táłtłʼááh chʼosh	Dytiscidae
Gáagii dinéʼiʼ	Crow
Shádiʼááhdę́ę́ʼ tábąąstííntsoh	Otaria flavescens
Táłtłʼááh álééh	Ardea herodias
Tsísʼnáłtsooítsoh	Vespa
Táłtłʼááh naakaii náásééł yił aheełtʼéhii	Stomatopoda
Náátsʼózídę́ę́ʼ tsiiłtsooí	Chrysolophus pictus
Bisóodi Danilínígíí	Suina
Atsiniltłʼish yiltʼąąʼí	Sambucus cerulea
Gólízhii noodǫ́zígíí	Mephitis mephitis
Tsinlátah naʼashǫ́ʼiitsoh	Iguana delicatissima
Tó bichʼosh (séigoʼ nahalinígíí)	Nepa cinerea
Naʼastsʼǫǫsí bijaaʼntsxaaígíí	Macrotis lagotis
Tsʼání	Gymnorhinus cyanocephalus
Chʼééh digháhii bitsʼaʼ yilzhólí	Trionychidae
Tó Hajiilneehé	Reserva India de Cañoncito
Chį́į́shghą́ʼiiłgaii	Sitta carolinensis
Hastiin Diego de Landa	Diego de Landa
Hastiin Biʼééʼ Łichíiʼii	Kit Carson
Tábąąstííntsoh (Akééháshį́į́dę́ę́ʼígíí)	Zalophus californianus
Mósí bizaʼazis hólóní	Dasyurus
Tségad	Selaginellaceae
Tsįyaalzhahí	Accipiter striatus
Hashtłʼishdi chʼééh digháhii	Kinosternidae
Yaaʼ nahachagiígíí	Siphonaptera
Kéʼ łizhiní	Pies negros
Tábąąsdísí áłtsʼíísí	Actitis macularius
Náátsʼózídę́ę́ʼ toohjįʼ ndiigaii	Egretta eulophotes
Łóóʼtsoh (Ałtsʼáʼáztiin)	Ballena (desambiguación)
Dlǫ́ʼii łizhiní	Mustela nigripes
Wóláchííʼ yildeełí łizhin dóó łigaígíí	Tamandua
Lókʼaatah bisóodi	Potamochoerus larvatus
Hodíłchʼil tłʼízí	Capricornis sumatraensis
Hakʼaz Dineʼé Bikéyahdę́ę́ʼ tábąąstííntsoh	Eumetopias jubatus
Dziłtah dlǫ́ʼii	Mustela altaica
Naayééʼ tsídiitsoh	Dinornithidae
Aghaałą́	Pico El Capitán
Atseełtsoii	Buteo jamaicensis
Tóniłhę́ęshii (dééł)	Grus americana
Naaltsoos Mormon Wolyéhígíí	Libro de Mormón
Téél halchíʼí	Turdus migratorius
Dlǫ́ʼátah néʼéshjaaʼ	Athene cunicularia
Naʼashǫ́ʼii bijáád ádinígíí	Amphisbaenia
Dził Ashdlaʼii	Sierra de La Sal (Colorado)
Naʼatłʼoʼii (chʼosh)	Embioptera
Dííłdzid yiyání	Staphylinidae
Kʼiishzhinii (tsin)	Carpinus caroliniana
Tʼiisbáí	Populus tremuloides
Yáhashjool yázhí	Ixobrychus exilis
Tłʼéeʼgo mágí	Aotus
Náʼagéédíchilí	Neurotrichus gibbsii
Tsʼíʼii jáádnézí	Tipulidae
Chʼil ditsʼozíłchííʼ	Nephelium lappaceum
Mágíłtsooí bináázhiní	Saimiri sciureus
Tsídiiłtsooí bitʼaʼ łizhinígíí	Carduelis tristis
Tsʼíʼii noodǫ́zí	Aedes albopictus
Bitseeʼ yee adiłhałii yázhí	Caimaninae
Anaasází	Anasazi
Chʼééh digháhiitsoh	Chelonoidis nigra
Tsineeshbízhii	Certhia americana
Yeenaʼałkǫ́ʼíłániichilí	Remipedia
Naʼnízhoozhí Bił Hahoodzo	Condado de McKinley
Mąʼii Deeshgiizh Bił Hahoodzo	Condado de Sandoval
Naatoohí Bił Hahoodzo	Condado de Cíbola
Tábąąstííntsoh łikizhígíí	Phoca largha
Ooljééʼ yiikááʼ nandahí	Alunizaje
Toohjįʼ noołnahii yázhí	Butorides virescens
Báshdo	Barstow (California)
Łóóʼ hashkéhé bíchį́į́hnézí	Mitsukurina owstoni
Tłʼiishtsiiʼí (łóóʼ)	Channidae
Chéłchaaʼ bideeneezígíí	Dynastes hercules
Déłí	Grus canadensis
Ąąʼąʼiiłbáhí	Cyanopica cyanus
Tsétah chaaʼ	Aplodontia rufa
Sighóla	Socorro (Nuevo México)
Chéłchaaʼ disxǫsígíí	Buprestidae
Naalʼeełí dootłʼizhí	Anas discors
Béíyózhin	Paiute
Tó Hasłeeh	Mancos (Colorado)
Dlǫ́tsʼósí łichííʼígíí	Galidia elegans
2010 yihahígíí bílaʼashdlaʼii náóltahígíí	Censo de los Estados Unidos de 2010
Jádídlǫ́ʼii	Troglodytes aedon
Yaayááhalzhiin	Amphispiza bilineata
Tłʼohchintó	Hotevilla-Bacavi
Tséʼédǫ́ʼii	Muscidae
Chʼagiitsoh	Xanthocephalus xanthocephalus
Dahsání dah Yikahjí Tsin Deigházhígíí	Hystricomorpha
Gad niʼeełí	Juniperus scopulorum
Níyolgi naʼałkǫ́ʼígíí (tónteel tsídii)	Pelecanoides
Tsinaʼayąʼii biyázhí	Zoraptera
Sóól dichʼíizhii	Acer glabrum
Łichííʼ Deezʼáhí	Sanders (Arizona)
Tseekʼi nástánii	Ammospermophilus
Tłʼízíʼilí	Cabra de Angora
Naatooh Sikʼaiʼí	Grants
Tsinaʼayąʼii	Isoptera
Náʼagéédí bíchį́į́h sǫʼ nahalinígíí	Condylura cristata
Naaléełchííʼ	Rhynchopsitta pachyrhyncha
Naaʼahóóhai disxǫsígíí	Lophophorus
Tsįyaatsiiłchííʼ	Pyrocephalus rubinus
Náhookǫsdę́ę́ʼ tsétah dibé	Ovis dalli
Níłtsą́goʼ łichííʼígíí (chʼil abeʼé bichʼosh)	Tetraopes tetraophtalmus
Naʼnízhoozhí	Gallup
Neeshchʼíínímazí	Avellana
Łóóʼ binááʼtsohí	Priacanthidae
Tsisteeł bikʼosneezígíí	Chelidae
Chʼilzhóóʼ (chʼil)	Artemisia cana
Naatsisʼáán bińdíshchííʼ	Pinus flexilis
Chąąneiłhizii	Histeridae
Tʼáyaałtso	Colaptes chrysoides
Nákʼeʼnáʼijiní	Sitta canadensis
Ałtaʼneetsʼéhii	Xanthium
Wáláchíʼétah nahachagiichilí	Myrmecophilidae
Yáhashjool yił aheełtʼéhii	Eurypyga helias
Tsintah bisóoditsoh	Hylochoerus meinertzhageni
Zééjíjinii	Chauna torquata
Tóikałí	Artemisia frigida
Naʼashǫ́ʼii hááʼáchʼiidí	Gambelia (animal)
Naʼníʼá Hayázhí	Cameron (Arizona)
Kááʼtsʼiní ditłʼooígíí	Chaetophractus
Gahtsohdą́ą́ʼ	Krascheninnikovia lanata
Naalkʼįhíchilí (bizaʼazis hólónígíí)	Acrobates pygmaeus
Dlǫ́ʼii yił aheełtʼéhii łibáhígíí	Herpestes edwardsii
Łóóʼ hashkéhé bitseeneezígíí	Alopias vulpinus
Chį́į́shłigaií dóó Naalʼeełítsoh	Anserinae
Jádí biniiʼtsʼózí	Alcelaphus buselaphus
Tábąąh jádí	Kobus ellipsiprymnus
Jádí binááʼ dį́įʼii	Beatragus hunteri
Tó wónaanídę́ę́ʼ dlǫ́ʼáyázhí	Spermophilus citellus
Ásáí Dineʼé Bikéyahdę́ę́ʼ mąʼiitsoh	Canis lupus arabs
Dlǫ́iitsoh bíchį́į́hdzísgaiígíí	Paguma larvata
Aniłtʼánii yázhí	Psyllidae
Chʼał mágí nahalinii	Phyllomedusa sauvagii
Sǫʼ tsisteeł	Geochelone radiata
Nahatʼeʼiitsoh Bikéyahdę́ę́ʼ tązhii	Alectura lathami
Mąʼii dootłʼizhí	Bassariscus astutus
Łeʼesoołii (nahachaʼígíí)	Archaeognatha
Tóidoozohii bidaaʼ łigaiígíí	Fulica
Chéłchaaʼtsoh	Escarabajo rinoceronte
Kʼaalógiitsoh disxǫsígíí	Morpho
Tsisteeł hashkéhé	Chelydridae
Tsilhazésii	Myiarchus cinerascens
Naʼastsʼǫǫsí bizaʼazis hólóní	Antechinus
Tsídiidą́ą́ʼ	Phlox
Wóniłchxoní	Pentatomidae
Tsiikʼánii (tsídii)	Scopus umbretta
Nahatʼeʼii niłchxoní	Hypsiprymnodon moschatus
Náátsʼózídę́ę́ʼ tsiidootłʼizhii	Argusianus argus
Ábishjaaʼ (daadánígíí)	Seta comestible
Tábąąh bisóodiłchíiʼii	Potamochoerus porcus
Kéyah Dańlínídę́ę́ʼ naalʼeełí	Anas luzonica
Tiníléítsoh naʼałkǫ́ʼígíí	Varanus salvator
Kézhoozhʼilí (tsin yigházhígíí)	Ctenodactylidae
Jádí bideeneezígíí	Oryx
Beehai	Jicarilla
Dáádílí łikizhígíí	Chromileptes altivelis
Tsísʼná náʼagéédígíí	Anthophorini
Mágíłbáhí	Cercopithecus mitis
Jaaʼditłʼoʼí naalkʼįhígíí (bizaʼazis hólónígíí)	Petauroides volans
Nahatʼeʼiitsoh yázhí	Thylogale
Tóshchíín / Naadą́ą́ʼ dootłʼizhí	Gruel
Sisnaajiní	Pico Blanca
Dlǫ́ʼii yił aheełtʼéhítsʼózí	Galerella sanguinea
Tółání	Laguna (Nuevo México)
Łóóʼ bigháhootʼíní	Ambassidae
Tónhidigaii	Silverton (Colorado)
Chʼosh áłtʼą́ą́ʼígíí	Lygaeidae
Dééłtsoh	Ardeotis kori
Shádiʼááhdę́ę́ʼ dahsání	Coendou prehensilis
Nahatʼeʼiitsoh Danilínígíí	Macropodiformes
Dlǫ́ʼii bitseenézí	Mustela frenata
Tsénáhádzoh	Twin Lakes (Nuevo México)
Kéyahígíí nidineesdzaʼ	Dust Bowl
Nahachagii dootłʼizhí	Tettigoniidae
Tsé Bíyah Aniiʼáhí	Cañón del Chaco
Nahatʼeʼiitsoh Bikéyahdę́ę́ʼ biyázhí neiyéhé	Trichosurus vulpecula
Naaʼahóóhaiłbáhí	Perdix
Tsísʼnádą́ą́ʼ	Gaillardia
Jeeshóóʼ ałchozhígíí	Gypohierax angolensis
Dlǫ́ʼii yił aheełtʼéhii łitsxooígíí	Cynictis penicillata
Naakaii Łizhiní Bikéyahdę́ę́ʼ nahatʼeʼii	Pedetes capensis
Táłtłʼááh chʼosh chʼééh digháhii bitsʼaʼ ádinígíí	Nudibranchia
Tiníléítsoh noodǫ́zígíí	Varanus niloticus
Naʼashǫ́ʼii bideewozhii	Uromastyx
Chʼał ntsxaaígíí	Conraua goliath
Tééh naaʼahóóhaitʼą́ʼí	Francolinus
Naalʼeełí (bílaʼashdlaʼii bilį́į́ʼ)	Anas platyrhynchos domesticus
Yáhashjool	Botaurus lentiginosus
Dlǫ́ʼii yił aheełtʼéhii yázhí	Helogale parvula
Halchíítah (Áshįįh Biiʼtó Hahoodzo)	Halchita
Nahatʼeʼiitsoh Bikéyahdę́ę́ʼ tábąąstííntsoh	Neophoca cinerea
Mąʼiiłtsooí yázhí	Vulpes macrotis
Gałbáhí	Sylvilagus
Naʼazísí Toʼí	Cuba (Nuevo México)
Tsékááʼgóó naagháhii (chʼosh)	Mantophasmatodea
Tłʼohtahilzhahí	Cariamidae
Táłtłʼááh tsxilghááhtsoh	Cryptobranchidae
Dibé dághaaʼígíí	Capricornis crispus
Chʼééh digháhii bitsiiʼntsxaaígíí	Platysternon megacephalum
Tsékʼi naʼałkǫ́ʼii	Galemys pyrenaicus
Kéyah Dańlínídę́ę́ʼ dzeeh dóó bįįh	Rusa (género)
Naʼastsʼǫǫsítsoh (chʼosh yildeełígíí)	Solenodon paradoxus
Tsídiiłtsooí	Setophaga petechia
Chʼagii	Agelaius phoeniceus
Łéʼétsoh diwozhí	Echinosorex gymnura
Łéʼétsoh bizaʼazis hólóní	Dasyuroides byrnei
Dlǫ́ʼiitsoh noodǫ́zígíí	Hemigalus derbyanus
Tábąąstííntsoh łizhin dóó łigaiígíí	Histriophoca fasciata
Jeeshóóʼ bitsiiłgaiígíí	Trigonoceps occipitalis
Tábąądijádí	Charadrius vociferus
Shádiʼááhdę́ę́ʼ niłchiis	Galictis
Naʼazísí	Geomyidae
Łeeyiʼ chʼał dichʼízhí	Rhinophrynus dorsalis
Táłtłʼááh naatʼáʼii	Dactylopteridae
Naakaii Dootłʼizhí Dabikéyah	Asia del Sur
Ńdaʼatʼaałii bideeʼ dahólónígíí	Pecora
Sháńdíín bitsʼą́ą́dę́ę́ʼ atsiniltłʼish álʼį́	Panel solar
Tsé noolchʼóshii	Catherpes mexicanus
Naaldlooshii	Cuadrúpedo
Naaʼahóóhai bikeetsohígíí	Megapodius
Naʼashǫ́ʼii kááʼtsʼinígíí	Ouroborus cataphractus
Diltʼóshii	Baeolophus
Kinteel (Yootó Hahoodzo)	Aztec
Néʼétsah azeeʼ	Conyza canadensis
Naʼastsʼǫǫsí bitsʼohígíí	Hemicentetes
Atsá diłhiłígíí	Ictinaetus malayensis
Ąąʼąʼii dootłʼizhígíí	Cissa chinensis
Hastiin Dághaaʼ (Barboncito)	Barboncito
Bisóodi dághaaʼígíí	Sus barbatus
Iichʼąhii biyázhí	Aleyrodidae
Dólii	Sialia currucoides
Kin Noodǫ́ǫ́z	Bernalillo
Tsiikʼánii (łóóʼ ooshgę́ęzhii)	Rhinobatidae
Biniiʼdootłʼizh	Glaucidium
Mágí biniiłgaígíí	Pithecia pithecia
Wónaʼałtéhii	Asilidae
Tłʼoh azihii	Ephedra
Kʼaalógii bitʼaʼ disxǫsgo łikizhígíí	Riodinidae
Tiníléítsoh bikʼosnézí	Varanus griseus
Shádiʼááhdę́ę́ʼ gahniiʼí ntsxaaígíí	Dolichotis
Łéʼétsoh bitseetłʼooígíí	Petromus typicus
Tsídii bizééʼ naashchʼąąʼí	Tragopan
Tábąąsdísíłbáí	Limnodromus
Dilzhę́ʼii	Cyanocitta stelleri
Mágí naashchʼąąʼígíí	Pygathrix nemaeus
Chʼosh naʼałkǫ́ʼí	Hydrophilidae
Tééh jádítsoh	Taurotragus
Łeeyiʼ bitiiní	Arvicolinae
Atsáłbáí	Falco mexicanus
Dáádílítsoh	Epinephelus lanceolatus
Tsétah bįįhchilí	Pudu
Tsʼánídílzhiʼí	Aphelocoma californica
Iichʼąh	Convulsión
Kiisʼáanii	Indios pueblo
Jeeshóóʼ bitsiiłtsooí	Cathartes burrovianus
Dlǫ́ʼii noodǫ́zígíí	Poecilogale albinucha
Tiníléítsoh dootłʼizhígíí	Varanus prasinus
Yáázhłání (naaldlooshii)	Tenrec ecaudatus
Łéʼétsoh yił aheełtʼéhii	Octodontidae
Tábąąh łéʼétsoh	Hydromys chrysogaster
Ghą́ą́ʼdiʼilii (tsin yigházhígíí)	Lophiomys imhausi
Lókʼaaʼ yigházhígíí	Thryonomys
Tsídii bitʼaʼ dah adadootłʼizhígíí	Polyplectron
Dichin	Inanición
Dilchʼóshii	Junco (aves)
Chį́į́hʼadeeʼii (łóóʼ)	Polyodontidae
Hazéíntsxaaígíí	Ratufa
Kéyah Dańlínídę́ę́ʼ bisóodi bizęęs hastání	Sus cebifrons
Chąąneiłmaasii	Escarabajo pelotero
Dzílí	Accipiter cooperii
Chʼałniiʼí (łóóʼ)	Batrachoididae
Dah Naatʼaʼí Bééhoʼdílzin	Juramento de Lealtad
Tó bichʼosh (tsiiyaago naʼałkǫ́ʼígíí)	Notonectidae
Tónteel táshchozhii	Sternidae
Naʼastsʼǫǫsí noodǫ́zígíí	Lemniscomys
Tówoł	Taos (Nuevo México)
Díchʼíító	Bitter Springs (Arizona)
Dóliiłchííʼ	Sialia mexicana
Łóóʼ binááʼ ádiní	Amblyopsidae
Naabiʼání	Bloomfield (Nuevo México)
Tséłgaii Deezʼáhí	Bluff (Utah)
Aniłtʼánii łizhinígíí	Sialidae
Mágí bichį́į́łgaígíí	Cercopithecus ascanius
Tábąąh chʼosh	Saldidae
Naakaii Bikéyahdę́ę́ʼ bįįh yázhí	Mazama
Naʼashǫ́ʼii dootłʼizhí (naaldeehii)	Crotaphytus collaris
Naʼashǫ́ʼiiłbáhí	Dipsosaurus dorsalis
Dlǫ́tsʼósí noodǫ́zígíí	Galidictis grandidieri
Chʼoshtsoh bíláshgaanʼilí	Kiwa hirsuta
Anáʼálwoʼ:Bee hadítʼéhígíí	Ayuda:Contenidos
Deinihootso	Dennehotso (Arizona)
Táłtłʼááh chʼoshtsoh bideeneezí	Palinuridae
Táshchozhiizhiin	Sayornis nigricans
Moháábii dinéʼiʼ	Mojave (tribu)
Hodíílid	Dolores (Colorado)
Kin Łichííʼ (Kiisʼáanii bikin)	Pueblo de San Juan
Néʼéshjaaʼkálii	Micrathene whitneyi
Chaaʼ Bitoʼ	McNary (Arizona)
Tsídii bitʼaʼ hózhóón	Paradisaea
Tiníléítsoh łikizhígíí	Varanus giganteus
Tsé noolchʼóshiiłbáhí	Salpinctes obsoletus
Chʼiyíítʼogii	Tyrannus
Dloziłgaii	Tamiasciurus
Tsísʼná dootłʼizhí	Chrysididae
Halchíítah	Desierto Pintado
Tsʼahchʼil	Sphaeralcea
Wóósitsʼílí	Cimex lectularius
Tsé Nikání	Round Rock (Arizona)
Níłtsą́goʼ dootłʼizhígíí	Cotinis mutabilis
Biizhii	Chordeiles minor
Tsidiłdǫǫhii	Megascops
Tsʼááhbįįh	Physaria
Dághaaʼ Łichííʼ	Kirtland (Nuevo México)
Tábąąh ndoochííʼ	Pyrola chlorantha
Kǫʼ naʼałbąąsii hééł bee nágéhéʼ	Tren de mercancías
Tádídíín dootłʼizh áłtsʼíísí	Campanula uniflora
Dlǫ́ʼiitsoh bizééʼ noodǫ́zí	Viverra tangalunga
Jaaʼabaní	Microchiroptera
Chʼosh chʼééh digháhii bideeʼ dį́įʼii	Stylommatophora
Wóláchííʼ yildeełí	Vermilingua
Azeeʼ ditłʼooí	Cirsium neomexicanum
Niłchʼiʼ bee naalkaahiʼ	Geostationary Operational Environmental Satellite
Azeediłhiłí	Astragalus canadensis
Tséʼédǫ́ʼii łibáhígíí	Sarcophagidae
Hastiin Chʼil Haajiní (Manuelito)	Manuelito
Dlozishzhiin	Sciurus aberti
Tó Sido Háálį́	Pagosa Springs
Aniłtʼánii (naakaii náásééł nahalinígíí)	Mantispidae
Tsisteeł naʼazísí	Gopherus
Tó Diłhił Biih Yílį́	Snowflake
Yoołgai (Hoozdoh Hahoodzo)	Superior (Arizona)
Tsé Noodǫ́ǫ́z	Springerville (Arizona)
Kin Łání (Dibé Nitsaa Hahoodzo)	Durango (Colorado)
Tségháhoodzání	Window Rock
Tsé Yaatóhí	Cortez (Colorado)
Tótaʼ	Farmington (Nuevo México)
Tó Naneesdizí	Tuba City (Arizona)
Táłtłʼááh chʼoshtsoh bideeteelí	Scyllaridae
Tséhootsooí	Fort Defiance (Arizona)
Chʼínílį́	Chinle (Arizona)
Lókʼaaʼdeeshjin	Keams Canyon (Arizona)
Tséyiʼ (Chʼínílį́įgiʼígíí)	Cañón de Chelly
Chʼoshtsoh bíláshgaantsohí (tónteelgiʼígíí)	Nephropidae
Tábąąstííntsoh bighaaʼ díłchʼilígíí	Arctocephalinae
Kʼaiʼbisii	Catharus fuscescens
Dlǫ́ʼiiłtsooí	Martes melampus
Tsʼímah	Chama (Nuevo México)
Táshchozhii dootłʼizhí	Progne subis
Nihookááʼ tsídii bichʼahígíí	Bucorvus
Tsísʼnáłtsooí	Vespula
Azeeʼ hókánii łibáhígíí	Sonchus asper
Jélii łóóʼ daʼhólzhaʼígíí	Salpidae
Gólízhii binághah dah łigaiígíí	Mephitis macroura
Dloziłbáhí	Sciurus griseus
Nahatʼeʼii jáádnézí	Jaculus
Tsiiʼnteelí (łóóʼ)	Platycephalidae
Tsiiłchin Biiʼ Tó	Chilchinbito
Chíshí	Chiricahua
Bikétłʼááh Hoolzhólígíí	Tylopoda
Deeschííʼ Bikooh	Cibecue
Chíshii Kʼíneeshbizhii	Oreothlypis luciae
Tǫ́ʼgaaʼ	Cochiti (Nuevo México)
Táłtłʼááh séigoʼ bitsʼaʼígíí	Limulus polyphemus
Nááʼnoodǫ́ǫzii	Thlaspi
Tóidoozohii dootłʼizhígíí	Porphyrio
Chʼagiiłbáhí	Molothrus
Jáád neishoodítsʼóóz	Ichneumonidae
Bitsiichįįshgahí	Nucifraga columbiana
Naʼashǫ́ʼii naatʼaʼí	Draco (género)
Gólízhii bíchį́į́h tʼáá łichíiʼii	Conepatus
Iichʼąhii naashchʼąąʼígíí	Chrysiridia rhipheus
Ałchʼįʼ beʼastłʼóní	Tamal
Tó bichʼosh (wónikǫsí nahalinígíí)	Ranatra
Gólízhii yistłʼinígíí	Spilogale
Biniiʼnoodǫ́zí (tsin yigázhígíí)	Lagostomus maximus
Tsísʼnátsoh diłhiłígíí	Xylocopa
Shádiʼááhdę́ę́ʼ chʼoshtsoh bíláshgaantsohí	Parastacidae
Zábąąhnteelii (łóóʼ ooshgę́ęzhii)	Rhina ancylostoma
Gahjaaʼí bitseeneezígíí	Lagidium
Łitsooí (Yootó Hahoodzo)	Tierra Amarilla (Nuevo México)
Tsézhin Dilkǫǫh	Dilkon
Naaldlooshii Bikéshgaan Dahólónígíí	Ungulata
Tółání Biyáázh	North Acomita Village (Nuevo México)
Nóódaʼí	Ute
Tó Dínéeshzheeʼ	Kayenta
Beehai (Kintah)	Dulce (Nuevo México)
Néʼézhiin	Sphyrapicus nuchalis
Ginítsoh diłhiłí	Buteogallus anthracinus
Hoshdódii	Antrostomus vociferus
Hasbídí Áshįįhí	East Fork (Arizona)
Chʼééh digháhii bitsʼaʼ dah deezʼáhí	Graptemys
Táłtłááh chʼoshyog	Nereididae
Dlǫ́ʼii yił aheełtʼéhii diłhiłígíí	Galerella pulverulenta
Gadtsagí	Juniperus monosperma
Chʼosh bitsʼaʼ doolghasígíí	Pectinidae
Hashkʼaan bichʼosh	Prodoxidae
Chaatʼíní bichʼosh	Groen zuringhaantje
Ndilkal biyaʼ noodǫ́zígíí	Acalymma vittatum
Tádídíín yiyání łizhinígíí	Timarcha
Niʼbéshjah	Amorpha
Tsékʼi Naʼasdzooí (Yootó Hahoodzo)	Monumento Nacional El Morro
Tsídii bidaatsoh naashchʼąąʼí	Ramphastidae
Kʼaiʼbiiʼtó	Kaibito
Chʼał bikéshgaan hólóní	Xenopus
Tó wónaanídę́ę́ʼ nahashchʼidí	Meles
Bidił Daazdoígíí dóó Daʼałtʼoʼígíí ałkééʼ daasdzoh	Anexo:Géneros de mamíferos
Wónitłʼizí nahalinígíí	Glomerida
Nahashchʼidí yił aheełtʼéhii yázhí	Melogale
Dáánézí (łóóʼ)	Centriscidae
Tłʼiish bichóhí	Crotalus cerastes
Tsékʼi yaʼiiʼáhii	Manduca sexta
Táłkááʼ sikaadí	Cerastium arvense
Dahtooʼ yinooghałii	Cistothorus palustris
Tsédááʼii	Oribatida
Dahiitį́į́hildaaʼígíí	Lobelia cardinalis
Tʼááłáhági átʼéego:Bééshbichʼahí	Categoría:Alemania
Tʼááłáhági átʼéego:Wááshindoon bikéyah ałhidadiidzooígíí	Categoría:Estados Unidos
Táłtłʼááh kʼaaʼ (łóóʼ)	Fistulariidae
Tʼááłáhági átʼéego:Dibé diníí bikéyah	Categoría:España
Tʼááłáhági átʼéego:Naakaii Bikéyah	Categoría:México
Naalkʼįhí bizaʼazis hólóní	Petaurus
Naʼashǫ́ʼii diwozhígíí	Smaug giganteus
Choozhghalii	Icterus
Tsinlátah mąʼii	Bassaricyon
Tsiiyah wozhii	Sturnella
Chʼóyáázh nahalinígíí (táłtłʼááh chʼosh)	Spirobranchus giganteus
Chʼosh dichiłí bitsʼaʼígíí	Mytiloida
Naatsédlózii	Geococcyx
Kʼįįʼ łitsooítsoh	Mahonia fremontii
Tʼááłáhági átʼéego:Bidił daazdoígíí dóó daʼałtʼoʼígíí	Categoría:Mammalia
Tʼááłáhági átʼéego:Naaldlooshii dadichʼízhii	Categoría:Reptiles
Tʼááłáhági átʼéego:Biyáázh Tsʼǫʼasánígíí	Categoría:Amphibia
Tʼááłáhági átʼéego:Tsídii	Categoría:Aves
Tʼááłáhági átʼéego:Chʼosh doo yitʼíinii dláádí dóó Ábishjaaʼ	Categoría:Fungi
Tʼááłáhági átʼéego:Chʼil	Categoría:Plantae
Tʼááłáhági átʼéego:Nátʼą́ą́ʼ náháneʼ	Categoría:Historia
Tʼááłáhági átʼéego:Naʼalkaah	Categoría:Ciencia
Béégashii bideetsohí	Ankole-Watusi (raza bovina)
Tsédeeshzha Dziłtaʼ mąʼiitsoh	Canis lupus irremotus
Cháʼoł	Pinos piñoneros
Dził Nááyisí	Sierra de Sandía
Tséchʼízhí	Rough Rock (Arizona)
Tsétaʼkin	Pueblo de San Ildefonso
Niʼiijíhí	Navajo (Nuevo México)
Lókʼaahnteel	Ganado (Arizona)
Góóhníinii	Havasupai
Tsísʼná disxǫsígíí	Euglossini
Łóóʼtsoh bizábąąh shiyishí	Eubalaena
Tʼiis Názbąs	Teec Nos Pos (Arizona)
Díwózhii Biiʼ Tó	Greasewood (Arizona)
Tó hájiiloh	Santo Domingo (Nuevo México)
Naashashí (Yootó Hahoodzo)	Pueblo de Santa Clara
Táłtłʼááh chʼosh chʼééh digháhii bikeeʼ nteelígíí	Naticidae
Dah yiskʼid	Montículo
Táshchozhii ndiilkʼísii	Petrochelidon pyrrhonota
Tsídiiłtsooiiłkizhígíí	Ammodramus bairdii
Ndilkal biyaʼ łikizhígíí	Diabrotica undecimpunctata
Jiłhazhí bichʼosh (níłtsą́goʼ)	Desmocerus californicus
Hosh yiyání (níłtsą́goʼ)	Moneilema
Hanáádlį́	Huérfano (Nuevo México)
Wóótsʼóóz	Alydidae
Tséʼałnáoztʼiʼí	Sanostee (Nuevo México)
Gad yił aheełtʼéhígíí bichʼosh	Diorhabda carinulata
Jádító	Jeddito (Arizona)
Iichʼąhii	Heterocera
Roman dinéʼiʼ	Antigua Roma
Maricopa dinéʼiʼ	Maricopa
Tóyééʼ	Steamboat (Arizona)
Dlodziłgai bichʼil	Ipomopsis aggregata
Chʼil deenínii	Salsola tragus
Tsééhílį́	Tsaile (Arizona)
Dziłíjiin	Mesa de las Vacas
Naabeehó	Nación Navajo
Áshįįhí Kiisʼáaniígíí	Pueblo de Laguna
Chʼílwozh	Whiteriver
Shą́ą́ʼtóhí	Shonto (Arizona)
Tó Nehelį́į́h	Tonalea (Arizona)
Kin Náztʼįʼ	Shongopovi
Tó Hałtsooí	Sheep Springs (Nuevo México)
Lókʼaʼchʼégai	Lukachukai (Arizona)
Tsé Binííʼtóhí	Tse Bonito (Nuevo México)
Tsiizizii	Leupp
Chʼoshtsoh bikágí diwozhí	Lithodidae
Tábąąh naʼashǫ́ʼii	Physignathus
Yaʼniilzhiin	Torreón (condado de Sandoval, Nuevo México)
Náhodeeshgiizh Chʼínílíní	Pueblo Pintado (Nuevo México)
Ooljééʼ Tó dóó Tsé Deelghasii	Oljato-Monument Valley (Arizona)
Dáʼákʼeh Halání	Many Farms (Arizona)
Názlíní	Nazlini (Arizona)
Niʼiijííh Hasání	Sawmill (Arizona)
Tséʼnaa Naʼníʼáhí	Monumento nacional Puente del Arco Iris
Dilzhʼíʼ	Yavapai
Tsé Łichííʼ Dahazkání (Hoozdoh Hahoodzo)	Red Mesa (Arizona)
Maʼiitoʼí	Houck (Arizona)
Tó Niłtsʼílí	Crystal (Nuevo México)
Tábąąh béégashii ałchiní	Bubalus arnee
Dáádílí ntsxaaígíí	Epinephelus itajara
Naakaii Chʼah	Mexican Hat (Utah)
Waalibéí dinéʼiʼ	Pueblo hualapai
Kégiizhí	Pueblo pápago
Chʼosh ałchozhii (iichʼąhii)	Polilla
Dookʼoʼoosłííd	Sierra de San Francisco
Tʼááłáhági átʼéego:Ałtsʼáʼáztiin	Categoría:Wikipedia:Desambiguación
Bis Deezʼáhí	Newcomb (Nuevo México)
Tsintah bįįhchilí	Tragulus
Yiikʼiʼdaʼ hiiznáʼ	Defensiva y ofensiva
Tʼiistsʼóóz	Populus angustifolia
Naatʼáanii Nééz	Shiprock (Nuevo México)
Tsékʼi naʼazólii	Sauromalus
Juan de Oñate	Juan de Oñate
Kʼish Chʼínítʼiʼ	Paguate (Nuevo México)
Hastiin Antonio de Espejo	Antonio de Espejo
Sǫʼtsoh nátʼoh	Salix exigua
Yaaʼííʼáhí (Bidááʼ Haʼaztʼiʼ Tsékooh)	Torre de Vigilancia Desert View
Gad diltáłii	Juniperus deppeana
Sengaa	San Carlos (Arizona)
Ńdíshchííʼ Dah Shizhóód	Pinehill (Nuevo México)
Naatoohó (Kintah)	Isleta Village Proper
Atsá	Águila
Séíbéʼézhóóʼ	Muhlenbergia
Tsʼah	Artemisia tridentata
Tsʼíhootso	St. Michaels (Arizona)
Tłʼoh Łikizhí	Tesuque (Nuevo México)
Dibé łizhiní dinéʼiʼ	Pueblo de San Felipe
Maʼii Tééh Yitłizhí	Brimhall Nizhoni (Nuevo México)
Dził Łigaii (Dibé Nitsaa Hahoodzo)	Montañas de San Juan
Tsé Chʼééchiiʼ	Mesita (Nuevo México)
Doo Alkʼahii	Upper Fruitland (Nuevo México)
Łichíiʼii	LeChee
Chʼał nineezí bidą́ą́ʼ	Epipactis gigantea
Tʼiistsʼóóz Ńdeeshgizh	Crownpoint (Nuevo México)
Naashtʼézhí (Yootó Hahoodzo)	Zuni Pueblo (Nuevo México)
Tséchʼil	Quercus gambelii
Ndilnaʼii	Folivora
Hashtłʼish Tó	Claypool (Arizona)
Tsísʼnáyázhí	Halictidae
Oozéí Hayázhí	Moenkopi
Bíina	Ignacio (Colorado)
Tsé Dootłʼizh (Hoozdoh Hahoodzo)	Peridot (Arizona)
Chʼałtʼą́hí	Pipa (animal)
Kinłitsosinil	Church Rock (Nuevo México)
Chʼil dilyésii	Gutierrezia
Iichʼąhiiłgai bitʼaʼnézí	Thysania agrippina
Tsézhįįh Deezlį́	Black Rock (Nuevo México)
Séí nahachagiichilí (chʼosh bikágí ntłʼizí)	Talitridae
Naakaii Bitoʼ	Nakaibito (Nuevo México)
Wóláchííʼ azeeʼ	Dyssodia
Dólii Dził	Los Cerrillos (Nuevo México)
Nátʼoh Dził	Meseta de Kaibab
Tłʼohchiní	Ramah (Nuevo México)
Beʼekʼid Baa Ahoodzání	Piñón (Arizona)
Kin Dootłʼizhí	Towaoc (Colorado)
Chʼil naʼatłʼoʼiitsʼóóz	Clematis ligusticifolia
Tsédédééh	Mirabilis multiflora
Woodiniih azeeʼ (chʼil)	Thelesperma
Íijeehí	Lappula
Chéchʼízhí	Rock Springs (Nuevo México)
Naayízí (Yootó Hahoodzo)	Nageezi (Nuevo México)
Dinastsoh	Arctostaphylos patula
Kʼaasdá bee yigą́	Eupatorium purpureum
Díkʼǫ́ǫ́zhízlíní	Atriplex confertifolia
Niłtsínii	Arisaema triphyllum
Táłchaaʼ	Phyllophaga
Jaaniłtsʼíliidą́ą́ʼ	Cheilanthes feei
Chąąʼinii	Rumex hymenosepalus
Chʼil łizhiní	Coleogyne ramosissima
Nááʼ łitsooí	Solanum elaeagnifolium
Tséʼézhííh	Artemisia ludoviciana
Tó Haachʼiʼ	Tohatchi (Nuevo México)
Biʼééʼ dootłʼizhgo disxǫsígíí	Pharomachrus
Tʼáá Bííchʼį́įdii (Áshįįh Biiʼtó Hahoodzo)	Aneth
Kʼaiʼ Chʼíneeltłʼǫ́	La Jara (Nuevo México)
Díwózhii łibáhígíí	Atriplex canescens
Dlǫ́ʼí Yázhí (Yootó Hahoodzo)	Thoreau (Nuevo México)
Tłʼoh nástasí	Bouteloua gracilis
Tʼááłáhági átʼéego:Chidí naatʼaʼí	Categoría:Aeronaves
Tłʼiish kʼaaʼ beeʼiiłkóóh	Eremocrinum albomarginatum
Bitłʼááh Bitoʼ	Beclabito (Nuevo México)
Naadą́ą́ʼ biyaʼ	Gorgojo del maiz
Tʼiistsoh	Álamo (Nuevo México)
Nahashchʼidí (Yootó Hahoodzo)	Naschitti (Nuevo México)
Tʼáá Bííchʼį́įdii (Yootó Hahoodzo)	Yah-ta-hey (Nuevo México)
Náyaasęęsí	Joseph City (Arizona)
Tʼááłáhági átʼéego:Wikipedia bots	Categoría:Wikipedia:Bots
Chooyin azeeʼ	Corydalis aurea
Tłʼoh Yaaniigai	Bylas (Arizona)
Tónteel zhį́ʼii	Phalacrocoracidae
Tsídii bitseeʼ naashchʼąąʼí	Pavo (género)
Bee álnééhí:Tl	Plantilla:Ep
Tʼááłáhági átʼéego:Bee Hazʼáanii	Categoría:Derecho
Tʼááłáhági átʼéego:Kéyah daʼnaaznilígíí dóó kéyah biłhaʼdaʼhaasdzoígíí	Categoría:Países
Wikiibíídiiya:Dahwéetʼaahígíí	Wikipedia:Bibliotecarios
Wikiibíídiiya:Botígíí beehazʼą́ąnii	Wikipedia:Bot
Ííjip	Egipto
Bee álnééhí:Bot	Plantilla:Bot
Deeteel Bikéyah	Canadá
Tsʼíʼii bitʼaʼ ádinígíí	Chionea
Wikiibíídiiya:Baa haneʼ	Wikipedia:Acerca de
Tʼááłáhági átʼéego:Béésh bichʼahníí bikéyah	Categoría:Países de Europa
Tʼááłáhági átʼéego:Choyoołʼįįhí Bizaad	Categoría:Wikipedia:Wikipedistas por idioma
Anáʼálwoʼ:Wikiibíídiiya beehazʼą́ąnii	Wikipedia:Políticas y convenciones
Tséłnííʼjí (chʼil)	Adiantum capillus-veneris
Azeeʼ ntłʼinítsoh	Potentilla pensylvanica
Hazéí yiltʼąąʼí	Aquilegia elegantula
Azeetłʼohí	Eremogone aculeata
Mąʼii náʼoołjił azeeʼ	Astragalus kentrophyta
Bee álnééhí:Softredirect	Plantilla:Redirección suave
Chʼosh chʼééh digháhii	Gastropoda
Tłʼoh hosh	Cenchrus echinatus
Azeeʼ naneesdizí	Boechera perennans
Teeł Chʼínítʼiʼ	Oak Springs (Arizona)
Kinteel (Hoozdoh Hahoodzo)	Wide Ruins
Łeeyiʼtó	Klagetoh
Séí Bídaagai	Seba Dalkai
Tʼááłáhági átʼéego:Saad	Categoría:Lenguas
Tódzísʼą́	Wheatfields (Arizona)
Wikiibíídiiya:General disclaimer	Wikipedia:Limitación general de responsabilidad
Tʼááłáhági átʼéego:Noindexed pages	Categoría:Wikipedia:Páginas no indexadas
Wikiibíídiiya:Statistics	Wikipedia:Estadísticas
Dził Náhooziłii	Sierra del Carrizo
Nátʼoh niłchiin	Castilleja affinis
Tséʼésdaazí	Cercocarpus montanus
Nahatʼeʼiitsoh	Canguro
Niʼtsʼǫǫsii	Dalea candida
Ayání bichʼil	Ratibida
Azeeʼitʼééł	Plantago patagonica
Bikéétsíín ditłʼooí	Tetraneuris
Tó Hahadleeh	Indian Wells (Arizona)
Tótsʼózí	Concho (Arizona)
Tłʼoh Haakai	Fort Apache (Arizona)
Toohjįʼ Hwiidzoh (kintah)	Woodruff (Arizona)
Chʼil hochʼid	Dithyrea
Łóóʼ hashkéhéchilí	Chimaeriformes
Tʼááłáhági átʼéego:Living people	Categoría:Personas vivas
Tʼááłáhági átʼéego:Béésh bee akʼeʼelchíhí tʼáá bí nitsékeesígíí	Categoría:Informática aplicada
Diné Bikéyah binaaldeehii dóó chʼil danílʼínídi	Parque Botánico y Zoológico de la Nación Navajo
Bee álnééhí:!	Plantilla:!
Dibé Ííjééʼ	Fence Lake (Nuevo México)
Chʼil ntłʼizí	Fendlera rupicola
Tʼááłáhági átʼéego:Naaltsoos	Categoría:Libros
Bee álnééhí:Wikisource	Plantilla:Wikisource
Bee álnééhí:Babel	Plantilla:Babel
Bee álnééhí:Commons	Plantilla:Commons
Bee álnééhí:Reflist	Plantilla:Listaref
Hooghan Łigaii Hahoshí	Fort Thomas (Arizona)
Bee álnééhí:Stub	Plantilla:Esbozo
Bee álnééhí:See also	Plantilla:VT
Bisdááʼáshchʼil	Purshia glandulosa
Naʼachííʼ azeeʼ	Euphorbia brachycera
Tʼááłáhági átʼéego:Chʼosh bijáád hastánígíí	Categoría:Insecta
Tʼááłáhági átʼéego:Choyoołʼįįhí uk	Categoría:Wikipedia:Wikipedistas con conocimientos de ucraniano
Tʼááłáhági átʼéego:Choyoołʼįįhí uk-N	Categoría:Wikipedia:Wikipedistas con nivel nativo de ucraniano
Tʼááłáhági átʼéego:Chʼiyáán	Categoría:Alimentos
Bee álnééhí:SIL	Plantilla:Doc ISO3
Tʼááłáhági átʼéego:Choyoołʼįįhí ms	Categoría:Wikipedia:Wikipedistas con conocimientos de malayo
Tʼááłáhági átʼéego:Choyoołʼįįhí fr-1	Categoría:Wikipedia:Wikipedistas con nivel básico de francés
Bee álnééhí:Image label	Plantilla:Etiqueta imagen
Tʼááłáhági átʼéego:Atsá dóó Giní Ndahalinígíí	Categoría:Falconiformes
Tʼááłáhági átʼéego:Choyoołʼįįhí en-4	Categoría:Wikipedia:Wikipedistas con nivel experto de inglés
Tʼááłáhági átʼéego:Choyoołʼįįhí en	Categoría:Wikipedia:Wikipedistas con conocimientos de inglés
Tʼááłáhági átʼéego:Choyoołʼįįhí zh	Categoría:Wikipedia:Wikipedistas con conocimientos de chino
Tʼááłáhági átʼéego:Choyoołʼįįhí zh-N	Categoría:Wikipedia:Wikipedistas con nivel nativo de chino
Tʼááłáhági átʼéego:Choyoołʼįįhí en-2	Categoría:Wikipedia:Wikipedistas con nivel intermedio de inglés
Bee álnééhí:GeoTemplate	Plantilla:GeoTemplate
Tʼááłáhági átʼéego:Choyoołʼįįhí hi	Categoría:Wikipedia:Wikipedistas con conocimientos de hindi
Tʼááłáhági átʼéego:Choyoołʼįįhí ms-N	Categoría:Wikipedia:Wikipedistas con nivel nativo de malayo
Tʼááłáhági átʼéego:Dził	Categoría:Montañas
Tʼááłáhági átʼéego:Kéyah yádiłhił biiʼ dahólónígíí	Categoría:Planetas del Sistema Solar
Tʼááłáhági átʼéego:Kéyah dah siʼánígíí	Categoría:América
Tʼááłáhági átʼéego:Choyoołʼįįhí bizaad-Templates	Categoría:Wikipedia:Plantillas Babel
Bee álnééhí:Archive	Plantilla:Caja de archivos
Tʼááłáhági átʼéego:Siláołtsooí	Categoría:Fuerzas armadas
Tʼááłáhági átʼéego:Naʼashǫ́ʼii	Categoría:Lacertilia
Bee álnééhí:Tb	Plantilla:Respuesta
Bee álnééhí:Image label end	Plantilla:Etiqueta imagen fin
Bee álnééhí:Userpage	Plantilla:Página usuario
Tsé Siʼání	Lupton (Arizona)
Bee álnééhí:Emergency-bot-shutoff	Plantilla:Paro de emergencia del bot
Bee álnééhí:Image label small	Plantilla:Etiqueta imagen pequeña
Tʼááłáhági átʼéego:Hosh	Categoría:Cactaceae
Tʼááłáhági átʼéego:Choyoołʼįįhí ja-N	Categoría:Wikipedia:Wikipedistas con nivel nativo de japonés
Bee álnééhí:@	Plantilla:@
Tʼááłáhági átʼéego:Tłʼoh	Categoría:Poaceae
Bee álnééhí:Ałtsʼáʼáztiin	Plantilla:Desambiguación
Bee álnééhí:Chʼiyáánbiiʼ	Plantilla:Ficha de valor nutricional
Dził Łizhinii / Aniłtʼánii Dził	Sierra de Jémez
Tʼááłáhági átʼéego:Choyoołʼįįhí gsw-1	Categoría:Wikipedia:Wikipedistas con nivel básico de alemán suizo
Tʼááłáhági átʼéego:Ásáí Bikéyah	Categoría:Estados de la Liga Árabe
Tʼááłáhági átʼéego:Kǫʼ naʼałbąąsii	Categoría:Ferrocarriles
Tʼááłáhági átʼéego:Templates/doc	Categoría:Wikipedia:Indicaciones para el uso de plantillas
Tʼááłáhági átʼéego:Choyoołʼįįhí bjn	Categoría:Wikipedia:Wikipedistas con conocimientos de Banjar
Tʼááłáhági átʼéego:Choyoołʼįįhí bew	Categoría:Wikipedia:Wikipedistas con conocimientos de Betawi
Tʼááłáhági átʼéego:Choyoołʼįįhí yue	Categoría:Wikipedia:Wikipedistas con conocimientos de Cantonese
Tʼááłáhági átʼéego:Choyoołʼįįhí pdc	Categoría:Wikipedia:Wikipedistas con conocimientos de Deitsch
Tʼááłáhági átʼéego:Choyoołʼįįhí mzn	Categoría:Wikipedia:Wikipedistas con conocimientos de Mazanderani
Tʼááłáhági átʼéego:Choyoołʼįįhí at	Categoría:Wikipedia:Wikipedistas con conocimientos de alemán austríaco
Tʼááłáhági átʼéego:Choyoołʼįįhí az	Categoría:Wikipedia:Wikipedistas con conocimientos de azerí
Tʼááłáhági átʼéego:Choyoołʼįįhí be	Categoría:Wikipedia:Wikipedistas con conocimientos de bielorruso
Tʼááłáhági átʼéego:Choyoołʼįįhí nb-N	Categoría:Wikipedia:Wikipedistas con nivel nativo de bokmal noruego
Tʼááłáhági átʼéego:Choyoołʼįįhí bs	Categoría:Wikipedia:Wikipedistas con conocimientos de bosnio
Tʼááłáhági átʼéego:Choyoołʼįįhí ce	Categoría:Wikipedia:Wikipedistas con conocimientos de checheno
Tʼááłáhági átʼéego:Choyoołʼįįhí chr	Categoría:Wikipedia:Wikipedistas con conocimientos de cherokee
Tʼááłáhági átʼéego:Choyoołʼįįhí hr	Categoría:Wikipedia:Wikipedistas con conocimientos de croata
Tʼááłáhági átʼéego:Choyoołʼįįhí sk	Categoría:Wikipedia:Wikipedistas con conocimientos de eslovaco
Tʼááłáhági átʼéego:Choyoołʼįįhí sl	Categoría:Wikipedia:Wikipedistas con conocimientos de esloveno
Tʼááłáhági átʼéego:Choyoołʼįįhí eo	Categoría:Wikipedia:Wikipedistas con conocimientos de esperanto
Tʼááłáhági átʼéego:Choyoołʼįįhí et	Categoría:Wikipedia:Wikipedistas con conocimientos de estonio
Tʼááłáhági átʼéego:Choyoołʼįįhí fr	Categoría:Wikipedia:Wikipedistas con conocimientos de francés
Tʼááłáhági átʼéego:Choyoołʼįįhí frr	Categoría:Wikipedia:Wikipedistas con conocimientos de frisón septentrional
Tʼááłáhági átʼéego:Choyoołʼįįhí gl	Categoría:Wikipedia:Wikipedistas con conocimientos de gallego
Tʼááłáhági átʼéego:Choyoołʼįįhí cy	Categoría:Wikipedia:Wikipedistas con conocimientos de galés
Tʼááłáhági átʼéego:Choyoołʼįįhí gn	Categoría:Wikipedia:Wikipedistas con conocimientos de guaraní
Tʼááłáhági átʼéego:Choyoołʼįįhí hu-N	Categoría:Wikipedia:Wikipedistas con nivel nativo de húngaro
Tʼááłáhági átʼéego:Choyoołʼįįhí id	Categoría:Wikipedia:Wikipedistas con conocimientos de indonesio
Tʼááłáhági átʼéego:Choyoołʼįįhí ia	Categoría:Wikipedia:Wikipedistas con conocimientos de interlingua
Tʼááłáhági átʼéego:Choyoołʼįįhí ga	Categoría:Wikipedia:Wikipedistas con conocimientos de irlandés
Tʼááłáhági átʼéego:Choyoołʼįįhí ja	Categoría:Wikipedia:Wikipedistas con conocimientos de japonés
Tʼááłáhági átʼéego:Choyoołʼįįhí km	Categoría:Wikipedia:Wikipedistas con conocimientos de jemer
Tʼááłáhági átʼéego:Choyoołʼįįhí rn	Categoría:Wikipedia:Wikipedistas con conocimientos de kiroundi
Tʼááłáhági átʼéego:Choyoołʼįįhí la	Categoría:Wikipedia:Wikipedistas con conocimientos de latín
Tʼááłáhági átʼéego:Choyoołʼįįhí li	Categoría:Wikipedia:Wikipedistas con conocimientos de limburgués
Tʼááłáhági átʼéego:Choyoołʼįįhí lt	Categoría:Wikipedia:Wikipedistas con conocimientos de lituano
Tʼááłáhági átʼéego:Choyoołʼįįhí mk	Categoría:Wikipedia:Wikipedistas con conocimientos de macedonio
Tʼááłáhági átʼéego:Choyoołʼįįhí mg	Categoría:Wikipedia:Wikipedistas con conocimientos de malgache
Tʼááłáhági átʼéego:Choyoołʼįįhí mwl	Categoría:Wikipedia:Wikipedistas con conocimientos de mirandés
Tʼááłáhági átʼéego:Choyoołʼįįhí mn	Categoría:Wikipedia:Wikipedistas con conocimientos de mongol
Tʼááłáhági átʼéego:Choyoołʼįįhí nn	Categoría:Wikipedia:Wikipedistas con conocimientos de nynorsk noruego
Tʼááłáhági átʼéego:Choyoołʼįįhí nah	Categoría:Wikipedia:Wikipedistas con conocimientos de náhuatl
Tʼááłáhági átʼéego:Choyoołʼįįhí oc	Categoría:Wikipedia:Wikipedistas con conocimientos de occitano
Tʼááłáhági átʼéego:Choyoołʼįįhí pt	Categoría:Wikipedia:Wikipedistas con conocimientos de portugués
Tʼááłáhági átʼéego:Choyoołʼįįhí ro	Categoría:Wikipedia:Wikipedistas con conocimientos de rumano
Tʼááłáhági átʼéego:Choyoołʼįįhí sc	Categoría:Wikipedia:Wikipedistas con conocimientos de sardo
Tʼááłáhági átʼéego:Choyoołʼįįhí sh	Categoría:Wikipedia:Wikipedistas con conocimientos de serbocroata
Tʼááłáhági átʼéego:Choyoołʼįįhí sv	Categoría:Wikipedia:Wikipedistas con conocimientos de sueco
Tʼááłáhági átʼéego:Choyoołʼįįhí sw	Categoría:Wikipedia:Wikipedistas con conocimientos de swahili
Tʼááłáhági átʼéego:Choyoołʼįįhí sa	Categoría:Wikipedia:Wikipedistas con conocimientos de sánscrito
Tʼááłáhági átʼéego:Choyoołʼįįhí th	Categoría:Wikipedia:Wikipedistas con conocimientos de tailandés
Tʼááłáhági átʼéego:Choyoołʼįįhí ta	Categoría:Wikipedia:Wikipedistas con conocimientos de tamil
Tʼááłáhági átʼéego:Choyoołʼįįhí vo	Categoría:Wikipedia:Wikipedistas con conocimientos de volapük
Tʼááłáhági átʼéego:Choyoołʼįįhí bar-3	Categoría:Wikipedia:Wikipedistas con nivel avanzado de Bavarian
Tʼááłáhági átʼéego:Choyoołʼįįhí az-3	Categoría:Wikipedia:Wikipedistas con nivel avanzado de azerí
Tʼááłáhági átʼéego:Choyoołʼįįhí be-3	Categoría:Wikipedia:Wikipedistas con nivel avanzado de bielorruso
Tʼááłáhági átʼéego:Choyoołʼįįhí cs-3	Categoría:Wikipedia:Wikipedistas con nivel avanzado de checo
Tʼááłáhági átʼéego:Choyoołʼįįhí sl-3	Categoría:Wikipedia:Wikipedistas con nivel avanzado de esloveno
Tʼááłáhági átʼéego:Choyoołʼįįhí et-3	Categoría:Wikipedia:Wikipedistas con nivel avanzado de estonio
Tʼááłáhági átʼéego:Choyoołʼįįhí fr-3	Categoría:Wikipedia:Wikipedistas con nivel avanzado de francés
Tʼááłáhági átʼéego:Choyoołʼįįhí cy-3	Categoría:Wikipedia:Wikipedistas con nivel avanzado de galés
Tʼááłáhági átʼéego:Choyoołʼįįhí gn-3	Categoría:Wikipedia:Wikipedistas con nivel avanzado de guaraní
Tʼááłáhági átʼéego:Choyoołʼįįhí hi-3	Categoría:Wikipedia:Wikipedistas con nivel avanzado de hindi
Tʼááłáhági átʼéego:Choyoołʼįįhí ia-3	Categoría:Wikipedia:Wikipedistas con nivel avanzado de interlingua
Tʼááłáhági átʼéego:Choyoołʼįįhí it-3	Categoría:Wikipedia:Wikipedistas con nivel avanzado de italiano
Tʼááłáhági átʼéego:Choyoołʼįįhí ja-3	Categoría:Wikipedia:Wikipedistas con nivel avanzado de japonés
Tʼááłáhági átʼéego:Choyoołʼįįhí li-3	Categoría:Wikipedia:Wikipedistas con nivel avanzado de limburgués
Tʼááłáhági átʼéego:Choyoołʼįįhí lt-3	Categoría:Wikipedia:Wikipedistas con nivel avanzado de lituano
Tʼááłáhági átʼéego:Choyoołʼįįhí mk-3	Categoría:Wikipedia:Wikipedistas con nivel avanzado de macedonio
Tʼááłáhági átʼéego:Choyoołʼįįhí nl-3	Categoría:Wikipedia:Wikipedistas con nivel avanzado de neerlandés
Tʼááłáhági átʼéego:Choyoołʼįįhí no-3	Categoría:Wikipedia:Wikipedistas con nivel avanzado de noruego
Tʼááłáhági átʼéego:Choyoołʼįįhí nah-3	Categoría:Wikipedia:Wikipedistas con nivel avanzado de náhuatl
Tʼááłáhági átʼéego:Choyoołʼįįhí oc-3	Categoría:Wikipedia:Wikipedistas con nivel avanzado de occitano
Tʼááłáhági átʼéego:Choyoołʼįįhí pl-3	Categoría:Wikipedia:Wikipedistas con nivel avanzado de polaco
Tʼááłáhági átʼéego:Choyoołʼįįhí sh-3	Categoría:Wikipedia:Wikipedistas con nivel avanzado de serbocroata
Tʼááłáhági átʼéego:Choyoołʼįįhí sw-3	Categoría:Wikipedia:Wikipedistas con nivel avanzado de swahili
Tʼááłáhági átʼéego:Choyoołʼįįhí sa-3	Categoría:Wikipedia:Wikipedistas con nivel avanzado de sánscrito
Tʼááłáhági átʼéego:Choyoołʼįįhí ta-3	Categoría:Wikipedia:Wikipedistas con nivel avanzado de tamil
Tʼááłáhági átʼéego:Choyoołʼįįhí tr-3	Categoría:Wikipedia:Wikipedistas con nivel avanzado de turco
Tʼááłáhági átʼéego:Choyoołʼįįhí ar-3	Categoría:Wikipedia:Wikipedistas con nivel avanzado de árabe
Tʼááłáhági átʼéego:Choyoołʼįįhí bew-1	Categoría:Wikipedia:Wikipedistas con nivel básico de Betawi
Tʼááłáhági átʼéego:Choyoołʼįįhí pdc-1	Categoría:Wikipedia:Wikipedistas con nivel básico de Deitsch
Tʼááłáhági átʼéego:Choyoołʼįįhí an-1	Categoría:Wikipedia:Wikipedistas con nivel básico de aragonés
Tʼááłáhági átʼéego:Choyoołʼįįhí be-1	Categoría:Wikipedia:Wikipedistas con nivel básico de bielorruso
Tʼááłáhági átʼéego:Choyoołʼįįhí cs-1	Categoría:Wikipedia:Wikipedistas con nivel básico de checo
Tʼááłáhági átʼéego:Choyoołʼįįhí da-1	Categoría:Wikipedia:Wikipedistas con nivel básico de danés
Tʼááłáhági átʼéego:Choyoołʼįįhí sl-1	Categoría:Wikipedia:Wikipedistas con nivel básico de esloveno
Tʼááłáhági átʼéego:Choyoołʼįįhí et-1	Categoría:Wikipedia:Wikipedistas con nivel básico de estonio
Tʼááłáhági átʼéego:Choyoołʼįįhí fi-1	Categoría:Wikipedia:Wikipedistas con nivel básico de finés
Tʼááłáhági átʼéego:Choyoołʼįįhí cy-1	Categoría:Wikipedia:Wikipedistas con nivel básico de galés
Tʼááłáhági átʼéego:Choyoołʼįįhí gn-1	Categoría:Wikipedia:Wikipedistas con nivel básico de guaraní
Tʼááłáhági átʼéego:Choyoołʼįįhí hi-1	Categoría:Wikipedia:Wikipedistas con nivel básico de hindi
Tʼááłáhági átʼéego:Choyoołʼįįhí ia-1	Categoría:Wikipedia:Wikipedistas con nivel básico de interlingua
Tʼááłáhági átʼéego:Choyoołʼįįhí ga-1	Categoría:Wikipedia:Wikipedistas con nivel básico de irlandés
Tʼááłáhági átʼéego:Choyoołʼįįhí jv-1	Categoría:Wikipedia:Wikipedistas con nivel básico de javanés
Tʼááłáhági átʼéego:Choyoołʼįįhí ku-1	Categoría:Wikipedia:Wikipedistas con nivel básico de kurdo
Tʼááłáhági átʼéego:Choyoołʼįįhí lv-1	Categoría:Wikipedia:Wikipedistas con nivel básico de letón
Tʼááłáhági átʼéego:Choyoołʼįįhí li-1	Categoría:Wikipedia:Wikipedistas con nivel básico de limburgués
Tʼááłáhági átʼéego:Choyoołʼįįhí lt-1	Categoría:Wikipedia:Wikipedistas con nivel básico de lituano
Tʼááłáhági átʼéego:Choyoołʼįįhí mk-1	Categoría:Wikipedia:Wikipedistas con nivel básico de macedonio
Tʼááłáhági átʼéego:Choyoołʼįįhí nl-1	Categoría:Wikipedia:Wikipedistas con nivel básico de neerlandés
Tʼááłáhági átʼéego:Choyoołʼįįhí nah-1	Categoría:Wikipedia:Wikipedistas con nivel básico de náhuatl
Tʼááłáhági átʼéego:Choyoołʼįįhí oc-1	Categoría:Wikipedia:Wikipedistas con nivel básico de occitano
Tʼááłáhági átʼéego:Choyoołʼįįhí pl-1	Categoría:Wikipedia:Wikipedistas con nivel básico de polaco
Tʼááłáhági átʼéego:Choyoołʼįįhí ro-1	Categoría:Wikipedia:Wikipedistas con nivel básico de rumano
Tʼááłáhági átʼéego:Choyoołʼįįhí sc-1	Categoría:Wikipedia:Wikipedistas con nivel básico de sardo
Tʼááłáhági átʼéego:Choyoołʼįįhí sh-1	Categoría:Wikipedia:Wikipedistas con nivel básico de serbocroata
Tʼááłáhági átʼéego:Choyoołʼįįhí sw-1	Categoría:Wikipedia:Wikipedistas con nivel básico de swahili
Tʼááłáhági átʼéego:Choyoołʼįįhí sa-1	Categoría:Wikipedia:Wikipedistas con nivel básico de sánscrito
Tʼááłáhági átʼéego:Choyoołʼįįhí tr-1	Categoría:Wikipedia:Wikipedistas con nivel básico de turco
Tʼááłáhági átʼéego:Choyoołʼįįhí vo-1	Categoría:Wikipedia:Wikipedistas con nivel básico de volapük
Tʼááłáhági átʼéego:Choyoołʼįįhí ar-1	Categoría:Wikipedia:Wikipedistas con nivel básico de árabe
Tʼááłáhági átʼéego:Choyoołʼįįhí be-4	Categoría:Wikipedia:Wikipedistas con nivel experto de bielorruso
Tʼááłáhági átʼéego:Choyoołʼįįhí cs-4	Categoría:Wikipedia:Wikipedistas con nivel experto de checo
Tʼááłáhági átʼéego:Choyoołʼįįhí ko-4	Categoría:Wikipedia:Wikipedistas con nivel experto de coreano
Tʼááłáhági átʼéego:Choyoołʼįįhí sl-4	Categoría:Wikipedia:Wikipedistas con nivel experto de esloveno
Tʼááłáhági átʼéego:Choyoołʼįįhí et-4	Categoría:Wikipedia:Wikipedistas con nivel experto de estonio
Tʼááłáhági átʼéego:Choyoołʼįįhí fr-4	Categoría:Wikipedia:Wikipedistas con nivel experto de francés
Tʼááłáhági átʼéego:Choyoołʼįįhí cy-4	Categoría:Wikipedia:Wikipedistas con nivel experto de galés
Tʼááłáhági átʼéego:Choyoołʼįįhí gn-4	Categoría:Wikipedia:Wikipedistas con nivel experto de guaraní
Tʼááłáhági átʼéego:Choyoołʼįįhí hi-4	Categoría:Wikipedia:Wikipedistas con nivel experto de hindi
Tʼááłáhági átʼéego:Choyoołʼįįhí hu-4	Categoría:Wikipedia:Wikipedistas con nivel experto de húngaro
Tʼááłáhági átʼéego:Choyoołʼįįhí id-4	Categoría:Wikipedia:Wikipedistas con nivel experto de indonesio
Tʼááłáhági átʼéego:Choyoołʼįįhí ia-4	Categoría:Wikipedia:Wikipedistas con nivel experto de interlingua
Tʼááłáhági átʼéego:Choyoołʼįįhí it-4	Categoría:Wikipedia:Wikipedistas con nivel experto de italiano
Tʼááłáhági átʼéego:Choyoołʼįįhí li-4	Categoría:Wikipedia:Wikipedistas con nivel experto de limburgués
Tʼááłáhági átʼéego:Choyoołʼįįhí lt-4	Categoría:Wikipedia:Wikipedistas con nivel experto de lituano
Tʼááłáhági átʼéego:Choyoołʼįįhí mk-4	Categoría:Wikipedia:Wikipedistas con nivel experto de macedonio
Tʼááłáhági átʼéego:Choyoołʼįįhí nah-4	Categoría:Wikipedia:Wikipedistas con nivel experto de náhuatl
Tʼááłáhági átʼéego:Choyoołʼįįhí oc-4	Categoría:Wikipedia:Wikipedistas con nivel experto de occitano
Tʼááłáhági átʼéego:Choyoołʼįįhí pl-4	Categoría:Wikipedia:Wikipedistas con nivel experto de polaco
Tʼááłáhági átʼéego:Choyoołʼįįhí sh-4	Categoría:Wikipedia:Wikipedistas con nivel experto de serbocroata
Tʼááłáhági átʼéego:Choyoołʼįįhí sw-4	Categoría:Wikipedia:Wikipedistas con nivel experto de swahili
Tʼááłáhági átʼéego:Choyoołʼįįhí ar-4	Categoría:Wikipedia:Wikipedistas con nivel experto de árabe
Tʼááłáhági átʼéego:Choyoołʼįįhí als-2	Categoría:Wikipedia:Wikipedistas con nivel intermedio de Alemannisch
Tʼááłáhági átʼéego:Choyoołʼįįhí mzn-2	Categoría:Wikipedia:Wikipedistas con nivel intermedio de Mazanderani
Tʼááłáhági átʼéego:Choyoołʼįįhí be-2	Categoría:Wikipedia:Wikipedistas con nivel intermedio de bielorruso
Tʼááłáhági átʼéego:Choyoołʼįįhí bs-2	Categoría:Wikipedia:Wikipedistas con nivel intermedio de bosnio
Tʼááłáhági átʼéego:Choyoołʼįįhí ce-2	Categoría:Wikipedia:Wikipedistas con nivel intermedio de checheno
Tʼááłáhági átʼéego:Choyoołʼįįhí cs-2	Categoría:Wikipedia:Wikipedistas con nivel intermedio de checo
Tʼááłáhági átʼéego:Choyoołʼįįhí da-2	Categoría:Wikipedia:Wikipedistas con nivel intermedio de danés
Tʼááłáhági átʼéego:Choyoołʼįįhí sk-2	Categoría:Wikipedia:Wikipedistas con nivel intermedio de eslovaco
Tʼááłáhági átʼéego:Choyoołʼįįhí sl-2	Categoría:Wikipedia:Wikipedistas con nivel intermedio de esloveno
Tʼááłáhági átʼéego:Choyoołʼįįhí et-2	Categoría:Wikipedia:Wikipedistas con nivel intermedio de estonio
Tʼááłáhági átʼéego:Choyoołʼįįhí fr-2	Categoría:Wikipedia:Wikipedistas con nivel intermedio de francés
Tʼááłáhági átʼéego:Choyoołʼįįhí cy-2	Categoría:Wikipedia:Wikipedistas con nivel intermedio de galés
Tʼááłáhági átʼéego:Choyoołʼįįhí gn-2	Categoría:Wikipedia:Wikipedistas con nivel intermedio de guaraní
Tʼááłáhági átʼéego:Choyoołʼįįhí hi-2	Categoría:Wikipedia:Wikipedistas con nivel intermedio de hindi
Tʼááłáhági átʼéego:Choyoołʼįįhí hu-2	Categoría:Wikipedia:Wikipedistas con nivel intermedio de húngaro
Tʼááłáhági átʼéego:Choyoołʼįįhí ia-2	Categoría:Wikipedia:Wikipedistas con nivel intermedio de interlingua
Tʼááłáhági átʼéego:Choyoołʼįįhí it-2	Categoría:Wikipedia:Wikipedistas con nivel intermedio de italiano
Tʼááłáhági átʼéego:Choyoołʼįįhí ja-2	Categoría:Wikipedia:Wikipedistas con nivel intermedio de japonés
Tʼááłáhági átʼéego:Choyoołʼįįhí rn-2	Categoría:Wikipedia:Wikipedistas con nivel intermedio de kiroundi
Tʼááłáhági átʼéego:Choyoołʼįįhí la-2	Categoría:Wikipedia:Wikipedistas con nivel intermedio de latín
Tʼááłáhági átʼéego:Choyoołʼįįhí li-2	Categoría:Wikipedia:Wikipedistas con nivel intermedio de limburgués
Tʼááłáhági átʼéego:Choyoołʼįįhí lt-2	Categoría:Wikipedia:Wikipedistas con nivel intermedio de lituano
Tʼááłáhági átʼéego:Choyoołʼįįhí mk-2	Categoría:Wikipedia:Wikipedistas con nivel intermedio de macedonio
Tʼááłáhági átʼéego:Choyoołʼįįhí mwl-2	Categoría:Wikipedia:Wikipedistas con nivel intermedio de mirandés
Tʼááłáhági átʼéego:Choyoołʼįįhí nl-2	Categoría:Wikipedia:Wikipedistas con nivel intermedio de neerlandés
Tʼááłáhági átʼéego:Choyoołʼįįhí nah-2	Categoría:Wikipedia:Wikipedistas con nivel intermedio de náhuatl
Tʼááłáhági átʼéego:Choyoołʼįįhí oc-2	Categoría:Wikipedia:Wikipedistas con nivel intermedio de occitano
Tʼááłáhági átʼéego:Choyoołʼįįhí pl-2	Categoría:Wikipedia:Wikipedistas con nivel intermedio de polaco
Tʼááłáhági átʼéego:Choyoołʼįįhí sh-2	Categoría:Wikipedia:Wikipedistas con nivel intermedio de serbocroata
Tʼááłáhági átʼéego:Choyoołʼįįhí sv-2	Categoría:Wikipedia:Wikipedistas con nivel intermedio de sueco
Tʼááłáhági átʼéego:Choyoołʼįįhí sw-2	Categoría:Wikipedia:Wikipedistas con nivel intermedio de swahili
Tʼááłáhági átʼéego:Choyoołʼįįhí sa-2	Categoría:Wikipedia:Wikipedistas con nivel intermedio de sánscrito
Tʼááłáhági átʼéego:Choyoołʼįįhí tr-2	Categoría:Wikipedia:Wikipedistas con nivel intermedio de turco
Tʼááłáhági átʼéego:Choyoołʼįįhí vo-2	Categoría:Wikipedia:Wikipedistas con nivel intermedio de volapük
Tʼááłáhági átʼéego:Choyoołʼįįhí ar-2	Categoría:Wikipedia:Wikipedistas con nivel intermedio de árabe
Tʼááłáhági átʼéego:Choyoołʼįįhí bjn-N	Categoría:Wikipedia:Wikipedistas con nivel nativo de Banjar
Tʼááłáhági átʼéego:Choyoołʼįįhí bew-N	Categoría:Wikipedia:Wikipedistas con nivel nativo de Betawi
Tʼááłáhági átʼéego:Choyoołʼįįhí at-N	Categoría:Wikipedia:Wikipedistas con nivel nativo de alemán austríaco
Tʼááłáhági átʼéego:Choyoołʼįįhí an-N	Categoría:Wikipedia:Wikipedistas con nivel nativo de aragonés
Tʼááłáhági átʼéego:Choyoołʼįįhí hy-N	Categoría:Wikipedia:Wikipedistas con nivel nativo de armenio
Tʼááłáhági átʼéego:Choyoołʼįįhí ast-N	Categoría:Wikipedia:Wikipedistas con nivel nativo de asturiano
Tʼááłáhági átʼéego:Choyoołʼįįhí be-N	Categoría:Wikipedia:Wikipedistas con nivel nativo de bielorruso
Tʼááłáhági átʼéego:Choyoołʼįįhí cs-N	Categoría:Wikipedia:Wikipedistas con nivel nativo de checo
Tʼááłáhági átʼéego:Choyoołʼįįhí chr-N	Categoría:Wikipedia:Wikipedistas con nivel nativo de cherokee
Tʼááłáhági átʼéego:Choyoołʼįįhí ko-N	Categoría:Wikipedia:Wikipedistas con nivel nativo de coreano
Tʼááłáhági átʼéego:Choyoołʼįįhí hr-N	Categoría:Wikipedia:Wikipedistas con nivel nativo de croata
Tʼááłáhági átʼéego:Choyoołʼįįhí sl-N	Categoría:Wikipedia:Wikipedistas con nivel nativo de esloveno
Tʼááłáhági átʼéego:Choyoołʼįįhí et-N	Categoría:Wikipedia:Wikipedistas con nivel nativo de estonio
Tʼááłáhági átʼéego:Choyoołʼįįhí fr-N	Categoría:Wikipedia:Wikipedistas con nivel nativo de francés
Tʼááłáhági átʼéego:Choyoołʼįįhí fy-N	Categoría:Wikipedia:Wikipedistas con nivel nativo de frisón occidental
Tʼááłáhági átʼéego:Choyoołʼįįhí gl-N	Categoría:Wikipedia:Wikipedistas con nivel nativo de gallego
Tʼááłáhági átʼéego:Choyoołʼįįhí cy-N	Categoría:Wikipedia:Wikipedistas con nivel nativo de galés
Tʼááłáhági átʼéego:Choyoołʼįįhí gn-N	Categoría:Wikipedia:Wikipedistas con nivel nativo de guaraní
Tʼááłáhági átʼéego:Choyoołʼįįhí hi-N	Categoría:Wikipedia:Wikipedistas con nivel nativo de hindi
Tʼááłáhági átʼéego:Choyoołʼįįhí id-N	Categoría:Wikipedia:Wikipedistas con nivel nativo de indonesio
Tʼááłáhági átʼéego:Choyoołʼįįhí ia-N	Categoría:Wikipedia:Wikipedistas con nivel nativo de interlingua
Tʼááłáhági átʼéego:Choyoołʼįįhí is-N	Categoría:Wikipedia:Wikipedistas con nivel nativo de islandés
Tʼááłáhági átʼéego:Choyoołʼįįhí it-N	Categoría:Wikipedia:Wikipedistas con nivel nativo de italiano
Tʼááłáhági átʼéego:Choyoołʼįįhí jv-N	Categoría:Wikipedia:Wikipedistas con nivel nativo de javanés
Tʼááłáhági átʼéego:Choyoołʼįįhí ku-N	Categoría:Wikipedia:Wikipedistas con nivel nativo de kurdo
Tʼááłáhági átʼéego:Choyoołʼįįhí lv-N	Categoría:Wikipedia:Wikipedistas con nivel nativo de letón
Tʼááłáhági átʼéego:Choyoołʼįįhí li-N	Categoría:Wikipedia:Wikipedistas con nivel nativo de limburgués
Tʼááłáhági átʼéego:Choyoołʼįįhí lt-N	Categoría:Wikipedia:Wikipedistas con nivel nativo de lituano
Tʼááłáhági átʼéego:Choyoołʼįįhí lb-N	Categoría:Wikipedia:Wikipedistas con nivel nativo de luxemburgués
Tʼááłáhági átʼéego:Choyoołʼįįhí mk-N	Categoría:Wikipedia:Wikipedistas con nivel nativo de macedonio
Tʼááłáhági átʼéego:Choyoołʼįįhí mg-N	Categoría:Wikipedia:Wikipedistas con nivel nativo de malgache
Tʼááłáhági átʼéego:Choyoołʼįįhí mwl-N	Categoría:Wikipedia:Wikipedistas con nivel nativo de mirandés
Tʼááłáhági átʼéego:Choyoołʼįįhí nl-N	Categoría:Wikipedia:Wikipedistas con nivel nativo de neerlandés
Tʼááłáhági átʼéego:Choyoołʼįįhí no-N	Categoría:Wikipedia:Wikipedistas con nivel nativo de noruego
Tʼááłáhági átʼéego:Choyoołʼįįhí nn-N	Categoría:Wikipedia:Wikipedistas con nivel nativo de nynorsk noruego
Tʼááłáhági átʼéego:Choyoołʼįįhí nah-N	Categoría:Wikipedia:Wikipedistas con nivel nativo de náhuatl
Tʼááłáhági átʼéego:Choyoołʼįįhí oc-N	Categoría:Wikipedia:Wikipedistas con nivel nativo de occitano
Tʼááłáhági átʼéego:Choyoołʼįįhí or-N	Categoría:Wikipedia:Wikipedistas con nivel nativo de oriya
Tʼááłáhági átʼéego:Choyoołʼįįhí ru-N	Categoría:Wikipedia:Wikipedistas con nivel nativo de ruso
Tʼááłáhági átʼéego:Choyoołʼįįhí sh-N	Categoría:Wikipedia:Wikipedistas con nivel nativo de serbocroata
Tʼááłáhági átʼéego:Choyoołʼįįhí sw-N	Categoría:Wikipedia:Wikipedistas con nivel nativo de swahili
Tʼááłáhági átʼéego:Choyoołʼįįhí sa-N	Categoría:Wikipedia:Wikipedistas con nivel nativo de sánscrito
Tʼááłáhági átʼéego:Choyoołʼįįhí ta-N	Categoría:Wikipedia:Wikipedistas con nivel nativo de tamil
Tʼááłáhági átʼéego:Choyoołʼįįhí ar-N	Categoría:Wikipedia:Wikipedistas con nivel nativo de árabe
Tʼááłáhági átʼéego:Choyoołʼįįhí cs-5	Categoría:Wikipedia:Wikipedistas con nivel profesional de checo
Tʼááłáhági átʼéego:Choyoołʼįįhí af	Categoría:Wikipedia:Wikipedistas con conocimientos de afrikaans
Tʼááłáhági átʼéego:Choyoołʼįįhí af-1	Categoría:Wikipedia:Wikipedistas con nivel básico de afrikáans
Tʼááłáhági átʼéego:Choyoołʼįįhí af-2	Categoría:Wikipedia:Wikipedistas con nivel intermedio de afrikaans
Tʼááłáhági átʼéego:Choyoołʼįįhí af-3	Categoría:Wikipedia:Wikipedistas con nivel avanzado de afrikaans
Tʼááłáhági átʼéego:Choyoołʼįįhí af-4	Categoría:Wikipedia:Wikipedistas con nivel experto de afrikaans
Tʼááłáhági átʼéego:Choyoołʼįįhí af-N	Categoría:Wikipedia:Wikipedistas con nivel nativo de afrikaans
Tʼááłáhági átʼéego:Choyoołʼįįhí als	Categoría:Wikipedia:Wikipedistas con conocimientos de Alemannisch
Tʼááłáhági átʼéego:Choyoołʼįįhí als-1	Categoría:Wikipedia:Wikipedistas con nivel básico de Alemannisch
Tʼááłáhági átʼéego:Choyoołʼįįhí an	Categoría:Wikipedia:Wikipedistas con conocimientos de aragonés
Tʼááłáhági átʼéego:Choyoołʼįįhí ar	Categoría:Wikipedia:Wikipedistas con conocimientos de árabe
Tʼááłáhági átʼéego:Choyoołʼįįhí ay	Categoría:Wikipedia:Wikipedistas con conocimientos de aimara
Tʼááłáhági átʼéego:Choyoołʼįįhí ay-1	Categoría:Wikipedia:Wikipedistas con nivel básico de aimara
Tʼááłáhági átʼéego:Tádídíín deiyání	Categoría:Chrysomelidae
Tʼááłáhági átʼéego:Choyoołʼįįhí cs	Categoría:Wikipedia:Wikipedistas con conocimientos de checo
Tʼááłáhági átʼéego:Choyoołʼįįhí csb	Categoría:Wikipedia:Wikipedistas con conocimientos de casubio
Tʼááłáhági átʼéego:Choyoołʼįįhí csb-1	Categoría:Wikipedia:Wikipedistas con nivel básico de casubio
Tʼááłáhági átʼéego:Choyoołʼįįhí da	Categoría:Wikipedia:Wikipedistas con conocimientos de danés
Tʼááłáhági átʼéego:Choyoołʼįįhí sk-N	Categoría:Wikipedia:Wikipedistas con nivel nativo de eslovaco
Tʼááłáhági átʼéego:Choyoołʼįįhí de	Categoría:Wikipedia:Wikipedistas con conocimientos de alemán
Tʼááłáhági átʼéego:Choyoołʼįįhí de-2	Categoría:Wikipedia:Wikipedistas con nivel intermedio de alemán
Tʼááłáhági átʼéego:Choyoołʼįįhí de-3	Categoría:Wikipedia:Wikipedistas con nivel avanzado de alemán
Tʼááłáhági átʼéego:Choyoołʼįįhí de-4	Categoría:Wikipedia:Wikipedistas con nivel experto de alemán
Tʼááłáhági átʼéego:Choyoołʼįįhí de-N	Categoría:Wikipedia:Wikipedistas con nivel nativo de alemán
Tʼááłáhági átʼéego:Choyoołʼįįhí el	Categoría:Wikipedia:Wikipedistas con conocimientos de griego antiguo
Tʼááłáhági átʼéego:Choyoołʼįįhí en-3	Categoría:Wikipedia:Wikipedistas con nivel avanzado de inglés
Tʼááłáhági átʼéego:Choyoołʼįįhí en-5	Categoría:Wikipedia:Wikipedistas con nivel profesional de inglés
Tʼááłáhági átʼéego:Choyoołʼįįhí en-N	Categoría:Wikipedia:Wikipedistas con nivel nativo de inglés
Tʼááłáhági átʼéego:Choyoołʼįįhí eo-1	Categoría:Wikipedia:Wikipedistas con nivel básico de esperanto
Tʼááłáhági átʼéego:Choyoołʼįįhí es	Categoría:Wikipedia:Wikipedistas con conocimientos de español
Tʼááłáhági átʼéego:Choyoołʼįįhí es-1	Categoría:Wikipedia:Wikipedistas con nivel básico de español
Tʼááłáhági átʼéego:Choyoołʼįįhí es-2	Categoría:Wikipedia:Wikipedistas con nivel intermedio de español
Tʼááłáhági átʼéego:Choyoołʼįįhí es-3	Categoría:Wikipedia:Wikipedistas con nivel avanzado de español
Tʼááłáhági átʼéego:Choyoołʼįįhí es-4	Categoría:Wikipedia:Wikipedistas con nivel experto de español
Tʼááłáhági átʼéego:Choyoołʼįįhí es-N	Categoría:Wikipedia:Wikipedistas con nivel nativo de español
Tʼááłáhági átʼéego:Gólízhii	Categoría:Mephitidae
Tʼááłáhági átʼéego:Choyoołʼįįhí gsw	Categoría:Wikipedia:Wikipedistas con conocimientos de alemán suizo
Tʼááłáhági átʼéego:Choyoołʼįįhí gsw-N	Categoría:Wikipedia:Wikipedistas con nivel nativo de alemán suizo
Tʼááłáhági átʼéego:Choyoołʼįįhí hu	Categoría:Wikipedia:Wikipedistas con conocimientos de húngaro
Tʼááłáhági átʼéego:Choyoołʼįįhí hy	Categoría:Wikipedia:Wikipedistas con conocimientos de armenio
Tʼááłáhági átʼéego:Choyoołʼįįhí als-N	Categoría:Wikipedia:Wikipedistas con nivel nativo de Alemannisch
Tʼááłáhági átʼéego:Choyoołʼįįhí pl-N	Categoría:Wikipedia:Wikipedistas con nivel nativo de polaco
Tʼááłáhági átʼéego:Choyoołʼįįhí pt-1	Categoría:Wikipedia:Wikipedistas con nivel básico de portugués
ShiŁeetsʼaʼ	MiPlato
Ńdíshchííʼ Ląʼí / Naashtʼézhí Dził	Sierra de Zuñi
Bee álnééhí:Hooʼááłígíí	Usuario:Userbox/Bibliotecario
Tʼááłáhági átʼéego:Choyoołʼįįhí it	Categoría:Wikipedia:Wikipedistas con conocimientos de italiano
Tʼááłáhági átʼéego:Choyoołʼįįhí it-1	Categoría:Wikipedia:Wikipedistas con nivel básico de italiano
Tʼááłáhági átʼéego:Choyoołʼįįhí ja-1	Categoría:Wikipedia:Wikipedistas con nivel básico de japonés
Tʼááłáhági átʼéego:Choyoołʼįįhí ka	Categoría:Wikipedia:Wikipedistas con conocimientos de georgiano
Tʼááłáhági átʼéego:Choyoołʼįįhí ko	Categoría:Wikipedia:Wikipedistas con conocimientos de coreano
Tʼááłáhági átʼéego:Wááshindoon bikéyah bił haʼdaʼhaasdzoígíí	Categoría:Estados de Estados Unidos
Tʼááłáhági átʼéego:Choyoołʼįįhí ku	Categoría:Wikipedia:Wikipedistas con conocimientos de kurdo
Tʼááłáhági átʼéego:Choyoołʼįįhí la-1	Categoría:Wikipedia:Wikipedistas con nivel básico de latín
Tʼááłáhági átʼéego:Dibé Nitsaa Hahoodzodi kin naaznilígíí	Categoría:Asentamientos de Colorado
Tʼááłáhági átʼéego:Choyoołʼįįhí ru-1	Categoría:Wikipedia:Wikipedistas con nivel básico de ruso
Yaaʼ bijáád hastánígíí	Phthiraptera
Tʼááłáhági átʼéego:Chʼil bikétłʼóól daadánígíí	Categoría:Raíces y tubérculos comestibles
Tʼááłáhági átʼéego:Choyoołʼįįhí lo	Categoría:Wikipedia:Wikipedistas con conocimientos de laosiano
Tʼááłáhági átʼéego:Choyoołʼįįhí lv	Categoría:Wikipedia:Wikipedistas con conocimientos de letón
Nahasdzáán bimagnetic field	Campo magnético terrestre
Tsiiʼyiishbizhí dinéʼiʼ	Pueblo chino
Tʼááłáhági átʼéego:Choyoołʼįįhí als-3	Categoría:Wikipedia:Wikipedistas con nivel avanzado de Alemannisch
Tʼááłáhági átʼéego:Choyoołʼįįhí es-5	Categoría:Wikipedia:Wikipedistas con nivel profesional de español
Tʼááłáhági átʼéego:Kéyah Ałhidadiidzooígíí dóó Ahiih Yikaígíí	Categoría:Organizaciones internacionales
Tʼááłáhági átʼéego:Chʼosh bijáád dahólónígíí	Categoría:Arthropoda
Tʼááłáhági átʼéego:Tó	Categoría:Agua
Tʼááłáhági átʼéego:Tsáʼásziʼ dóó Noodah	Categoría:Agavaceae
Tʼááłáhági átʼéego:Bidił daazdoígíí dóó daʼalghałígíí	Categoría:Carnivora
Tʼááłáhági átʼéego:Choyoołʼįįhí nb	Categoría:Wikipedia:Wikipedistas con conocimientos de bokmal noruego
Tʼááłáhági átʼéego:Naakaii Łizhiní Bikéyah	Categoría:Países de África
Tʼááłáhági átʼéego:Tsin bineestʼąʼ dadíkʼǫ́zhígíí	Categoría:Citrus
Tʼááłáhági átʼéego:Choyoołʼįįhí ru	Categoría:Wikipedia:Wikipedistas con conocimientos de ruso
Tʼááłáhági átʼéego:Choyoołʼįįhí ru-2	Categoría:Wikipedia:Wikipedistas con nivel intermedio de ruso
Tʼááłáhági átʼéego:Choyoołʼįįhí ru-3	Categoría:Wikipedia:Wikipedistas con nivel avanzado de ruso
Tʼááłáhági átʼéego:Choyoołʼįįhí ru-4	Categoría:Wikipedia:Wikipedistas con nivel experto de ruso
Tʼááłáhági átʼéego:Choyoołʼįįhí stq	Categoría:Wikipedia:Wikipedistas con conocimientos de Seeltersk
Tʼááłáhági átʼéego:Choyoołʼįįhí tr	Categoría:Wikipedia:Wikipedistas con conocimientos de turco
Tʼááłáhági átʼéego:Choyoołʼįįhí tr-4	Categoría:Wikipedia:Wikipedistas con nivel experto de turco
Tʼááłáhági átʼéego:Choyoołʼįįhí tr-N	Categoría:Wikipedia:Wikipedistas con nivel nativo de turco
Tʼááłáhági átʼéego:Tsin ííʼáhígíí	Categoría:Árboles y arbustos
Náshdóítsoh (Ałtsʼáʼáztiin)	Grandes felinos
Tʼááłáhági átʼéego:Mágí: Diné Ndahalinígíí	Categoría:Hominoidea
Tʼááłáhági átʼéego:Mágí	Categoría:Primates
Bee álnééhí:LivingP	Plantilla:BPV
Tʼááłáhági átʼéego:Naʼiiniʼ	Categoría:Comercio
Tʼááłáhági átʼéego:Naaki góneʼ yéigo daʼahijoogą́ą́ʼ	Categoría:Segunda Guerra Mundial
Gad niʼeełii bílátah łichíʼígíí	Tamarix chinensis
Chʼil abeʼétsʼóóz	Euphorbia fendleri
Tʼááłáhági átʼéego:Mósí dóó Náshdóí	Categoría:Felidae
Dahiitį́hídą́ą́ʼ	Silene laciniata
Kʼíneedlíshii	Eleodes
Tʼááłáhági átʼéego:Naakaii Łizhiní Bikéyahdę́ę́ʼ Ndaaldeehii	Categoría:Fauna de África
Tʼááłáhági átʼéego:Hakʼazdi Ndaaldeehii	Categoría:Fauna del océano Ártico
Kʼįįʼ báhádzidígíí	Toxicodendron vernix
Tʼááłáhági átʼéego:Choyoołʼįįhí nl	Categoría:Wikipedia:Wikipedistas con conocimientos de neerlandés
Tʼááłáhági átʼéego:Choyoołʼįįhí nn-3	Categoría:Wikipedia:Wikipedistas con nivel avanzado de nynorsk noruego
Tʼááłáhági átʼéego:Choyoołʼįįhí no	Categoría:Wikipedia:Wikipedistas con conocimientos de noruego
Tʼááłáhági átʼéego:Choyoołʼįįhí zh-1	Categoría:Wikipedia:Wikipedistas con nivel básico de chino
Tʼááłáhági átʼéego:Chʼał	Categoría:Anura
Tʼááłáhági átʼéego:Atłʼóóh	Categoría:Tejeduría
Tʼááłáhági átʼéego:Mąʼii yił Ałhidanoolinígíí Yázhí	Categoría:Procyonidae
Tʼááłáhági átʼéego:Dlǫ́ʼiitsoh Danilínígíí	Categoría:Viverridae
Tʼááłáhági átʼéego:Chéłchaaʼ	Categoría:Coleoptera
Tʼááłáhági átʼéego:Naakáí dootłʼizhí dóó Bééshbichʼahii dabizaad ndahalinígíí	Categoría:Lenguas indoeuropeas
Tʼááłáhági átʼéego:Hazéí	Categoría:Sciuridae
Tʼááłáhági átʼéego:Chidí naatʼaʼí ńdinibįįhígi	Categoría:Aeropuertos
Tʼááłáhági átʼéego:Áʼádaatʼéhígíí	Categoría:Elementos químicos
Tʼááłáhági átʼéego:Mósí Danilínígíí	Categoría:Felis
Tʼááłáhági átʼéego:Biwooʼ Ádaałtsʼíísígíí dóó Kááʼtsʼiní	Categoría:Xenarthra
Tʼááłáhági átʼéego:Abeʼ bitsʼą́ą́dóó ádaalyaaígíí	Categoría:Lácteos
Tʼááłáhági átʼéego:Tsin dóó chʼil bineestʼąʼ	Categoría:Frutas
Tʼááłáhági átʼéego:Kʼaalógii dóó Iichʼąhii	Categoría:Lepidoptera
Tʼááłáhági átʼéego:Chʼosh bijáád ádaadinígíí	Categoría:Mollusca
Tʼááłáhági átʼéego:Deeteel Bikéyah bił haʼdaʼhaasdzoígíí	Categoría:Provincias y territorios de Canadá
Tʼááłáhági átʼéego:Shádiʼááhdę́ę́ʼ Mágí	Categoría:Platyrrhini
Tʼááłáhági átʼéego:Gáagii dóó Joogii Ndahalinígíí	Categoría:Corvidae
Tʼááłáhági átʼéego:Mąʼii dóó Łééchąąʼí	Categoría:Canidae
Tʼááłáhági átʼéego:Ayání dóó Béégashii	Categoría:Bovinae
Tʼááłáhági átʼéego:Tó Wónaanídę́ę́ʼ Mágí	Categoría:Cercopithecidae
Tʼááłáhági átʼéego:Naayízí dóó taʼneeskʼání	Categoría:Cucurbitaceae
Tʼááłáhági átʼéego:Dlǫ́ʼii Ndahalinígíí	Categoría:Mustelidae
Tʼááłáhági átʼéego:Łóóʼtsoh biwooʼ dantłʼizígíí	Categoría:Odontoceti
Tʼááłáhági átʼéego:Łóóʼtsoh biwooʼ daditsʼózígíí	Categoría:Mysticeti
Adidlą́halchiin	Valeriana arizonica
Ałtsáʼázchʼil	Purshia stansburyana
Tʼááłáhági átʼéego:Naaldeehii	Categoría:Animales
Tʼááłáhági átʼéego:Shádiʼááhdę́ę́ʼ Ndaaldeehii	Categoría:Fauna de América del Sur
Tʼááłáhági átʼéego:Bizaʼazis Dahólónígíí	Categoría:Marsupialia
Nahashtʼeʼii azis (chʼil)	Reverchonia
Tʼááłáhági átʼéego:Chʼosh chʼééh diikáhii	Categoría:Gastropoda
Tʼááłáhági átʼéego:Chʼosh bitsʼaʼígíí	Categoría:Bivalvia
Jádí nátʼoh	Pleiacanthus
Tʼááłáhági átʼéego:Gah	Categoría:Lagomorpha
Tʼááłáhági átʼéego:Łóóʼtsoh dóó Tééh hóyáanii	Categoría:Cetacea
Gad bidahtsʼaaʼ	Phoradendron juniperinum
Tʼááłáhági átʼéego:Łóóʼ Bigaan Dahólónígíí	Categoría:Cephalopoda
Tʼááłáhági átʼéego:Chʼééh digháhii dóó Tsisteeł	Categoría:Testudines
Dah diníilghaazh	Frybread
Tʼááłáhági átʼéego:Béésh	Categoría:Metales
Tʼááłáhági átʼéego:Naayééʼ	Categoría:Dinosauria
Tʼááłáhági átʼéego:Choyoołʼįįhí pl	Categoría:Wikipedia:Wikipedistas con conocimientos de polaco
Tʼááłáhági átʼéego:Chʼosh bikágí dantłʼizí	Categoría:Crustacea
Tʼááłáhági átʼéego:Jaaʼabaní	Categoría:Chiroptera
Tʼááłáhági átʼéego:Tłʼiish	Categoría:Serpentes
Tʼááłáhági átʼéego:Shádiʼááhjí kéyah yistinígíí	Categoría:Antártida
Tʼááłáhági átʼéego:Beʼekʼid	Categoría:Lagos
Kʼíshíshjį́į́zh	Toxicodendron radicans
Tʼááłáhági átʼéego:Bįįh	Categoría:Cervidae
Tʼááłáhági átʼéego:Łóóʼ hashkéhé	Categoría:Selachimorpha
Tʼááłáhági átʼéego:Łóóʼ ooshgę́ęzhii	Categoría:Chondrichthyes
Tʼááłáhági átʼéego:Chidí	Categoría:Automoción
Chąąshtʼezhiitsoh	Daucus carota
Tó Háálį́	Quemado (Nuevo México)
Tsé Łichííʼ Deezʼáhí	Red Rock (condado de Apache, Arizona)
Tʼááłáhági átʼéego:Kéyah bił haʼdaʼhaasdzoígíí	Categoría:Entidades subnacionales
Haltso (Yootó Hahoodzo)	San Mateo (Nuevo México)
Tséyooʼáałii	Curculionidae
Tʼááłáhági átʼéego:Łį́į́ʼ Ndahalinígíí	Categoría:Equidae
Tʼááłáhági átʼéego:Naabeehó	Categoría:Navajos
Tʼááłáhági átʼéego:Wóʼatsʼǫǫsii Ádaatʼéhígíí	Categoría:Hemiptera
Tʼááłáhági átʼéego:Tsin Deigházhígíí	Categoría:Rodentia
Tʼááłáhági átʼéego:Choyoołʼįįhí ab	Categoría:Wikipedia:Wikipedistas con conocimientos de abjasio
Tʼááłáhági átʼéego:Choyoołʼįįhí ab-3	Categoría:Wikipedia:Wikipedistas con nivel avanzado de abjasio
Tséyaa Akʼahí (Chʼį́įdii Łichííʼ)	Waterflow (Nuevo México)
Tʼááłáhági átʼéego:Dlǫ́ʼii yił Aheedaałtʼéhígíí	Categoría:Herpestidae
Tʼááłáhági átʼéego:Hoozdo Hahoodzodi kin naaznilígíí	Categoría:Asentamientos de Arizona
Tʼááłáhági átʼéego:Hoozdo Hahoodzodi chidí naatʼaʼí ńdinibįįhígi	Categoría:Aeropuertos de Arizona
Tʼááłáhági átʼéego:Yootó Hahoodzodi chidí naatʼaʼí ńdinibįįhígi	Categoría:Aeropuertos de Nuevo México
Tʼááłáhági átʼéego:Beeʼeldííldahsinil	Categoría:Albuquerque
Tʼááłáhági átʼéego:Tábąąstííntsoh	Categoría:Pinnipedia
Tʼááłáhági átʼéego:Táłkáaʼgi Tsídii	Categoría:Anseriformes
Tʼááłáhági átʼéego:Tsísʼná dóó Wáláchííʼ	Categoría:Apocrita
Tʼááłáhági átʼéego:Chʼosh bijáád tseebíhígíí	Categoría:Arachnida
Tʼááłáhági átʼéego:Yágháhonikáánji biłnaaztʼiʼígíí	Categoría:Exploración espacial
Tʼááłáhági átʼéego:Shash	Categoría:Ursidae
Tʼááłáhági átʼéego:Tsin deiłkaałii	Categoría:Picidae
Tʼááłáhági átʼéego:Tsékooh	Categoría:Desfiladeros
Tó bichʼoshtsoh	Belostomatidae
Tʼááłáhági átʼéego:Chʼosh bijáád neeznánígíí	Categoría:Decapoda
Tʼááłáhági átʼéego:Bílaʼashdlaʼii bilį́į́ʼ danilínígíí	Categoría:Animales domesticados
Tʼááłáhági átʼéego:Dziil / Atsiniltłʼish álʼį́	Categoría:Energía
Tʼááłáhági átʼéego:Shádiʼááh biyaadi dóó Kéyah Yistinígíí bikáaʼgi Ndaaldeehii	Categoría:Fauna de la Antártida
Tʼááłáhági átʼéego:Nahatʼeʼiitsoh Bikéyahdę́ę́ʼ Ndaaldeehii	Categoría:Fauna de Australia
Tʼááłáhági átʼéego:Naakaii Dootłʼizhii Dabikéyahdę́ę́ʼ Ndaaldeehii	Categoría:Fauna del subcontinente Indio
Tʼááłáhági átʼéego:Tsʼíʼii dóó Tséʼédǫ́ʼii	Categoría:Diptera
Tʼááłáhági átʼéego:Tązhii dóó Naaʼahóóhai Ndahalinígíí	Categoría:Galliformes
Tʼááłáhági átʼéego:Tééh łééchąąʼí	Categoría:Hyaenidae
Tʼááłáhági átʼéego:Wónitłʼizí	Categoría:Isopoda
Tʼááłáhági átʼéego:Kǫʼ naʼałbąąsii ninádaaltłiʼígi	Categoría:Estaciones de ferrocarril
Tʼááłáhági átʼéego:Daʼałtʼoʼígíí biyęęzhii deiłchíhígíí	Categoría:Monotremata
Tʼááłáhági átʼéego:Nahachagii dóó Nahakʼízii	Categoría:Orthoptera
Tʼááłáhági átʼéego:Chéłchaaʼ bigaantéłígíí	Categoría:Scarabaeidae
Tʼááłáhági átʼéego:Tábąąsdísí	Categoría:Scolopacidae
Tʼááłáhági átʼéego:Séigoʼ	Categoría:Scorpiones
Tʼááłáhági átʼéego:Táłtłʼááhdę́ę́ʼ dóó tónteel biyiʼdę́ę́ʼ chʼiyáán	Categoría:Marisco
Tʼááłáhági átʼéego:Tsin naaʼeeł	Categoría:Barcos
Tʼááłáhági átʼéego:Áshįįh Biiʼtó Hahoodzodi kin naazniilígíí	Categoría:Asentamientos de Utah
Tʼááłáhági átʼéego:Naʼashjéʼii	Categoría:Araneae
Tʼááłáhági átʼéego:Jááłánii	Categoría:Myriapoda
Tʼááłáhági átʼéego:Azeeʼ	Categoría:Plantas medicinales
Tʼááłáhági átʼéego:Naʼastsʼǫǫsí dóó Łéʼétsoh	Categoría:Muridae
Bee álnééhí:Image label begin	Plantilla:Etiqueta imagen inicio
Tʼááłáhági átʼéego:Yootó Hahoodzodi kin naaznilígíí	Categoría:Ciudades de Nuevo México
Tʼááłáhági átʼéego:Choyoołʼįįhí ay-N	Categoría:Wikipedia:Wikipedistas con nivel nativo de aimara
Tʼááłáhági átʼéego:Choyoołʼįįhí swg-3	Categoría:Wikipedia:Wikipedistas con nivel avanzado de Swabian
Tʼááłáhági átʼéego:Dibé dóó Tłʼízí Ndahalinígíí	Categoría:Caprinae
Tʼááłáhági átʼéego:Biishchʼid Dahólónígíí	Categoría:Placentalia
Tʼááłáhági átʼéego:Kiisʼáanii	Categoría:Indios pueblo
Tʼááłáhági átʼéego:Nahatʼeʼiitsoh Danilínígíí	Categoría:Macropodiformes
Tʼááłáhági átʼéego:Choyoołʼįįhí en-1	Categoría:Wikipedia:Wikipedistas con nivel básico de inglés
Tʼááłáhági átʼéego:Choyoołʼįįhí de-1	Categoría:Wikipedia:Wikipedistas con nivel básico de alemán
Tʼááłáhági átʼéego:Bikétłʼááh Hoolzhólígíí	Categoría:Tylopoda
Tʼááłáhági átʼéego:Choyoołʼįįhí da-N	Categoría:Wikipedia:Wikipedistas con nivel nativo de danés
Yaaʼ bijáád tseebíhígíí	Ixodida
Gáagii bitłʼohchin	Allium cernuum
Dahsání	Erethizon dorsatum
Mąʼii Deeshgiizhnii	Pueblo jemez
Chʼil naʼatłʼoʼiitsoh	Ciruela
Akétłʼóól łichxííʼí yázhí	Raphanus sativus
Bee álnééhí:Nobots	Plantilla:Nobots
Tsé nahalinii (łóóʼ)	Synanceia
Wónitłʼizí ntsxaaígíí	Isópodo Gigante
Special:RecentChanges	Especial:CambiosRecientes
Tʼááłáhági átʼéego:Choyoołʼįįhí ja-4	Categoría:Wikipedia:Wikipedistas con nivel experto de japonés
Gaantsʼosí dóó Sǫʼ łóóʼ biyaʼ	Myzostomida
Ábishjaaʼ łóóʼ	Dendrogramma
