Afrika	África
Jabaan	Japón
Ameerikada koonfureed	América del Sur
Norway	Noruega
Ingiriiska	Inglaterra
Skotland	Escocia
Waalis	Gales
Waqooyiga Ayrland	Irlanda del Norte
Ireland	Irlanda
Hungaria	Hungría
Isbania	España
Mareykanka	Estados Unidos
Beljim	Bélgica
Luksemburg	Luxemburgo
Koon	Universo
Dhul	Tierra
Nolosha	Vida
Biniaadan	Homo sapiens
George Washington	George Washington
Finland	Finlandia
Iswiidhan	Suecia
Denmark	Dinamarca
Boland	Polonia
Lithuaniya	Lituania
Talyaaniga	Italia
Iswisarland	Suiza
Austriya	Austria
Giriig	Grecia
Turkiga	Turquía
Bortuqaal	Portugal
Yurub	Europa
Aasiya	Asia
Woqooyiga Ameerika	América del Norte
Antiarktis	Antártida
Wikipedia	Wikipedia
Holland	Países Bajos
New York	Nueva York
Washington D.C	Washington D. C.
Baarliin	Berlín
Los Angeles	Los Ángeles
Boeing	Boeing
Kumbuyuutar	Computadora
Jineefa	Ginebra
Internet	Internet
Barack Obama	Barack Obama
Uruguay	Uruguay
London	Londres
Qaahiro	El Cairo
Baariis	París
Android	Android
Google	Google
Meksiko	México
Badweynta Atlaantik	Océano Atlántico
Badweynta Baasifik	Océano Pacífico
Kalifornia	California
Isniin	Lunes
Janaayo	Enero
Febraayo	Febrero
Maarso	Marzo
Farraare	Marte (planeta)
Kiinya	Kenia
Itoobiya	Etiopía
Gaana	Ghana
Abriil	Abril
May	Mayo
Juun	Junio
Luuliyo	Julio
Agoosto	Agosto
Sebteembar	Septiembre
Oktoobar	Octubre
Nofeembar	Noviembre
Diseembar	Diciembre
Talaado	Martes
Arbaco	Miércoles
Khamiis	Jueves
Jimco	Viernes
Sabti	Sábado
Axad	Domingo
Libaax	Panthera leo
Faransiiska	Francia
Esberanto	Esperanto
Ey	Canis lupus familiaris
Midowga boqortooyada Britan	Reino Unido
Yaanyuur	Felis silvestris catus
Shiinaha	República Popular China
Af-Faransiis	Idioma francés
Malaay	Pisces
Khamri	Bebida alcohólica
Barasiil	Brasil
François Hollande	François Hollande
Ruushka	Rusia
Nibiri	Cetacea
Labajibaarane	Cuadrado
Bad	Mar
Bada madaw	Mar Negro
Pi Sumad xisaabeed	Número π
Wiki	Wiki
Toronto	Toronto
Alabama	Alabama
São Paulo	São Paulo
São Paulo (Gobol)	Estado de São Paulo
Wikimedia	Fundación Wikimedia
Jimmy Wales	Jimmy Wales
Ingiriis	English (desambiguación)
Jarmalka	Alemania
Belarus	Bielorrusia
Af-Jarmal	Idioma alemán
Island	Islandia
Estoniya	Estonia
David Cameron	David Cameron
Raage	Saturno (planeta)
Chocolate	Chocolate
Dagaalada	Guerra
Kow	Uno
Labo	Dos
Sadax	Tres
Afar (lambar)	Cuatro
Shan	Cinco
0	Cero
George W. Bush	George W. Bush
Laydi	Rectángulo
Latfiya	Letonia
Ukrain	Ucrania
Jamhuuriyadda Tashik	República Checa
Islofaakiya	Eslovaquia
Isloveeniya	Eslovenia
Moldofa	Moldavia
Romania	Rumania
Bulgaria	Bulgaria
Roma	Roma
Jamhuriyada Makedonia	República de Macedonia
Albania	Albania
Griinland	Groenlandia
Kroatia	Croacia
Bosniya	Bosnia y Herzegovina
Aserbiijaan	Azerbaiyán
Andorra	Andorra
Jasiirada Qabrus	Chipre
Joorjiya	Georgia
Kasakhstan	Kazajistán
Malta	Malta
Monako	Mónaco
Montenegro	Montenegro
Faatikan	Ciudad del Vaticano
San Marino	San Marino
Boroksel	Bruselas
Kuuba	Cuba
Belise	Belice
Barbados	Barbados
Indunisiya	Indonesia
Wolfgang Amadeus Mozart	Wolfgang Amadeus Mozart
Af-Turki	Idioma turco
Koonfur Afrika	Sudáfrica
Aljeeriya	Argelia
Usbekistan	Uzbekistán
Biyo	Agua
Alwaax	Madera
Telefishin	Televisión
Claude Monet	Claude Monet
Diego Velázquez	Diego Velázquez
Jili	Chile
El Greco	El Greco
Ciise	Jesús de Nazaret
Dusaa	Mercurio (planeta)
Taariikh	Historia
Apple Inc	Apple
Waxaraxir	Venus (planeta)
Jaceyl	Amor
Cirjeex	Júpiter (planeta)
Uraano	Urano (planeta)
Nicolas Sarkozy	Nicolas Sarkozy
Nebtuun	Neptuno (planeta)
Xiddigis	Astronomía
Singabuur	Singapur
Saynis	Ciencia
Buluuto	Plutón (planeta enano)
Liechtenstein	Liechtenstein
Ciyaaraha	Deporte
Adolf Hitler	Adolf Hitler
Facebook	Facebook
Julian Assange	Julian Assange
Dagaalkii koowaad	Primera Guerra Mundial
Dagaalkii Labaad ee Aduunka	Segunda Guerra Mundial
Goorsheegto	Reloj
Xisaab	Matemáticas
Af-Laatiin	Latín
Baxrayn	Baréin
Armania	Armenia
Seerbiya	Serbia
Bil	Luna
Istanbuul	Estambul
Australia	Australia
Fiisigis	Física
Arjantiina	Argentina
Isgaarsiinta	Telecomunicación
Peru	Perú
Bayoloji	Biología
Waqooyiga Kuuriya	Corea del Norte
Kambodiya	Camboya
Qur'aan	Corán
Diinsoor (xayawaan)	Dinosauria
Islaam	Islam
Ljubljana	Liubliana
World Wide Web	World Wide Web
Naag	Mujer
Gabay	Poesía
Chernobyl	Accidente de Chernóbil
Milan	Milán
Torino	Turín
Liin dhanaan	Citrus × limon
Ubax	Flor
Magaalo	Ciudad
Napoleon Bonaparte	Napoleón Bonaparte
Xidig	Estrella
Qorax	Sol
Cir	Cielo
Tuulo	Pueblo (población rural)
Ooshiyaaniya	Oceanía
Bahda Midaysay Qoraxdu	Sistema Solar
Hydrogen	Hidrógeno
Hiliyaam	Helio
Ilik	Diente
Cadaab	Infierno
Wikimedia Commons	Wikimedia Commons
Liithiyaam	Litio
Beriiliyaam	Berilio
Buug	Libro
Maalin	Día
Bariga Timor	Timor Oriental
Sanad	Año
Qarni	Siglo
Oslo	Oslo
Lissabon	Lisboa
Dubay	Dubái
Lionel Messi	Lionel Messi
Booron	Boro
Versailles	Versalles
Kaarboon	Carbono
Nitrojiin	Nitrógeno
Ogsajiin	Oxígeno
FC Internazionale Milano	Inter de Milán
Meere	Planeta
Muusig	Música
Moskow	Moscú
Foloriin	Flúor
Af-Taliyaani	Idioma italiano
Niyoon	Neón
Saint Petersburg	San Petersburgo
Jad	Chad
Sodhiyaam	Sodio
Woqooyi	Norte
Magniisiyaam	Magnesio
Alumiiniyaam	Aluminio
New Zealand	Nueva Zelanda
Koonfur	Sur
Hindiya	India
Silikoon	Silicio
Faransiyaam	Francio
Tuvalu	Tuvalu
Fosforos	Fósforo
Xadiid	Hierro
Galbeed	Oeste
Salfar	Azufre
Bari (Jiho)	Este
Jasiiradaha Solomon	Islas Salomón
Koloriin	Cloro
Koofurta Holland	Holanda Meridional
Balau	Palaos
Aargon	Argón
Nawru	Nauru
Firefox	Mozilla Firefox
Waqooyiga Holland	Holanda Septentrional
Botashiyaam	Potasio
Zeeland	Zelanda
Kaalshiyaam	Calcio
Flevoland	Flevolanda
Lead	Plomo
Jasiirada Marshall	Islas Marshall
Kiribati	Kiribati
Mongolia	Mongolia
Fiji	Fiyi
Iskaandhiyaam	Escandio
Titaaniyaam	Titanio
Fanansuwela	Venezuela
Jinkis Khan	Gengis Kan
Fanadhiyaam	Vanadio
Koroomiyaam	Cromo
Faras	Equus ferus caballus
Amistardam	Ámsterdam
Hub	Arma
Xayawaan	Animalia
Surinam	Surinam
Manganiis	Manganeso
Paraguay	Paraguay
Guyana	Guyana
Fan	Arte
Ikwadoor	Ecuador
Reheniyaam	Renio
Kolombiya	Colombia
Kobalti	Cobalto
Tungsten	Wolframio
Nikel	Níquel
Boliifia	Bolivia
Osmiyaam	Osmio
Groningen	Provincia de Groninga
Kober	Cobre
Beer	Plantae
Sinki	Cinc
Leonardo da Vinci	Leonardo da Vinci
Boqoshaa	Fungi
Jamayka	Jamaica
Friesland	Frisia
Drenthe	Drente
Overijssel	Overijssel
Guatemala	Guatemala
Gelderland	Güeldres
Utrecht	Provincia de Utrecht
Bahamas	Bahamas
Dooro	Gallus gallus domesticus
Antigua iyo Barbuda	Antigua y Barbuda
Hawaay	Hawái
Dominika	Dominica
Doofaar	Sus scrofa domestica
Haiti	Haití
El Salfador	El Salvador
Iiraan	Irán
Ciraaq	Irak
Xikmad	Sabiduría
Kosta Rika	Costa Rica
Israaiil	Israel
Magaalada Utrecht	Utrecht
Banama	Panamá
Yemen	Yemen
Virus	Virus
Urdun	Jordania
Nikaragua	Nicaragua
Florida	Florida
Qargistan	Kirguistán
Kuwayt	Kuwait
Laos	Laos
Lubnaan	Líbano
Jasiirada Maldiif	Maldivas
Ameerika	América
Lo'	Bos primigenius taurus
Malaysiya	Malasia
Burma	Birmania
Nebal	Nepal
Cumaan	Omán
Bakistaan	Pakistán
Qatar	Catar
Ciyaarta Teeniska	Tenis
Sacuudi Carabiya	Arabia Saudita
Siri Lanka	Sri Lanka
Suuriya	Siria
Gaaliyaam	Galio
Tadsjikistan	Tayikistán
Pokemon	Pokémon
Taywan	República de China
YouTube	YouTube
Jermaaniyaam	Germanio
Tayland	Tailandia
Tareen	Tren
Aarsenik	Arsénico
Turkmenistan	Turkmenistán
Seleniyaam	Selenio
Iridiyaam	Iridio
Imaaraatka Carabta	Emiratos Árabes Unidos
Boromiin	Bromo
Balatiniyaam	Platino
Fiyetnam	Vietnam
Charlie Chaplin	Charles Chaplin
Koonfur Kuuriya	Corea del Sur
Kiribtoon	Kriptón
Afgaanistan	Afganistán
Gangnam Style	Gangnam Style
Rubiidhiyaam	Rubidio
Dahab	Oro
Kanaalka Suweys	Canal de Suez
Bangladesh	Bangladés
Maali	Malí
Sokrades	Sócrates
Angola	Angola
Butaan	Bután
Twitter	Twitter
Barunay	Brunéi
Tansaaniya	Tanzania
Meerkuri	Mercurio (elemento)
Roald Amundsen	Roald Amundsen
Harry Mulisch	Harry Mulisch
Filibiin	Filipinas
Jamhuuriyadda Bartamaha Afrika	República Centroafricana
Cirifka Koonfur	Polo Sur
Cirifka waqooyi	Polo Norte
Isxaaq Newton	Isaac Newton
Albert Einstein	Albert Einstein
Istoroontiyaam	Estroncio
Itriyaam	Itrio
Bismuth	Bismuto
Jaale	Amarillo
Togo	Togo
Tunisiya	Túnez
Saambiya	Zambia
Simbaabwi	Zimbabue
Beijing	Pekín
Koonfur Suudaan	Sudán del Sur
Benin	Benín
Botswana	Botsuana
Burkina Faso	Burkina Faso
Burundi	Burundi
Komoros	Comoras
Jamhuuriyadda Kongo	República del Congo
Jamhuuriyada Dimuqaraadiga Kongo	República Democrática del Congo
Jabuuti	Yibuti
Boloniyaam	Polonio
Ikweetiga Guinea	Guinea Ecuatorial
Eratareya	Eritrea
New Delhi	Nueva Delhi
Ilmo	Bebé
Astatiin	Ástato
Gabon	Gabón
Mahatma Gandhi	Mahatma Gandhi
Gambia	Gambia
Guinea	Guinea
Guinea-Bissau	Guinea-Bisáu
Xeebta Foolmaroodi	Costa de Marfil
Kamiruun	Camerún
Kab Ferde	Cabo Verde
Lesotho	Lesoto
Liberia	Liberia
Libiya	Libia
Madagaskar	Madagascar
Malaawi	Malaui
Mauritania	Mauritania
Mauritius	Mauricio
Marooko	Marruecos
Musanbiig	Mozambique
Nambiya	Namibia
Nayjar	Níger
Nayjeeriya	Nigeria
Yugandha	Uganda
Ruwanda	Ruanda
Sirkooniyaam	Circonio
Sao Tome iyo Prinsipe	Santo Tomé y Príncipe
Sinigaal	Senegal
Seyshelles	Seychelles
Sierra Leone	Sierra Leona
Soomaaliya	Somalia
Niyobiyaam	Niobio
Julius Caesar	Julio César
Suudaan	Sudán
Swasiland	Suazilandia
Qaansa Roobaad	Arco iris
Molybdenum	Molibdeno
Teknetiyaam	Tecnecio
Qaramada Midoobay	Organización de las Naciones Unidas
Juquraafi	Geografía
Wadno	Corazón
Maskax	Cerebro
Maqaar	Piel
Midab	Color
Rutheniyaam	Rutenio
Roodhiyaam	Rodio
Baluug	Azul
Baladiyaam	Paladio
Naxaas	Plata
Kaadmiyaam	Cadmio
Limburg	Limburgo (Países Bajos)
Tin (curiye)	Estaño
Antimony	Antimonio
Teluriyaam	Telurio
Waqooyiga Brabant	Brabante Septentrional
Aaydhiin	Yodo
Siinoon	Xenón
Kaasiyaam	Cesio
Baariyaam	Bario
Haafniyaam	Hafnio
Aktiiniyaam	Actinio
Tantalum	Tantalio
Bill Clinton	Bill Clinton
Raadhiyaam	Radio (elemento)
Raadhoon	Radón
Lorraine	Lorena (Francia)
Buerto Riko	Puerto Rico
Niedersachsen	Baja Sajonia
Lombardia	Lombardía
Qudus	Jerusalén
Rutherfordium	Rutherfordio
Dubniyaam	Dubnio
Siiborgiyaam	Seaborgio
Badweynta Hindiya	Océano Índico
Kosofo	Kosovo
Badda Karabiya	Mar Caribe
Bohriyaam	Bohrio
Hasiyaam	Hassio
Meitneriyaam	Meitnerio
Darmstadtiyaam	Darmstadio
Roentgeniyaam	Roentgenio
Dortmund	Dortmund
Ununtriyaam	Ununtrio
Lifermoriyaam	Livermorio
Ununoktiyaam	Ununoctio
Maastricht	Maastricht
Jiilaal	Invierno
Gu	Primavera
Xagaa	Verano
Dayr	Otoño
Sadaam Xuseen	Sadam Husein
Usaama bin Laadin	Osama bin Laden
Caarcaaro	Araneae
Miro	Fruto
Lacagta	Dinero
Xasharaad	Insecta
Faladimir Lenin	Lenin
Uetersen	Uetersen
Augustus Octavian	César Augusto
Microsoft Windows	Microsoft Windows
Jibraltaar	Gibraltar
Nokia	Nokia
Baabuur	Automóvil
Juventus FC	Juventus de Turín
Texas	Texas
Bruno Mars	Bruno Mars
Sasiiliya	Sicilia
Sardiiniya	Cerdeña
Fuuqbax	Enfermedad de Crohn
Buenos Aires	Buenos Aires
Tokyo	Tokio
Barcelona	Barcelona
Abidjan	Abiyán
Minnesota	Minnesota
Baqdaad	Bagdad
Isuduwaha Waqtiga Caalamiga	Tiempo universal coordinado
AC Milan	Associazione Calcio Milan
Buuri	Tabaco
Internet Explorer	Internet Explorer
Sigaar	Cigarrillo
Nayl armistaroong	Neil Armstrong
Maxamed Faarax	Mohamed Farah
München	Múnich
Fiyena	Viena
Kobanhaygan	Copenhague
Stockholm	Estocolmo
Helsinki	Helsinki
Dublin	Dublín
Bratislava	Bratislava
Budapest	Budapest
Frankfurt	Fráncfort del Meno
Lanthanum	Lantano
Kitaabka quduska	Biblia
Phnom Penh	Nom Pen
Ho Chi Minh City	Ciudad Ho Chi Minh
Luteetiyaam	Lutecio
Mida Rumeed Kaniisada Ciise	Verdadera Iglesia de Jesús
Ingiriis (luqad)	Idioma inglés
Bangkok	Bangkok
Dong Hoi	Đồng Hới
Concepción	Concepción (Chile)
Franck Ribéry	Franck Ribéry
Ottawa	Ottawa
Dayaxa Cirjeex	Satélites de Júpiter
Juba	Yuba (Sudán del Sur)
Końskowola	Końskowola
Dar es Salaam	Dar es-Salam
Khartuum	Jartum
Dayaxa raage	Satélites de Saturno
2000	2000
2003	2003
2002	2002
2001	2001
2012	2012
2011	2011
2010	2010
2009	2009
2013	2013
2014	2014
2008	2008
2004	2004
2005	2005
2006	2006
2007	2007
1900	1900
1901	1901
Charles De Gaulle	Charles de Gaulle
1906	1906
1908	1908
1909	1909
1992	1992
1991	1991
1990	1990
1993	1993
1994	1994
1995	1995
1996	1996
1910	1910
1911	1911
1912	1912
1913	1913
1914	1914
1997	1997
1998	1998
1999	1999
1918	1918
Cunto	Alimento
Mas	Serpentes
Dayaxa docay	Satélites de Neptuno
Dashiishe	1 de enero
1920	1920
1919	1919
1921	1921
Georges Pompidou	Georges Pompidou
Malmö	Malmö
Birmingham	Birmingham
Microsoft	Microsoft
Borotoon	Protón
Kurów	Kurów
Kimisteri	Química
Robin van Persie	Robin van Persie
27	27
1989	1989
1988	1988
1987	1987
1986	1986
1985	1985
1984	1984
1983	1983
1982	1982
1981	1981
1980	1980
Muqdisho	Mogadiscio
Sana'a	Saná
1970	1970
1971	1971
1972	1972
1973	1973
1974	1974
1975	1975
1976	1976
1977	1977
1978	1978
1979	1979
1969	1969
18 Abriil	18 de abril
25 Abriil	25 de abril
26 Abriil	26 de abril
Dayax	Satélite natural
Kristian Wulff	Christian Wulff
15 Meey	15 de mayo
SSC Napoli	Società Sportiva Calcio Napoli
1968	1968
1967	1967
1966	1966
1965	1965
1964	1964
27 Juun	27 de junio
Kubadda Cagta	Fútbol
AS Roma	Associazione Sportiva Roma
1963	1963
Holokost	Holocausto
1962	1962
Michael Jackson	Michael Jackson
Bogota	Bogotá
29 Diseembar	29 de diciembre
Quito	Quito
Adhi	Capra aegagrus hircus
21 Oktoobar	21 de octubre
Paramaribo	Paramaribo
Kanbera	Canberra
Sydney	Sídney
Cagaar	Verde
Gaduud	Rojo
Perth	Perth
Galbeed Australia (gobol)	Australia Occidental
New South Wales	Nueva Gales del Sur
Wabiga Niil	Nilo
Jini	Genio
Wabiga Nijer	Río Níger
Rabat	Rabat
Algiers	Argel
Tunis	Túnez (ciudad)
Triboli	Trípoli
Rede Globo	Rede Globo
Jabuuti (magaalo)	Yibuti (ciudad)
Tahraan	Teherán
Addis Abeba	Adís Abeba
Ankara	Ankara
Asmara	Asmara
Nijamiina	Yamena
Niamey	Niamey
Nawakshot	Nuakchot
1961	1961
Bamako	Bamako
Belgaraad	Belgrado
Dakar	Dakar
Banjul	Banjul
Konakri	Conakri
Bissau	Bisáu
Category:Template	Categoría:Wikipedia:Plantillas
Monrofia	Monrovia
Braia	Praia
1960	1960
Akara	Acra
Dimishiq	Damasco
Yamoussoukro	Yamusukro
Faransiis Guyana	Guayana Francesa
Ougadougou	Uagadugú
Freetown	Freetown
Abuja	Abuya
Lome	Lomé
Borto-Novo	Porto Novo
Yawunde	Yaundé
Malabo	Malabo
Librefille	Libreville
Bangui	Bangui
Kinshasa	Kinsasa
Barasafille	Brazzaville
Bujumbura	Buyumbura
Kigali	Kigali
Dodoma	Dodoma
Nayroobi	Nairobi
Lilongwe	Lilongüe
Lusaka	Lusaka
Qorax madoobaad	Eclipse solar
Mabuto	Maputo
Kambaala	Kampala
Luanda	Luanda
Moroni	Moroni (Comoras)
Mabane	Mbabane
Maseru	Maseru
Dugsi	Escuela
Antananarifo	Antananarivo
Jaamacad	Universidad
Gaborone	Gaborone
Harare	Harare
Pretoria	Pretoria
Bort Lois	Port Louis
Sao Tome	Santo Tomé (capital)
Windhoek	Windhoek
Wikipedia:Bacaadka	Wikipedia:Zona de pruebas
Fiktoria	Victoria (Seychelles)
Guri	Casa
Kombuyuuterka Dhabta	Computadora portátil
Computer Hardware	Hardware
Aljebra	Álgebra
Webiyada	Río
Osasko	Osasco
Garoonka ee Dong Hoi	Aeropuerto de Đồng Hới
Curitiba	Curitiba
Pangea	Pangea
Keyn	Bosque
Anne Frank	Ana Frank
Shilin Soomaali	Chelín somalí
Confucius	Confucio
Category:Taariikhda Ciraaq	Categoría:Historia de Irak
Corbin Bleu	Corbin Bleu
Category:Xisaab	Categoría:Matemáticas
Jasiiradaha Feroe	Islas Feroe
Maxamed Morsi	Mohamed Morsi
Euro	Euro
Bada Dhexe	Mar Mediterráneo
Haashim	Banu Hashim
Masiixiyad	Cristianismo
Windows 8	Windows 8
Bariis	Arroz
Céline Dion	Céline Dion
Qaaradaha	Continente
Adelaide	Adelaida (Australia)
Shimbir	Aves
Bilaha	Mes
Mustafa Kemal Atatürk	Mustafa Kemal Atatürk
1948	1948
Jeejniya	Chechenia
1949	1949
Garoosni	Grozni
Huang Xianfan	Huang Xianfan
1956	1956
1941	1941
1945	1945
1958	1958
1926	1926
1947	1947
1944	1944
1952	1952
Bill Gates	Bill Gates
Encyclopedia	Enciclopedia
DVD	DVD
Bogga Hore	Wikipedia:Portada
CPU	Unidad central de procesamiento
1959	1959
Template:Maqaal Cusub	Plantilla:Artículo bueno
Dhesibel	Decibelio
Kubadda Koleyga	Baloncesto
Kab town	Ciudad del Cabo
Bada Qaswiin	Mar Caspio
Harta Fiktooriya	Lago Victoria
Harada malaawi	Lago Malaui
Salvador Dalí	Salvador Dalí
Finsent van Gogh	Vincent van Gogh
Hokusai	Katsushika Hokusai
Mishelangelo	Miguel Ángel
Bablo bekaso	Pablo Picasso
Rembrandt van Rijn	Rembrandt
Eminem	Eminem
Bas	Autobús
Baabiyloon	Babilonia (ciudad)
Katalooniya	Cataluña
Samarqanda	Samarcanda
Bukhaara	Bujará
Mekka	La Meca
Che Guvara	Ernesto Guevara
Mao Zedong	Mao Zedong
Kabul	Kabul
Luqada Tamil-ka	Idioma tamil
Filasoofiyada	Filosofía
50 Cent	50 Cent
Dr. Dre	Dr. Dre
Snoop Dogg	Snoop Dogg
Shaax	Té
Tupac Shakur	Tupac Shakur
Xidig-dhul	Erinaceinae
1507	1507
Shuuciyad	Comunismo
Amadeyo afogadro	Constante de Avogadro
Liberalinimo	Liberalismo
Wadan	País
Qaran	Nación
Jow Bayden	Joe Biden
Hillary Clinton	Hillary Clinton
Dabaal	Natación
Category:Xiddigis	Categoría:Astronomía
1542	1542
1543	1543
Jaan Jaak Rosoo	Jean-Jacques Rousseau
Saxaara	Desierto del Sahara
Hambeegar	Hamburguesa
Shaydaanka	Diablo
1606	1606
Maktabad	Biblioteca
FC Barcelona	Fútbol Club Barcelona
Midowga afrika	Unión Africana
Siyaasadda,	Política
Jaamacada Carabta	Liga Árabe
Dimoqraadi	Democracia
Hay'ada laanqayrta cas	Cruz Roja
Gaashaanbuurta NATO	OTAN
Qin Shi Huang	Qin Shi Huang
Bariga Dhexe	Oriente Medio
Jamhuriyadda	República
Hantiwadaag	Socialismo
Dowlad	Estado
Xisbi	Partido político
Kilimanjaaro	Kilimanjaro
Kristoffer Kolombus	Cristóbal Colón
Rixlaat Ibn Batuuta	Ibn Battuta
Kanaalka Banama	Canal de Panamá
Dheg	Oído
San	Nariz
Muruq	Músculo
Hees	Canción
Kaneeco	Culicidae
Libaax Badeed	Selachimorpha
Geel	Camelus
Naasley	Mammalia
Quraansho	Formicidae
Shini	Anthophila
Software	Software
Af-Holandees	Idioma neerlandés
DNA	Ácido desoxirribonucleico
Nuucyada dhirta	Especie
Hooyo	Madre
Aabe	Padre
Waalid	Parental
Gaadiidka Dadweynaha	Transporte
Debian	Debian
1669	1669
1670	1670
1671	1671
1672	1672
1673	1673
1674	1674
1675	1675
1676	1676
1677	1677
1678	1678
1679	1679
1680	1680
1856	1856
Af-Ruush	Idioma ruso
Faladimir Putin	Vladímir Putin
Dastuur	Constitución
Dalalka Kommonwels	Mancomunidad de Naciones
OPEC	Organización de Países Exportadores de Petróleo
Rooti	Pan
UNESCO	Unesco
Baaqa Caalamiga ee Xuquuqda Aadanaha	Declaración Universal de los Derechos Humanos
1796	1796
1797	1797
1899	1889
Sawaaxili	Idioma suajili
1893	1893
Unug	Célula
Dhiig	Sangre
Qolfoof	Esqueleto
Sambab	Pulmones
Hab Neefsi	Aparato respiratorio
Habdhiska Taranka	Aparato genital
Af-Romani	Idioma rumano
Roob	Lluvia
Dhulgariir	Terremoto
Ibn Siinaa	Avicena
Nelson Mandela	Nelson Mandela
Martin Luther King,	Martin Luther King
Ensiim	Enzima
Borotiin	Proteína
Daad	Inundación
Tsunami	Tsunami
Fulkaano	Volcán
Caad	Nube
Tirignoometeri	Trigonometría
Joomitiri	Geometría
Qarnigii 2aad	Siglo II
Qarnigii 1aad	Siglo I
Dhaqaale	Economía
Warshad	Industria
Farta laatiinka	Alfabeto latino
Suugaan	Literatura
Category:Faransiiska	Categoría:Francia
Category:Muusig	Categoría:Música
Kun Habeen Iyo Habeen	Las mil y una noches
Category:Suugaanta	Categoría:Literatura
Category:Gabayada	Categoría:Poesía
Waxbarasho	Educación
Qoys	Familia
Hugo Chavez	Hugo Chávez
Nin	Varón
Guur	Matrimonio
Midab Takoor	Racismo
Adoon	Esclavitud
Dagaal Sokeeye	Guerra civil
Cumar	Umar ibn al-Jattab
Suldaan Suleymaan kan 1aad	Süleyman Kanuni
Bun	Café
Caano	Leche
Buur	Montaña
Salaaxudiin al-Ayyuubi	Saladino
Karaaji	Karachi
Riyaal Madrid	Real Madrid Club de Fútbol
Dagaalkii qaboobaa	Guerra Fría
Seoul	Seúl
Tomas Edison	Thomas Alva Edison
Michael Faraday	Michael Faraday
Internet protocol	Internet Protocol
HTML	HTML
Af-Iswiidhan	Idioma sueco
Muxamed bin Muuse al-Khwarizmī	Al-Juarismi
Karl Marx	Karl Marx
Nabi Muuse C.S.	Moisés
Aqoon	Conocimiento
Naas	Mama
Atom	Átomo
Ileys	Luz
Af Giriig	Idioma griego
Operating system	Sistema operativo
Naf	Alma
Af-Faarsi	Idioma persa
Diin	Religión
Nabi Ibraahiim C.S.	Abraham
Saladh	Ensalada
Yuhuuda	Judaísmo
Af-Hebrow	Idioma hebreo
Ibn Khalduun	Ibn Jaldún
Beer (xubin)	Hígado
Cilminafsi	Psicología
Badweyn	Océano
Gootama buuda	Buda Gautama
Muxamed	Mahoma
BBC	BBC
Shahrukh Khan	Shahrukh Khan
Al-Ghazaali	Al-Ghazali
Gerald Ford	Gerald Ford
Shiica	Chiismo
Suufi	Sufismo
Carab	Lengua (anatomía)
Chelsea FC	Chelsea Football Club
Arsenal F.C.	Arsenal Football Club
Ganac	Páncreas
Qolfoofta Dadka	Esqueleto humano
Qoor	Cuello
Af	Boca
Sakaar	Tórax
Elizabeth II	Isabel II del Reino Unido
Caajiska	Cansancio
Schiphol	Aeropuerto de Ámsterdam-Schiphol
Haarlem	Haarlem
Ronald Reagan	Ronald Reagan
Af-Zulu	Idioma zulú
Foosto	Barril
Sabool	Pobreza
Gordon Brown	Gordon Brown
Jadwalka Curiyayaasha	Tabla periódica de los elementos
Robert Mugabe	Robert Mugabe
Xamaam(Shinbir)	Columbidae
Bakteeri	Bacteria
Geed	Árbol
Canab	Uva
Malab	Miel
Hilib	Carne
Barandho	Solanum tuberosum
Sonkor	Azúcar
Khudaar	Verdura
Robot	Robot
Makiinad	Máquina
Saxaafad	Periodismo
Taleefoon	Teléfono
Dhaqan	Cultura
RNA	Ácido ribonucleico
Xidigisyahan	Astrónomo
Habdhiska Wareega Dhiiga	Aparato circulatorio
Mindhicirka weyn	Intestino grueso
Mindhicirka yar	Intestino delgado
Ibn Haytham	Alhacén
Isku dhis	Compuesto químico
Sharci dajinta	Poder legislativo
Windows 7	Windows 7
Boqolleey	Porcentaje
Windows Vista	Windows Vista
Fidel Castaro	Fidel Castro
Category:Barasiil	Categoría:Brasil
Tamar	Energía
Abala-abalayn bayoloji	Clasificación biológica
Awood	Fuerza
Cufisjiidad	Gravedad
Cuf	Masa
Bir	Metal
Hawo	Gas
Dareere	Líquido
Adke	Sólido
Bushkuleeti	Bicicleta
Markab	Buque
Beeraha	Agricultura
Tiknolajiga nano	Nanotecnología
Xaansho	Papel
Bac	Plástico
Bed	Área
Lambar	Número
Kiilogaraam	Kilogramo
Cristiano Ronaldo	Cristiano Ronaldo
Mitir	Metro
Ilbiriqsi	Segundo
Galley	Zea mays
Kelvinka	Kelvin
Dalalka	Anexo:Países
Ludwik Lejzer Zamenhof	L. L. Zamenhof
Mesobotaamiya	Mesopotamia
Buti	Ursidae
Britney Spears	Britney Spears
Habdhiska Dheefshiidka	Digestión
Habka Samayska Cuntada	Fotosíntesis
Kansar	Cáncer
Qamadi	Triticum
Kalandar	Calendario
Dhagool	Sordera
Cudur	Enfermedad
Niikotiin	Nicotina
Malaariyo	Malaria
Cunto xumida	Malnutrición
Benseliin	Penicilina
Nantes	Nantes
AIDS	Sida
Sokorow	Diabetes mellitus
Template:Location map Yemen	Plantilla:Mapa de localización de Yemen
Mona Lisa	La Gioconda
Horgale (Fiisikis)	Sistema Internacional de Unidades
Burj Khalifa	Burj Khalifa
Gidaarka Shiinaha	Gran Muralla China
Abyoone	Número entero
Kubad	Esfera
Dawladii Cabaasiyiinta	Califato abasí
Dawlada Cosmaniya	Imperio otomano
Koronto	Electricidad
Seef	Espada
Pawlo Kuwelho	Paulo Coelho
Stephan El Shaarawy	Stephan El Shaarawy
Liin	Citrus × sinensis
Af-Soomaali	Idioma somalí
Aljaziira	Al Jazeera
Hal-xeraale	Rompecabezas (juego)
Carabi	Idioma árabe
Xorta ah	Contenido libre
Baar	Arecaceae
Dollar	Dólar
Ra'iisul wasaare	Primer ministro
Araga	Óptica
Calan	Bandera
Qalin Qori	Lápiz
Saabaan	Mobiliario
Template:Location map Sudan	Plantilla:Mapa de localización de Sudán
Template:Location map Eritrea	Plantilla:Mapa de localización de Eritrea
Template:Location map Ethiopia	Plantilla:Mapa de localización de Etiopía
Template:Location map Djibouti	Plantilla:Mapa de localización de Yibuti
Template:Location map Somalia	Plantilla:Mapa de localización de Somalia
Template:Location map Nigeria	Plantilla:Mapa de localización de Nigeria
Template:Location map Uganda	Plantilla:Mapa de localización de Uganda
Geri	Giraffa camelopardalis
Faruur	Labio
Shaarbo	Bigote
Midowga Sofiyet	Unión Soviética
Qolofta kore ee Dhulka	Corteza terrestre
Lil Wayne	Lil Wayne
FC Bayern München	Bayern de Múnich
Queen	Queen
Kanye West	Kanye West
Huguri	Garganta
Wikipedia:Maqaallo Xul Ah	Wikipedia:Artículos destacados
Template:Link FA	Plantilla:Destacado
Maalmaha	Luz diurna
Aduunka	Mundo
Wikipedia:Goob	Wikipedia:Café
Nanjing	Nankín
Mayotte	Mayotte
Goobo	Circunferencia
Cesc Fàbregas	Cesc Fàbregas
Goronyo	Struthio camelus
Kuuriya	Corea
Manchester	Mánchester
1000	1000
999	999
Yeey	Canis lupus
1955	1955
1954	1954
1953	1953
1951	1951
1950	1950
1946	1946
1943	1943
1942	1942
1940	1940
1939	1939
1938	1938
1937	1937
1936	1936
Manchester United FC	Manchester United Football Club
1935	1935
1934	1934
Axdiga Cusub	Nuevo Testamento
Qafqaas	Cáucaso
Sagaal	Nueve
Dabaqaroof	Scorpiones
Koobka Adduunka	Copa Mundial de Fútbol
Boolo	Pelecanus
Macdin Alkaliini ah	Alcalino
Macdin dhuleed ah	Alcalinotérreo
Rafael Correa	Rafael Correa
Transitional Metal	Metal de transición
Bir la Mood	Semimetal
Bir Ma Ahe	No metal
Guruubka 17	Halógeno
Neefta Gobta	Gases nobles
5	5
4	4
3	3
2	2
Buqarest	Bucarest
Louvre	Museo del Louvre
Motorhead	Motörhead
Dameer	Equus africanus asinus
Wikipedia:Maqaal Cusub	Wikipedia:Artículos buenos
6	6
Axdigii Hore	Antiguo Testamento
Saddax-xagal	Triángulo
Lady Gaga	Lady Gaga
Luqada Hindo Yurub	Lenguas indoeuropeas
Breinigerberg	Breinigerberg
Muammar Qadaafi	Muamar el Gadafi
Shabeel	Panthera tigris
Francesco Totti	Francesco Totti
PSY	PSY
Nissan	Nissan
Booyad	Camión cisterna
Walhade	Péndulo
Samsung	Samsung
Skandinafiyen	Escandinavia
Aruba	Aruba
Smartphone	Teléfono inteligente
Shidaal	Petróleo
Isuduwe Habka Juqraafiga	Coordenadas geográficas
Banki	Banco
1	1
10	10
20	20
30	30
Abkhazia	Abjasia
40	40
9	9
7	7
8	8
Todoba	Siete
Sideed	Ocho
Todobaad	Semana
Deero	Cervidae
Baraf	Hielo
Toon	Allium sativum
Musée d'Orsay	Museo de Orsay
Anthroboloji	Antropología
Badacas	Mar Rojo
13	13
Koonfur Ossetia	Osetia del Sur
Ulan Bator	Ulán Bator
51	51
Jasiirad	Isla
Cad	Blanco (color)
Madaw	Negro (color)
37	37
900	900
Lordi	Lordi
Basal	Allium cepa
Lix	Seis
700	700
Yaanyo	Solanum lycopersicum
George H. W. Bush	George H. W. Bush
68	68
89	89
11	11
Quang Binh	Quảng Bình
Entrena	Entrena
Dhulbare	Ecuador terrestre
NASA	NASA
Benito Mussolini	Benito Mussolini
15	15
14	14
17	17
500	500
150	150
Qaamuus	Diccionario
Bermuda	Bermudas
Madax	Cabeza
Wellington	Wellington (Nueva Zelanda)
23	23
800	800
Heesta qaranka	Himno nacional
42	42
Afarta jiho	Punto cardinal
18	18
Nuurad	Caliza
19	19
16	16
21	21
26	26
41	41
32	32
33	33
Falastiin	Palestina (región)
Valletta	La Valeta
200	200
38	38
43	43
39	39
24	24
79	79
61	61
104	104
29	29
102	102
100	100
Haramcad	Acinonyx jubatus
Afarta xilli	Estaciones del año
101	101
105	105
108	108
Dhuxul Dhagax	Carbón
22	22
46	46
25	25
153	153
156	156
31	31
28	28
Liverpool	Liverpool
85	85
88	88
76	76
54	54
60	60
47	47
Guumees	Strigiformes
Nederlaan Antiilis	Antillas Neerlandesas
Bahda Bisada	Felidae
Ambeer	Amperio
Isotope	Isótopo
Göteborg	Gotemburgo
Culeys	Peso
Geed Timir	Phoenix dactylifera
Burris	Martillo
Racibórz	Racibórz
Odense	Odense
Kobe Bryant	Kobe Bryant
Luqadaha Berberiga	Lenguas bereberes
600	600
400	400
300	300
Tilburg	Tilburgo
Dayax gacmeed	Satélite artificial
Horseed FC	Horseed FC
Taylor Swift	Taylor Swift
Khaalid bin Waliid	Jalid ibn al-Walid
Bariga Afrika	África Oriental
Fiat	Fiat
Bartamaha Ameerika	América Central
Af-Cafari	Idioma afar
Magrib	Magreb
Amxaari	Idioma amhárico
36)	36
Tin	Pelo
Wareeg	Perímetro
Portal:Af-maal	Portal:Lenguas
Dhicis	Aborto espontáneo
Kacdoonka masar	Revolución egipcia de 2011
Willis Tower	Sears Tower
Kacbada	Kaaba
Beatriks	Beatriz de los Países Bajos
Isuzu	Isuzu
Dublad	Embudo
159	159
107	107
103	103
152	152
240	240
197	197
70	70
Duqa	Alcalde
81	81
69	69
87	87
65	65
66	66
67	67
55	55
34	34
44	44
35	35
64	64
151	151
155	155
50	50
260	260
45	45
49	49
230	230
Zhengzhou	Zhengzhou
154	154
52	52
82	82
84	84
73	73
72	72
62	62
71	71
75	75
74	74
83	83
78	78
77	77
90	90
80	80
91	91
190	190
109	109
53	53
270	270
Madaxweyne	Presidente
63	63
86	86
401	401
99	99
98	98
110	110
137	137
138	138
140	140
130	130
210	210
220	220
Dell	Dell
180	180
158	158
157	157
106)	106
48	48
97	97
Yuumbi	Istiophoridae
56	56
93	93
Alofi	Alofi (Niue)
57	57
Jamestown	Jamestown (Santa Elena)
170	170
171	171
172	172
58	58
59	59
139	139
134	134
135	135
96)	96
92	92
133	133
176	176
131	131
Fowdo	Anarquía
Jasiirad Dhuleedka Carabta	Arabia
250	250
280	280
290	290
Mindi	Cuchillo
Masaajid	Mezquita
Akon	Akon
Dumnad	Dominó
174	174
International Standard Book Number	ISBN
132	132
178	178
Luqadaha Tashaadiga	Lenguas chádicas
Drake	Drake (rapero)
Luqadaha Kushiitiga	Lenguas cushitas
Afguri	Dialecto
95	95
94	94
257	257
Biriq	Rayo
Gacan	Mano
Luqadaha Omotik	Lenguas omóticas
Af-Oromo	Idioma oromo
Caleen	Hoja
Jilaa	Actor
Niue	Niue
Luqadaha Semitiga	Lenguas semíticas
Justin Bieber	Justin Bieber
Xusni Mubaarak	Hosni Mubarak
Af-Tigrinya	Idioma tigriña
Af-Tigre	Idioma tigré
Dhululubo	Cilindro
Subag	Mantequilla
Yaasir Carafaat	Yasir Arafat
Fara-ka hadal	Lengua de señas
136	136
Injiil	Evangelio
Alexander Graham Bell	Alexander Graham Bell
Tasmaniya	Tasmania
Rotterdam	Róterdam
Saabuun	Jabón
Cabdillahi ibn Cabdi al Mudalib	Abd Allah ibn Abd al-Muttalib
Mošovce	Mošovce
Shakira	Shakira
Jaamacadda Oxford	Universidad de Oxford
Maxamuud Axmadinajaad	Mahmud Ahmadineyad
CD	Disco compacto
Al-Qaacida	Al Qaeda
Maxamed Al-faatex	Mehmed II
Jeer	Hippopotamus amphibius
Far	Dedo
Furaat	Éufrates
Gacanka Faarsiga	Golfo Pérsico
Cilmiga bulshada	Ciencias sociales
Somaliland	Somalilandia
Ciida sanadka cusub	Año Nuevo
Babaay	Carica papaya
Brisbane	Brisbane
Fiitamiin	Vitamina
Towraad	Torá
Koonfur Joorjiya iyo Koonfurta Jasiiradaha Sanwij	Islas Georgias del Sur y Sandwich del Sur (territorio británico de ultramar)
Maahmaah	Proverbio
Noemi	Noemi (cantante)
Website	Sitio web
Ido	Ido
Sumeer	Sumeria
Kolonbo	Colombo
Dariishad	Ventana
Medina	Medina
Akkadiyaan	Idioma acadio
Booliis	Policía
UEFA	UEFA
Tigris	Tigris
Koonfur Australia (gobol)	Australia Meridional
Baarlamaan	Parlamento
Maatar	Materia
Jaamacadda Cambridge	Universidad de Cambridge
Fulinta (Dawlad)	Poder ejecutivo
Hurdo	Sueño
Neefta	Asma
Doon	Barco
Queensland	Queensland
Mohammed ali Clay,	Muhammad Ali
Beyoncé Knowles	Beyoncé
Urur	Conjunto
Siligo	Siligo
Riyo	Ensueño
Bur	Harina
Dhigaha	Longitud (cartografía)
Kimikal dibusocod	Reacción química
Den Haag	La Haya
Goriila	Gorilla
Daylight saving time	Horario de verano
Daanta galbeed	Cisjordania
Maraykanka assalkoodii	Indígenas de América
Siinaa	Península del Sinaí
Albaab	Puerta
Rihanna	Rihanna
Hargab Doofaar	Gripe porcina
Cinjo	Uña
Ugaadhsi	Caza
Toshiro Mifune	Toshirō Mifune
Waji	Cara
Aleksander Fileming	Alexander Fleming
Musmaar	Clavo (objeto)
Nabi Suleymaan C.S.	Salomón
Yahoo	Yahoo!
AK-47	AK-47
Mowjad	Onda
Dhexroor	Diámetro
Bare	Maestro
Internet Movie Database	Internet Movie Database
Dalai Lama	Dalái Lama
Jilib (xubin)	Articulación de la rodilla
ISO 4217	ISO 4217
Tomas hobis	Thomas Hobbes
Campora San Giovanni	Campora San Giovanni
Jirjiroole	Chamaeleonidae
Cusmaan bin Cafaan	Uthman Ibn Affan
Jaandi	Aleación
Nafto	Gasóleo
Qare	Citrullus lanatus
Toban iyo shan	Quince
Rikter Cabir	Escala sismológica de Richter
Xamaas	Hamás
Ruhollah Khomeini	Ruhollah Jomeini
Rajab Dayib Erdogaan	Recep Tayyip Erdoğan
Jamaal Cabdinaasir	Gamal Abdel Nasser
Bluetooth	Bluetooth
Cali	Ali Ibn Abi Talib
Marinka Gaza	Franja de Gaza
Radio Studio 54 Network	Radio Studio 54 Network
Cabitaan	Bebida
Qoori	Playa
Qabaal	Elipse
Hobart	Hobart
Dayax Gacmeed	Nave espacial
Doorashada	Elecciones
Iskudhufasho	Multiplicación
Saxaraha Galbeed	República Árabe Saharaui Democrática
.et	.et
Geeska Afrika	Cuerno de África
Lisa Gerrard	Lisa Gerrard
Nabi Yaxye C.S.	Juan el Bautista
Jennifer Lopez	Jennifer Lopez
Faraq	Resta
Breda (Netherlands)	Breda
Shuban	Diarrea
Nancy	Nancy
Honiara	Honiara
PH	PH
Asiyriya	Asiria
Qardhaas	Rombo
Xayla Siilaasi	Haile Selassie
Xalab	Alepo
Big Ben	Big Ben
Dhererka Mowjadda	Longitud de onda
Nabi Daa'uud C.S.	David
Culeyska atomka	Peso atómico
Borussia Dortmund	Borussia Dortmund
Xidido	Raíz (botánica)
Mole	Mol
Frank Lampard	Frank Lampard
Qallal	Epilepsia
Ramadaan	Ramadán
Baqal	Mula (animal)
Garaam	Gramo
Shahaadah	Shahada
Gacanka Cadmeed	Golfo de Adén
Beeraha laalaada	Jardines Colgantes de Babilonia
Maas	Río Mosa
Khadiija binti Khuweylad	Jadiya
Waraabe	Hyaenidae
Sariir	Cama
Madaxwayne kuxigeen	Vicepresidente
Cilmibaadhis	Investigación
Faaranhaayt	Grado Fahrenheit
Dhuldaaqsiin	Sabana
Dhogor	Lana
Toobin	Cono (geometría)
Daliban	Talibán
MP3	MP3
Ismaamulka Falastiin	Autoridad Nacional Palestina
.ke	.ke
Fernando Torres	Fernando Torres
Gar	Barba
Nabi	Profeta
Derbi	Pared
SMS	Servicio de mensajes cortos
Yaxaas	Crocodylidae
Majladda Time	Time
Dhedig	Hembra
Farabadne	Chilopoda
Amedeo Avogadro	Amedeo Avogadro
Shambay	Felis silvestris
Federaalka	Federación
Sedex Geesoodka Bermuda	Triángulo de las Bermudas
Arjen Robben	Arjen Robben
Xamid Karzai	Hamid Karzai
Lab	Masculino
Rey mysterio	Rey Mysterio
Dayax madoobaad	Eclipse lunar
Taxane	Matriz (matemáticas)
Kayene	Cayena
John Cena	John Cena
Waran	Lanza
Dadqalato	Canibalismo
Busbus	Varicela
Provinces of Argentina	Provincias de Argentina
Dekad	Puerto
Garoonka Diyaaradaha ee Bole	Aeropuerto Internacional Bole
Dadka Berberiga	Bereberes
Afganbi	Golpe de Estado
Burcad Badeed	Piratería
RSS	RSS
Lacagta Meherka	Dote
Barbaroole	Paralelogramo
Leeb	Flecha
Chris Paul	Chris Paul
Awood Socota	Energía cinética
Koor	Trapecio (geometría)
Qaanso	Arco (arma)
Amiibada	Ameba
Zlatan Ibrahimović	Zlatan Ibrahimović
GSM	Sistema global para las comunicaciones móviles
Dhaban	Mejilla
Saint-Denis	Saint-Denis (Reunión)
Arsène Wenger	Arsène Wenger
Baabiylooniya	Imperio babilónico
Warqadda aqoonsiga	Documento de identidad
Template:Commonscat	Plantilla:Commonscat
Qoorgooye	Meningitis
399	399
Iidi Amiin Daada	Idi Amin
Kayseri	Kayseri
CNN	CNN
Drogbaa	Didier Drogba
Dhakhaatiirta Bilaaxuduudaa	Médicos Sin Fronteras
Abwaan	Poeta
Manchester city	Manchester City Football Club
Ilaahay	Troms
John Dramani Mahama	John Dramani Mahama
Luqada Masaarida	Lenguas egipcias
Anatooliya	Anatolia
Nabi Ciise	Isa (Jesús de Nazaret)
Cudurka Ebola	Enfermedad por el virus del Ébola
Template:Taxobox	Plantilla:Ficha de taxón
Carly Rae Jepsen	Carly Rae Jepsen
Toyota	Toyota
Osmose	Ósmosis
Af-Hawsa	Idioma hausa
Saxan	Plato
Mwai Kibaki	Mwai Kibaki
Jalaal Daalabaani	Yalal Talabani
Ismaaciil Cumar Geelle	Ismail Omar Guelleh
Nuur Al-Maliki	Nuri al-Maliki
Dileita Maxamed Dileita	Dileita Mohamed Dileita
Mark Rutte	Mark Rutte
Cumar Cabdirashiid Cali Sharmaarke	Omar Abdirashid Ali Sharmarke
Axmed Dafutoglu	Ahmet Davutoğlu
Robinho	Robinho
Bada Carbeed	Mar Arábigo
Dhircun	Herbívoro
Calanka Denmark	Bandera de Dinamarca
Jay-Z	Jay-Z
Caroog	Caracola
Yuusuf Alqardaawi	Yusuf al-Qaradawi
Sahel	Sahel
Henry Kissinger	Henry Kissinger
Abu Hurayra	Abu Hurairah
Flums	Flums
Nabi Aadam C.S.	Adán
Diego Milito	Diego Milito
Shumac	Vela (iluminación)
Wikipedia:Sharaxaada Maqaalada Xulka Ah	Wikipedia:Candidatos a artículos destacados
Wikipedia:Sharaxaada Maqaalada Cusub	Wikipedia:Selección de artículos buenos
Dhalo	Botella
Raqay	Tamarindus indica
Shabeelada Tamil	Tigres de Liberación del Eelam Tamil
Qaangaadh	Adulto
Gacanka Caqaba	Golfo de Aqaba
KwaZulu-Natal Province	KwaZulu-Natal
Hilibcun	Carnívoro
AFC Ajax	Ajax de Ámsterdam
Qaado	Cuchara
VOIP	Voz sobre Protocolo de Internet
Jibriil	Arcángel Gabriel
Taksi	Taxi
Soqotra	Socotra
Timor	Timor
Almere	Almere
Xoor-dubbur	Mephitidae
Dooli	Mus musculus
Suul	Dedo pulgar
Mesut ozil	Mesut Özil
Turki	Turcos
Ukun	Huevo (alimento)
HyperText	Hipertexto
Xeeb	Costa
Lobamba	Lobamba
Magarete2	Margarita II de Dinamarca
Calanka jabuuti	Bandera de Yibuti
Xareed	Agua dulce
Calanka Suudaan	Bandera del Sudán
Daanyeer	Hominoidea
Sodium Hydroxide	Hidróxido de sodio
Xoolo	Ganado
Cirid	Encía
Chalcogen	Anfígeno
Tufaax	Malus
Shakaal	Hipotenusa
Biniktojiin	Grupo del nitrógeno
Lambedusa	Lampedusa
Manuel Neuer	Manuel Neuer
Jalmad	Caldera (cocina)
Eris	Eris
Wiz Khalifa	Wiz Khalifa
Agool	Caspa
Barfasoor	Profesor
Massari	Massari
Maydhax	Xilema
Dhax kujir	Estado sin litoral
Andalus	Al-Ándalus
Sako	Azaque
Dhadhan	Gusto
ICAO	Organización de Aviación Civil Internacional
.so	.so
Western Cape Province	Provincia Occidental del Cabo
Mario Balotelli	Mario Balotelli
Qiiq	Humo
Eastern Cape Province	Provincia Oriental del Cabo
Cerebellum	Cerebelo
Haaruun Alrashiid	Harún al-Rashid
Kaftan	Chiste
Funaanad	Camiseta
Tangent	Tangente (geometría)
Niisaabuur	Nishapur
Khilaafada Islaamka	Califato
Cadan	Adén
Het Wilhelmus	Wilhelmus
Universidade Federal de Minas Gerais	Universidad Federal de Minas Gerais
Mpumalanga Province	Mpumalanga
Northern Cape Province	Provincia Septentrional del Cabo
Mamawdsaw	Mamoudzou
Gauteng Province	Gauteng
Lug	Pata
Cagaarshow	Ictericia
Du gamla, Du fria	Du gamla, du fria
Shaydaanimo	Satanismo
Limpopo Province	Provincia de Limpopo
LG	LG Group
Ogaden	Ogaden
Alexandre Pato	Alexandre Pato
Wabiga Jubba	Río Juba
Qooleey	Paloma mensajera
Wabiga Shabeelle	Río Shebelle
Masago	Mallotus villosus
Marsho	Engranaje
Saynab bint Khuzayma	Zaynab bint Khuzayma
Saynab bint Jahsh	Zaynab bint Jahsh
Nabi Yuusuf	José (patriarca)
One Direction	One Direction
Mille	Disolvente
Ajay Devgan	Ajay Devgan
Herpesviruses	Herpesviridae
Degmo	Distrito
Tomahok (gantaal)	BGM-109 Tomahawk
Dambas	Ceniza
Eduard Douwes Dekker	Multatuli
Yuusuf Islaam	Cat Stevens
Kiyaawe	Llave (herramienta)
Awood Kaydsan	Energía potencial
Chris Brown	Chris Brown (cantante)
Universidade Estadual de Feira de Santana	Universidad Estatal de Feira de Santana
Aadan Cabdulle Cusmaan	Aden Abdullah Osman Daar
Saylac	Zeila
Anopheles	Anopheles
Malawad	Recto
Universidade Federal da Bahia	Universidad Federal de Bahía
Centro Federal de Educação Tecnológica de Minas Gerais	Centro Federal de Educación Tecnológica de Minas Gerais
Calanka Soomaaliya	Bandera de Somalia
Dhuuso	Flatulencia
Free State Province	Provincia del Estado Libre
Maqal	Audición
Oorfane	Orfanato
Ubuc	Tronco (anatomía)
Meles Zenawi	Meles Zenawi
Nicki Minaj	Nicki Minaj
Wahaabi	Wahhabismo
Diffusion	Difusión (física)
DDT	DDT
Cadnaan Oktaar	Adnan Oktar
Dheddin	Commiphora myrrha
Ibrahim Affelay	Ibrahim Afellay
Angry Birds	Angry Birds
Daango	Palomitas de maíz
Qalin	Pluma (escritura)
Aadaan	Adhan
Usher	Usher
Hummaag noqod	Reflexión (física)
North West Province	Provincia del Noroeste
Lelystad	Lelystad
Midabada Asaasiga	Color primario
Isnidaamis	Sarna
Daaf	Conjuntivitis
Abkow	Abuelo
CAF	Confederación Africana de Fútbol
Hargeysa	Hargeisa
Nabiyada Islaamka	Profetas del islam
Xijaas	Hiyaz
Filibs	Philips
Kaliber	Calibre (armas de fuego)
Geed Hindi	Azadirachta indica
Jidh	Cuerpo (anatomía)
Qosol	Risa
Nektar	Néctar (botánica)
Mount kenya	Monte Kenia
Uunsi	Olíbano
Jomo Kenyatta	Jomo Kenyatta
Gacan (Joomitiri)	Radio (geometría)
Centimetre	Centímetro
Millimeter	Milímetro
Baadiye	Medio rural
Fasuul Cabdalla Maxamed	Fazul Abdullah Mohammed
Portal:Taariikh	Portal:Historia
Hunguriga neefta	Tráquea
Bowdo	Fémur
Qaamo-qashiir	Parotiditis
Tiirarka Islaamka	Pilares del islam
Fanaan	Cantante
Huulaaku Khan	Hulagu
Wadan soo kobcooyo	País en vías de desarrollo
Dhuxul	Carbón vegetal
Shansho	Tibia
Saac (faah faahin)	Reloj de pulsera
Soon	Sawm
Alchemist(Buug)	El alquimista (novela)
The Notorious B.I.G.	The Notorious B.I.G.
Sanab	Estatua
Saadiyom bicarbonate	Bicarbonato de sodio
Nabi Ayuub C.S.	Job (Biblia)
Fatima bint Muxamed	Fátima az-Zahra
Baras	Vitiligo
Sumad xisaabed	Anexo:Símbolos matemáticos
Ricir	Vértebra
Qol	Habitación
Dhado	Humedad del aire
Curiye	Elemento
Mucaawiye bin Abii Sufyaan	Muawiya ibn Abi Sufyan
Xasan Nasrallaah	Hasan Nasrallah
Mahathir Bin Maxamed	Mahathir bin Mohamad
Bidaar	Alopecia
Aafda tahriibka	Trata de personas
KLM	KLM Royal Dutch Airlines
Johan Rudolph Thorbecke	Johan Rudolf Thorbecke
Mitsubishi	Mitsubishi
Cashuura	Ashura
Tamaashiir	Creta (roca)
Memory card	Tarjeta de memoria
Will.i.am	Will.i.am
Saxaro	Estiércol
Gaamur	Alquitrán
UFC	Ultimate Fighting Championship
Pitbull	Pitbull (cantante)
Aayad	Aleya
Tariikhda Shiikh Axmed Yaasiin	Ahmed Yasín
Saxaabi	Sahaba
Gows	Diente molar
Shanbal	Platillos
Harar	Harar Jugol
Dhismaha websiteka	Diseño web
Golcas	Gazella
Abuu Xaniifa	Abu Hanifah
Ammonium	Amonio
Session Initiation Protocol	Session Initiation Protocol
Salafiya	Salafismo
Berbera	Berbera
Botka internetka	Bot
Bergen op Zoom	Bergen op Zoom
Mengista Xayle Maryam	Mengistu Haile Mariam
Mowliidka Nebiga	Mawlid
Ciraaqi Diinaar	Dinar iraquí
Adenoviridae	Adenoviridae
Daniel arap Moi	Daniel Arap Moi
Nabi Huud	Hud (profeta)
Ne-Yo	Ne-Yo
Sin	Articulación de la cadera
Rajab	Rayab
Axmed Binu Xambal	Ahmad bin Hanbal
Sheybaar	Microscopio
Peso (Arjantiina)	Peso (moneda de Argentina)
Yamanta Koonfureed	Yemen del Sur
Assur	Aššur
Decimetre	Decímetro
Sean paul	Sean Paul
Calanka somaliland	Bandera de Somalilandia
Shilin Kiinyaati	Chelín keniano
Astaannta Qaranka ee Soomaaliya	Escudo de Somalia
Astaannta Qaranka ee Imaaraatka	Escudo de los Emiratos Árabes Unidos
Velupillai Prabhakaran	Velupillai Prabhakaran
Federaaliisim	Federalismo
Biomolikule	Biomolécula
Nabi Alyasac C.S.	Eliseo
Birr	Birr etíope
Jaad	Catha edulis
Cows	Césped
S-block	Elementos del bloque s
Dab Damis	Vehículo de bomberos
SliTaz	SliTaz GNU/Linux
Kung fu	Kung-fu
Maxamed Siyaad Barre	Mohamed Siad Barre
Salo	Salo (Finlandia)
Ívi Adámou	Ivi Adamou
Cafar	Pueblo afar
Saliid Macsaro	Aceite de sésamo
Cumar Mukhtaar	Omar Al-Mukhtar
Angalool	Concha
Flo Rida	Flo Rida
Eden Hazard	Eden Hazard
T.I.	T.I.
Budhcad badeeda geeska afrika	Piratería en Somalia
Ayaan Xirsi Cali	Ayaan Hirsi Ali
P-block	Elementos del bloque p
D-block	Elementos del bloque d
F-block	Elementos del bloque f
Cabdullaahi Yuusuf Axmed	Abdullahi Yusuf Ahmed
Ururka Dawladaha aan la aqoonsan Wali	Organización de Naciones y Pueblos No Representados
Qof	Persona
Darawal	Chofer
Dhul (dhulka lagu socdo)	Piso
Faysal Bin Cabdil Caziiz	Faisal bin Abdelaziz
Wadar	Sumatorio
Qormo saynis	Notación científica
C.H	BC
Adam Levine	Adam Levine
Al-Faatixa	Fatiha
Hogaamiye Kooxeed	Señor de la guerra
T-pain	T-Pain
Anggun	Anggun
Carlos the Jackal	Ilich Ramírez
Fatima	Fátima
Mombaaso	Mombasa
Alexa Internet	Alexa Internet
Sheekh Xasan Albanaa	Hasan al-Banna
Daariq ibn Ziyaad	Táriq ibn Ziyad
Seed	Tendón
Suurad	Sura
Xadiis	Hadiz
Allaah	Alá
Salaad	Salat
Xaj	Hajj
Malag	Ángel
Astaannta Qaranka ee Kolombiya	Escudo de Colombia
Xisbiga shacabka iyo xoriyada Holalnd	Partido Popular por la Libertad y la Democracia
Qeshm	Qeshm
Bukhaari	Muhammad Ibn Ismail Al-Bujari
Dadka Soomaaliyeed	Etnia somalí
Haumea	Haumea
Dagaalkii sokeeye ee Soomaaliya	Guerra civil somalí
Jason Derulo	Jason Derülo
Macrakadii Ceyn Jaaluut	Batalla de Ain Yalut
Iskugeyn	Plus
FIFA	FIFA
Uumi	Vapor (estado)
Iman model	Iman (modelo)
Amina bint Wahb	Amina bint Wahb
Maryama al-Qibtiyya	Maria al-Qibtiyya
Xafsa bint Cumar	Hafsa bint Umar
Laf	Hueso
Wayne Rooney	Wayne Rooney
Al Hudaydah	Al Hudayda
Sheekh Shariif Axmed	Sharif Sheid Ahmed
Kismaayo	Kismaayo
Beydaan	Terminalia catappa
R. Kelly	R. Kelly
Fool	Diente incisivo
Lacey Duvalle	Lacey Duvalle
Geed Walaayo	Parkinsonia aculeata
Saaxil	Saaxil
Dhul Udug	Punt
Bakool	Bakool
Nabi Yacquub C.S.	Jacob
Mariana Ximenes	Mariana Ximenes
Imaamu Shaafici	Muhammad ibn Idris ash-Shafi`i
Demba Ba	Demba Ba
Xasan Guuleed Abtidoon	Hassan Gouled Aptidon
K'naan	K'naan
Greyson Chance	Greyson Chance
Cabdul-Qadir Jilani	Abdul Qadri Jilani
Al-Shabaab	Al-Shabbaab
Booc	Calotropis
Imaam Maalik	Malik ibn Anas
Cody Simpson	Cody Simpson
Madfac	Obús (proyectil)
Dagaalkii xoraynta ogaden	Guerra de Ogaden
Oromo	Pueblo oromo
Ibn Nafiis	Ibn Nafis
Xasan Sheekh Maxamuud	Hassan Sheikh Mohamud
Rodolfo Graziani	Rodolfo Graziani
Maxamed Faarax Caydiid	Mohamed Farrah Aidid
Biyo baxa deg dega ah	Eyaculación precoz
Dhulka Talyaaniga ee Soomaaliya	Somalia Italiana
Saytuun	Psidium
Trey songz	Trey Songz
Macawiis	Sarong
Nuuraddin Faarax	Nuruddin Farah
Compaq	Compaq
Unimog	Unimog
Lufthansa Duulimaadkii 181	Secuestro del avión Landshut
Gob	Ziziphus mauritiana
Tooreey	Hoja (cuchillo)
Boosaaso	Bosaso
Axmed Deedat	Ahmed Deedat
Abu Bakr	Abu Bakr as-Siddiq
Abuu Sufyaan	Abu Sufyan ibn Harb
Caabudwaaq	Abudwak
IHH	IHH
Dun	Hilo (desambiguación)
Daahir Rayaale Kaahin	Dahir Riyale Kahin
Timo Soini	Timo Soini
Cali maxamed Geedi	Ali Mohammed Ghedi
Marek Grechuta	Marek Grechuta
Jeddah	Yeda
Shukaansi	Cortejo
Axmed Maxamed Maxamuud (Siilaanyo)	Ahmed Mohamed Mahamoud Silanyo
Xulka Qaranka Soomaaliya	Selección de fútbol de Somalia
Woqooyi bari	Provincia Nororiental (Kenia)
Masjid al-Aqsa	Mezquita de Al-Aqsa
Dadka Tigriga	Pueblo tigray
Computer Engineering	Ingeniería en sistemas computacionales
Masjid al-Xaram	Masjid al-Haram
Karl Wolf	Karl Wolf
Taabici	Tabi‘un
Caluula	ʿAlūla
Nuur Xasan Xuseen	Nur Hassan Hussein
Astaanta Calanka Soomaaliya	Somaliyaay toosoo
Pitty	Pitty
Amxaaro	Amhara
Rayhana bint Zayd	Rayhana
Ta'izz	Taiz
Murgacasho	Esguince
Calooleey	Tripas
Maxamed Xaaji Ibraahim Cigaal	Ibrahim Egal
Dibi	Buey
Paramore	Paramore
Tuur	Cifosis
Luís Carlos Almeida da Cunha	Nani (futbolista)
Paris Saint-Germain FC	París Saint-Germain Football Club
Ahlu sunno waljamaaca	Sunismo
Puntland	Puntlandia
Qureysh	Quraysh
Masjidka Nabiga	Mezquita del Profeta
Dagaalkii uxud	Batalla de Uhud
Sambuus	Samosa
Fiat 124	Fiat 124
Busteejo	Estación de autobús
Galatasaray SK	Galatasaray Spor Kulübü (fútbol)
IGAD	Autoridad Intergubernamental sobre el Desarrollo de África Oriental
Astaanta Calanka Jabuuti	Himno nacional de Yibuti
G-Spot	Punto G
Kulmiye	Partido Paz, Unidad y Desarrollo
Sayid Maxamed Cabdulle Xassan	Mohammed Abdullah Hassan
Salmaan Alfaarisi	Salmán el Persa
Maxamed Cabdulaahi Maxamed	Abdullahi Mohamed
Sheekh Maxamed Naasiruddiin Al-Albaani	Muhammad Nasiruddin al-Albani
Salaada Magrib	Magrib
Baskin-Robbins	Baskin Robbins
Haparanda	Haparanda
Xarardheere	Harardhere
Baraawe	Barāwe
Xisbiga Hantiwadaagga Kacaanka Soomaaliyeed	Partido Socialista Revolucionario Somalí
Oday	Old Man
Aakhiro	Más allá
Shimbiris	Shimbiris
Biciid	Oryx
Hiiraan	Hiiraan
Astaannta Qaranka ee somaliland	Emblema nacional de Somalilandia
Dhulka Biritishka ee Soomaaliya	Somalilandia Británica
Wax soo saar	Producción
Nabi Isxaaq C.S.	Isaac
Soomaaliweyn	Gran Somalia
Zamenhof	Zamenhof
Xidid	Vasija
Shabeellaha Dhexe	Shabeellaha Dhexe
Hanti maguurto	Inmueble
Salaada Subax	Fajr
Maktabadda Dadweynaha ee Minneapolis	Biblioteca Pública de Minneapolis
Liiska dalalka dad ahaan	Anexo:Países por población
Jaamacada Admas	Universidad de Admas
Jaamacada Banaadir	Universidad de Benadir
Jaamacada Muqdisho	Universidad de Mogadiscio
Mr. Lordi	Tomi Putaansuu
Bari (Gobol)	Bari (Somalia)
Wajeer	Wajir
Adult Film Database	Adult Film Database
Midowga Maxkamadaha Islaamiga	Unión de Tribunales Islámicos
Somaliland shilling	Chelín somalilandés
UNICEF	Unicef
Behra	Dorcatragus megalotis
Sanaag	Sanaag
Salaada Casir	Asr
Centro Federal de Educação Tecnológica Celso Suckow da Fonseca	Centro Federal de Educação Tecnológica Celso Suckow da Fonseca
Garoonka Diyaaradaha ee Da Nang	Aeropuerto Internacional de Đà Nẵng
Cirbadii dhimashada	Leiurus quinquestriatus
Nansi Ajram	Nancy Ajram
Awdal	Awdal
Ayuub Daa'uud	Ayub Daud
Badhan	Badhan
Jasiiradaha Jubbada Hoose	Islas Bajuni
Banaadir	Benadir
Bari	Bari
Baay	Bay (Somalia)
Sedjibeke	Cubo
Garoowe	Garowe
Derg	Consejo Administrativo Militar Provisional
Kilometer	Kilómetro
Xaawo	Eva
Soor	Harina de maíz
Dhuun	Faringitis estreptocócica
Web feed	Fuente web
Salaada Duhur	Dhuhr
YouPorn	YouPorn
Guraag	Etnia gurage
Hectometre	Hectómetro
Eurobeat	Eurobeat
Decametre	Decámetro
Sool	Sool
York University	Universidad de York
Buurta Xira	Cueva de Hira
Gedo	Gedo
Guddi	Comité
Togdheer	Togdheer
Goobogali	Pregunta de opción múltiple
Galguduud	Galguduud
Woqooyi Galbeed	Woqooyi Galbeed
Shabeellaha Hoose	Shabeellaha Hoose
Mudug	Mudug
Jubbada Hoose	Jubbada Hoose
Boorama	Boorama
Taran	Productorio
Reoviruses	Reoviridae
Wikipedia:Caawinaad	Ayuda:Contenidos
Wikipedia:Tutorial	Ayuda:Tutorial
Miraha Mucjisada	Synsepalum dulcificum
Pontifícia Universidade Católica de Minas Gerais	Pontifícia Universidade Católica de Minas Gerais
Galmudug	Galmudug
Canjeelo	Injera
Dawladii Mamaaliikta	Mameluco
Poxviruses	Poxviridae
Digri	Dhikr
Burco	Burao
Ajdjadajd	Jubalandia
Mandheera	Mandera
Cadaad	Acacia senegal
Qabaa'ilka Soomaaliya	Demografía de Somalia
Sagaaro	Madoqua piacentinii
Sheekh Aways	Hassan Aweys
Budka Suflera	Budka Suflera
Hobyo	Hobyo
Ceerigaabo	Erigabo
Iskushuban	Iskušuban
Xaafuun	Cabo Hafun
Laascaanood	Las Anod
Eyl	Eyl
Calool	Estómago
Jubbada Dhexe	Jubbada Dhexe
Nugaal	Nugaal
Internet Adult Film Database	Internet Adult Film Database
Cismaan Yuusuf Keenadiid	Osman Yusuf Kenadid
Ceres	Ceres
Lambar Tubaxan	Sistema ternario
Dagaalkii (2006–2009)	Guerra en Somalia (2006-2009)
Ciidamada Qalabka Sida ee Masaarida	Fuerzas Armadas de Egipto
Milme	Soluto
Daallo Airlines	Daallo Airlines
Kaniini	Píldora
Garoonka Diyaaradaha ee Aadan Cadde	Aeropuerto Internacional Aden Adde
Liverpool FC	Liverpool Football Club
Xariiqanta Cagaaran	Línea Verde (Israel)
Duurjoog	Humbug
Gobolada somaliland	Regiones de Somalilandia
Xtube	Xtube
Tusbax	Tasbih
Raas Caseyr	Cabo Guardafui
GCompris	GCompris
Makemake	Makemake
Wikipedia:Safaarad	Wikipedia:Embajadas
Dhoobley	Dhobley
Naafto	Diésel
U qeybin	División (matemática)
Samuel Eto'o	Samuel Eto'o
RedTube	RedTube
Taariikhda Somaliland	Historia de Somalilandia
Shimbir soomaaliyeed	Laniarius erlangeri
Shabiixa	Shabiha
Maakhir	Maajir
Ra'iisul wasaarayaashii Soomaaliya	Primer ministro de Somalia
Qurac	Acacia tortilis
Garoonka Diyaaradaha ee Bender Qaasim	Aeropuerto Internacional Bender Qassim
Agnes Monica	Agnes Mónica
Farta Cismaaniya	Escritura osmanya
Pornopedia	Pornopedia
Category:Jarmal	Categoría:Alemania
Category:Talyaaniga	Categoría:Italia
Category:Qaramada Midoobey ee Maraykanka	Categoría:Estados Unidos
Category:Ruushka	Categoría:Rusia
Category:Midowga boqortooyada Britan	Categoría:Reino Unido
Category:Isbania	Categoría:España
Category:Shiinaha	Categoría:China
Category:Hindiya	Categoría:India
Category:Sucuudiga	Categoría:Arabia Saudita
Category:Turki	Categoría:Turquía
Category:Koonfur Afrika	Categoría:Sudáfrica
Category:Masar	Categoría:Egipto
Category:Iiraan	Categoría:Irán
Category:Arjantiina	Categoría:Argentina
Category:Afqaanistan	Categoría:Afganistán
Category:Austriya	Categoría:Austria
Category:Itoobiya	Categoría:Etiopía
Category:Ciraaq	Categoría:Irak
Category:Nederland	Categoría:Países Bajos
Category:Bakistaan	Categoría:Pakistán
Category:Boland	Categoría:Polonia
Category:Bortuqaal	Categoría:Portugal
Category:Suudaan	Categoría:Sudán
Category:Iswisarland	Categoría:Suiza
Category:Fiyetnam	Categoría:Vietnam
Category:Shimbir	Categoría:Aves
Category:Fiisikis	Categoría:Física
Category:Bayoloji	Categoría:Biología
Category:Kimisteri	Categoría:Química
Category:Taariikh	Categoría:Historia
Category:Juqraafi	Categoría:Geografía
Category:Diin	Categoría:Religión
Category:Ciyaaraha	Categoría:Deporte
Category:Saynis	Categoría:Ciencia
SYL	Liga de la Juventud Somalí
Category:Filimaanta	Categoría:Cine
Category:Isgaadhsiin	Categoría:Comunicación
Jamhuuriyadda Dimuqraadiga Soomaaliya	República Democrática de Somalia
Dhaqaallaha Soomaaliya	Economía de Somalia
Jabhadda Wadaniga Xoreynta Ogaadeenya)	Frente para la Liberación Nacional de Ogaden
Jilib	Jilib
Peso Argentino	Peso argentino (moneda)
Ciidamada Midowga Afrika	Misión de la Unión Africana en Somalia
International Rescue Committee	Comité Internacional de Rescate
Qandala	Ġandala
Ras kambooni	Ras Kamboni
Luqmaan Alxakiim	Locman
Submission (film)	Sumisión (película)
Waqtiga Bariga Afrika	Tiempo de África Oriental
Cabdiweli Maxamed Cali	Abdiweli Mohamed Ali
Laas Geel	Laas Geel
Xisbiga talada ee dalka jabuuti RPP	Concentración Popular por el Progreso
Luuq	Luuq
Elman FC	Elman FC
Muxaram	Muharram
Category:Filasoofiyada	Categoría:Filosofía
Category:Cilminafsi	Categoría:Psicología
Category:Masiixiyad	Categoría:Cristianismo
Category:Islaam	Categoría:Islam
Goronyo soomaaliyeed	Struthio molybdophanes
UDUB	UDUB
Qoryooley	Qoryooley
Doorashadii madaxtinimo ee somaliland 2010	Elecciones presidenciales de Somalilandia de 2010
Dafo	Águila
PornoTube	PornoTube
Badh	Un medio
Ramla bint Abi Sufyan	Ramla bint Abi Sufyan
Jaamacadda Roma Tre	Universidad de Roma III
Ruqiya bint Muxamed	Ruqayya bint Muhammad
Kobra	Cobra
Saldanadii Cadal	Sultanato de Adel
Umm Kaltuum bint Muxamed	Umm Kulthum bint Muhammad
Nabi Yuunus C.S.	Jonás (profeta)
Dad	Pueblo
Xiriirka Soomaaliyeed ee Kubadda koleyga	Selección de baloncesto de Somalia
Universidade do Estado de Minas Gerais	Universidade do Estado de Minas Gerais
Bianca Castanho	Bianca Castanho
Mareer	Cordia sinensis
Bander Beyla	Bandar Beyla
Sheekh Aaden Maxamed Nuur	Adan Mohamed Nuur Madobe
Cabdi Shakuur Sheekh Xassan Farax	Abdi Shakur Sheikh Hassan
Laan	Rama
Category:Dhaqan	Categoría:Cultura
Category:Tobaneeyada sano	Categoría:Décadas
Category:Sanad	Categoría:Años
Category:Qaaradaha	Categoría:Continentes
Edmond Debeaumarché	Edmond Debeaumarché
Paolla Oliveira	Paola Oliveira
Portal:Cilmi Fallag	Portal:Astronomía
Portal:Juqraafi	Portal:Geografía
Precalculus	Precálculo
Jagada Madaxwaynaha Somaliland	Anexo:Presidente de Somalilandia
Radio Gaalkacyo	Radio Gaalkacyo
Gunbur	Pirámide (geometría)
Jano	Paraíso
Saami qumman	Razón (matemáticas)
Tiro	Conde
Banaadir Stadium	Estadio Banadir
Jaamacada Burco	Universidad de Burao
Anna Rita Del Piano	Anna Rita Del Piano
Category:Wikipedia bots	Categoría:Wikipedia:Bots
XVideos	XVideos
Dagaal Dhaqameedka shiineeska	Artes marciales de China
Warsangali	Warsangali
Cufka atamka	Masa atómica
Wikipedia:Su'aal/Hordhac	Wikipedia:Consultas
Wikipedia:Graphics Lab	Wikiproyecto:Ilustración/Taller gráfico
Wikipedia:Soo Bandhigga Sawirka Xulka	Wikipedia:Candidatos a recursos destacados
Template:Wikipedialang	Plantilla:Portada:Idiomas
Category:Wadamada	Categoría:Países
Wikipedia:Maamulka	Wikipedia:Bibliotecarios
Category:Shaqsiyadaad	Categoría:Personas
Wikipedia:Requests for adminship	Wikipedia:Candidaturas a bibliotecario
Wikipedia:Bots	Wikipedia:Bot
Category:Amin	Categoría:Tiempo
Category:Internet	Categoría:Internet
Category:Siyaasad	Categoría:Política
Category:Waxbarasho	Categoría:Educación
Category:Araga	Categoría:Óptica
Category:Fan	Categoría:Arte
Masar	Egipto
Category:Filasoofiyaasha	Categoría:Filósofos
Category:Doorashooyinka	Categoría:Elecciones
Template:Bot	Plantilla:Bot
Kanada	Canadá
Category:Denmark	Categoría:Dinamarca
Category:Giriig	Categoría:Grecia
Category:Iswiidhan	Categoría:Suecia
Category:Islofaakiya	Categoría:Eslovaquia
Wikipedia:Copyright	Wikipedia:Derechos de autor
Wikipedia:Ku saabsan	Wikipedia:Acerca de
Qolobaa Calankeed	Qolobaa calankeed
Category:Microsoft	Categoría:Microsoft
Portal:Saynis	Portal:Ciencias naturales y formales
Wikipedia:Ogaysiiska Maamulka	Wikipedia:Tablón de anuncios de los bibliotecarios/Portal/Archivo/Miscelánea/Actual
Wikipedia:Goob/Farsamo	Wikipedia:Café/Archivo/Técnica/Actual
Template:Flagicon	Plantilla:Bandera
Category:Wadamada Yurub	Categoría:Países de Europa
Category:Yurub	Categoría:Europa
Wikipedia:Bogga Isticmaalaha	Wikipedia:Página de usuario
Portal:Dhacdooyinka Hadda	Portal:Actualidad
Template:Documentation	Plantilla:Documentación
Category:Delete	Categoría:Wikipedia:Borrar
Wikipedia:Ilaalinta badelka	Wikipedia:Política de protección
Wikipedia:Albaabka bulshada	Portal:Comunidad
Category:Luqadaha wikipediyaasha	Categoría:Wikipedia:Wikipedistas por idioma
Wikipedia:Shan walxood	Wikipedia:Los cinco pilares
Wikipedia:Userboxes	Usuario:Userbox
Wikipedia:Saxiix	Wikipedia:Firma de usuario
Sung Jae-ki	Sung Jae-ki
Caa'isha binti Abiibakar	Aisha bint Abi Bakr
Android software development	Desarrollo de programas para Android
Anthrobologist	Antropólogo
Ganacsi	Negocio
Instituto Federal da Bahia	Instituto Federal da Bahia
Template:Softredirect	Plantilla:Redirección suave
Template:Tirtir	Plantilla:Destruir
Category:Teknooloji	Categoría:Tecnología
Category:Afafka	Categoría:Lenguas
Category:Kalandar	Categoría:Calendarios
Category:Wikipedia	Categoría:Wikipedia
Wikipedia:Masuul la'aan guud	Wikipedia:Limitación general de responsabilidad
Category:Pages with broken file links	Categoría:Wikipedia:Páginas con enlaces rotos a archivos
Wikipedia:Tirakoob	Wikipedia:Estadísticas
Wikipedia:Xeerka Wiki	Wikipedia:Política de privacidad
Template:Navbox	Plantilla:Navegación
Template:Xaqiiq	Plantilla:Cita requerida
Portal:Siiro	Portal:Biografías
Template:!	Plantilla:!
Template:Tnavbar	Plantilla:Navbar
Template:Clear	Plantilla:Clear
Template:Nowrap	Plantilla:Nowrap
Millan	Disolución
Wikipedia:Codsiga maamulka/Hordhac	Wikipedia:Tablón de anuncios de los bibliotecarios/Portal/Archivo/Permisos/Actual
Wikipedia:Maqaalada aan u baahan laheen	Wikipedia:Lista de artículos que toda Wikipedia debería tener
Category:Afrika	Categoría:África
Category:Elektaroonig	Categoría:Electrónica
Category:Kitaabka quduska	Categoría:Biblia
Category:Buugta	Categoría:Libros
Category:Bilaha	Categoría:Meses
Template:Babel	Plantilla:Babel
Template:Reflist	Plantilla:Listaref
Category:Isbitaal	Categoría:Hospitales
Wikipedia:Soo bandhigida xogta	Wikipedia:Verificabilidad (propuesta)
Wikipedia:Habka maqaalada Xulka Ah	Wikipedia:Qué es un artículo destacado
Template:Gumud	Plantilla:Esbozo
Template:See also	Plantilla:VT
Dugsiyada Sare ee Dadweynaha ee Saint Paul	Escuelas Públicas de Saint Paul
Category:Aasiya	Categoría:Asia
Category:Jili	Categoría:Chile
Category:Ameerikada koonfureed	Categoría:América del Sur
Template:Intricate template	Plantilla:Plantilla compleja
Template:Country data Belgium	Plantilla:Geodatos Bélgica
Category:Maalmaha usbuuca	Categoría:Días de la semana
Template:Navy/core	Plantilla:Banderanavalpaís
Template:Country data Ethiopia	Plantilla:Geodatos Etiopía
Template:Country data Cuba	Plantilla:Geodatos Cuba
Template:Country data Kenya	Plantilla:Geodatos Kenia
Template:Country data Denmark	Plantilla:Geodatos Dinamarca
Template:Country data Bosnia and Herzegovina	Plantilla:Geodatos Bosnia y Herzegovina
Template:Country data Norway	Plantilla:Geodatos Noruega
Template:Country data Argentina	Plantilla:Geodatos Argentina
Template:Country showdata	Plantilla:Mostrar geodatos
Template:Image label	Plantilla:Etiqueta imagen
Template:Country data Mexico	Plantilla:Geodatos México
Template:Country data Saudi Arabia	Plantilla:Geodatos Arabia Saudita
Template:Country data Iraq	Plantilla:Geodatos Irak
Template:Country data United Arab Emirates	Plantilla:Geodatos Emiratos Árabes Unidos
Template:Kutaal	Plantilla:Ubicación geográfica
Template:Country data Australia	Plantilla:Geodatos Australia
Template:Sidebar	Plantilla:Navegación vertical
Template:Infobox Xooga Dalka Soomaaliyeed	Plantilla:Ficha de Fuerzas Armadas
Template:Country data Austria	Plantilla:Geodatos Austria
Template:Country data Nepal	Plantilla:Geodatos Nepal
Template:Country data Finland	Plantilla:Geodatos Finlandia
Wikipedia:Tutorial (Wikipedia links)	Ayuda:Tutorial (enlaces internos)
Template:Country data Netherlands	Plantilla:Geodatos Países Bajos
Template:Maqaal Xul Ah	Plantilla:Artículo destacado
Template:Country data Russian Federation	Plantilla:Geodatos Rusia
Category:Gaana	Categoría:Ghana
Category:User en	Categoría:Wikipedia:Wikipedistas con conocimientos de inglés
Category:User en-2	Categoría:Wikipedia:Wikipedistas con nivel intermedio de inglés
Template:Infobox	Plantilla:Ficha
Template:Navy	Plantilla:Naval
Category:Farta	Categoría:Alfabeto
Template:Country data Italy	Plantilla:Geodatos Italia
Template:Country data	Plantilla:Geodatos
Template:Min	Plantilla:Min
Category:Astaannta Qaranka	Categoría:Escudos
Category:Beeraha	Categoría:Agricultura
Template:Maamulka	Plantilla:Biblio
Category:Dowladaha	Categoría:Estado
Category:Bahda Midaysay Qoraxdu	Categoría:Planetas del Sistema Solar
Template:Country data Soviet Union	Plantilla:Geodatos Unión Soviética
Template:Country data India	Plantilla:Geodatos India
Category:Falastiin	Categoría:Palestina
Category:Language user templates	Categoría:Wikipedia:Plantillas Babel
Template:Navbox subgroup	Plantilla:Navegación/subgrupo
Template:Farac	Plantilla:Ficha de grupo étnico
Template:Category redirect	Plantilla:Categoría redirigida
Template:Macluumaad Qof Madax Ah	Plantilla:Ficha de autoridad
Category:Kacaanka	Categoría:Revolucionarios
Template:Border	Plantilla:Borde
Template:Country data Turkey	Plantilla:Geodatos Turquía
Category:Qoraaga	Categoría:Escritores
Category:Jaamacadaha	Categoría:Universidades
Template:Country data Nigeria	Plantilla:Geodatos Nigeria
Template:Country data Malaysia	Plantilla:Geodatos Malasia
Template:Infobox website	Plantilla:Ficha de sitio web
Template:Image label end	Plantilla:Etiqueta imagen fin
Template:Documentation subpage	Plantilla:Subpágina de documentación
Template:Infobox number	Plantilla:Ficha de número
Template:Rtl-lang	Plantilla:Rtl-lang
Template:Please don't change this page	Ayuda:Introducción 2
Category:Dekedaha	Categoría:Puertos
Template:Lang-la	Plantilla:Lang-la
Template:Macluumaad askariga	Plantilla:Ficha de militar
Template:User	Plantilla:U
Template:References	Plantilla:Referencias
Template:Jadwal	Plantilla:Tabla bonita
Template:Infobox former country	Plantilla:Ficha de estado desaparecido
Template:Infobox Political post	Plantilla:Ficha de cargo político
Template:Kaydka wadahadalka	Plantilla:Archivo discusión
Portal:Fiisikis	Portal:Física
Template:Country data West Germany	Plantilla:Geodatos Alemania Occidental
Template:Hooyga Maqaalada	Plantilla:Portales de Wikipedia
Category:Booliis	Categoría:Policía
Template:Fb	Plantilla:Self-i
Template:Astaamayn	Usuario:Hyeox/puntuación/plantilla
Template:Plain link	Plantilla:Enlace plano
Template:Country data Comoros	Plantilla:Geodatos Comoras
Template:User sandbox	Plantilla:Taller de usuario
Template:Country data Qadar	Plantilla:Geodatos Catar
Template:Country data Ukrain	Plantilla:Geodatos Ucrania
Template:Country data Pakistan	Plantilla:Geodatos Pakistán
Template:MainPageInterwikis	Plantilla:Portada:Interwikis
Template:Higgaad	Plantilla:Copyedit
Category:Qalabka Waxlagu kariyo	Categoría:Electrodomésticos de cocina
Category:User sk	Categoría:Wikipedia:Wikipedistas con conocimientos de eslovaco
Category:User eo	Categoría:Wikipedia:Wikipedistas con conocimientos de esperanto
Category:User ja	Categoría:Wikipedia:Wikipedistas con conocimientos de japonés
Category:User da-2	Categoría:Wikipedia:Wikipedistas con nivel intermedio de danés
Template:Correct title	Plantilla:Título erróneo
Category:User ar	Categoría:Wikipedia:Wikipedistas con conocimientos de árabe
Category:User da	Categoría:Wikipedia:Wikipedistas con conocimientos de danés
Category:User sk-N	Categoría:Wikipedia:Wikipedistas con nivel nativo de eslovaco
Category:User de	Categoría:Wikipedia:Wikipedistas con conocimientos de alemán
Category:Tiirarka Islaamka	Categoría:Pilares del islam
Template:Country data Burundi	Plantilla:Geodatos Burundi
Template:Country data Germany	Plantilla:Geodatos Alemania
Template:Country data UK	Plantilla:Geodatos Reino Unido
Category:User ja-1	Categoría:Wikipedia:Wikipedistas con nivel básico de japonés
Category:User ko	Categoría:Wikipedia:Wikipedistas con conocimientos de coreano
Wikipedia:Babel	Wikipedia:Babel
Template:Wikipedia how to	Plantilla:Guía
Category:Abwaanada	Categoría:Poetas
Category:Badaha	Categoría:Mares
Category:Ingiriiska	Categoría:Inglaterra
Template:Str ≥ len	Plantilla:Str ≥ len
Category:Taariikhda Soomaaliya	Categoría:Historia de Somalia
Leilani Leeane	Leilani Leeane
Template:Country data Brazil	Plantilla:Geodatos Brasil
Category:Ururada caalamiga ah	Categoría:Organizaciones internacionales
Category:Gobolada Soomaaliya	Categoría:Regiones de Somalia
Category:Juquraafiga Soomaaliya	Categoría:Geografía de Somalia
Template:Country data Somaliland	Plantilla:Geodatos Somalilandia
Category:Madaxda Soomaaliya	Categoría:Presidentes de Somalia
Category:Cilmiga bulshada	Categoría:Ciencias sociales
Category:Wadamada Afrika	Categoría:Países de África
Category:1542	Categoría:1542
Fenerbahce SK	Fenerbahçe Spor Kulübü (fútbol)
Template:Country data United States	Plantilla:Geodatos Estados Unidos
Universidade Federal do Recôncavo da Bahia	Universidade Federal do Recôncavo da Bahia
Category:Farshaxanka	Categoría:Pintores
Wikipedia:Xeerka adeegsiga sawirada	Wikipedia:Política de uso de imágenes
Template:Raadiyoow	Plantilla:Ficha de emisora de radio
Category:Dhirta	Categoría:Árboles y arbustos
Wikipedia:Habaynta Maqaalada Xulka Ah	Wikipedia:Revalidación de artículos destacados
Portal:Baayooloji	Portal:Biología
Category:Juquraafiga Hindiya	Categoría:Geografía de la India
Template:Weather box/cold	Plantilla:Clima/cold
Category:Xisbiyada Somaliland	Categoría:Partidos políticos de Somalilandia
Template:User information templates	Plantilla:Plantillas de enlaces internos a nombres de usuario
Dugsiyada Dadweynaha Minneapolis	Escuelas Públicas de Minneapolis
Category:Jabuuti	Categoría:Yibuti
Category:Ereteriya	Categoría:Eritrea
Category:Kiinya	Categoría:Kenia
Muqdisho Stadium	Estadio Mogadiscio
Category:Komoros	Categoría:Comoras
Category:Libiya	Categoría:Libia
Category:Diinta Soomaaliya	Categoría:Religión en Somalia
Category:Dhaqaalaha Soomaaliya	Categoría:Economía de Somalia
Category:Lacagta	Categoría:Monedas
Category:Webiyada	Categoría:Ríos
Category:Juquraafiga Jabuuti	Categoría:Geografía de Yibuti
Category:Soomaaliya	Categoría:Somalia
Category:Webiyada Soomaaliya	Categoría:Ríos de Somalia
Category:Juquraafiga Yemen	Categoría:Geografía de Yemen
Category:Magaalooyinka Yemen	Categoría:Localidades de Yemen
Template:Maanta	Plantilla:Calendario
Template:Country data Djibouti	Plantilla:Geodatos Yibuti
Category:User nl	Categoría:Wikipedia:Wikipedistas con conocimientos de neerlandés
Category:Hay'ada laanqayrta cas	Categoría:Cruz Roja
Template:Country data Federated States of Micronesia	Plantilla:Geodatos Estados Federados de Micronesia
Category:Diffusion	Categoría:Difusión
Category:Suuriya	Categoría:Siria
Category:Qarniyada	Categoría:Siglos
Category:Qarnigii 16aad	Categoría:Siglo XVI
Category:Qooriyada	Categoría:Playas
Category:Filasoofiyaasha Jarmalka	Categoría:Filósofos de Alemania
Cismaan Xasan Cali Caato	Osman Ali Atto
Category:Harraha Afrika	Categoría:Lagos de África
Category:Madaxda Faransiiska	Categoría:Presidentes de Francia
Category:Madaxda Iiraan	Categoría:Presidentes de Irán
Category:Norway	Categoría:Noruega
Category:Yemen	Categoría:Yemen
Category:Malaay	Categoría:Peces
Category:Mutolojiyada	Categoría:Mitología
Category:Qaamuus	Categoría:Diccionarios
Category:Axdiga Cusub	Categoría:Nuevo Testamento
Category:Ilko	Categoría:Dientes
Category:Dhaqanka Soomaalida	Categoría:Cultura de Somalia
Category:Wikimedia	Categoría:Fundación Wikimedia
Category:Radio	Categoría:Radio
Category:Xayawaan	Categoría:Animales
Category:Jamhuriyadda	Categoría:República
Category:Muqdisho	Categoría:Mogadiscio
Category:Bartamaha Ameerika	Categoría:América Central
Category:Caasimadaha	Categoría:Capitales nacionales
Category:Magaalooyinka Hindiya	Categoría:Localidades de la India
Category:Isgaarsiinta	Categoría:Telecomunicaciones
Category:Gaadiidka	Categoría:Transporte
Category:Ameerikada waqooyi	Categoría:América del Norte
Category:Harraha	Categoría:Lagos
Category:Saxaabada	Categoría:Sahabas
Category:Calamada	Categoría:Banderas
Template:Macluumaad luqadda	Plantilla:Ficha de idioma
Category:Dimoqraadi	Categoría:Democracia
Kaaroot	Daucus carota
Category:Caasimadaha afrika	Categoría:Capitales de África
Category:Komunistiyaasha Jarmalka	Categoría:Comunistas de Alemania
Category:Magaalooyinka Soomaaliya	Categoría:Localidades de Somalia
Category:Magaalooyinka Jabuuti	Categoría:Localidades de Yibuti
Category:Geeska Afrika	Categoría:Cuerno de África
Category:Guurka	Categoría:Matrimonio
Category:Lahjadaha looga hadlo Soomaaliya	Categoría:Lenguas de Somalia
Category:Caasimadaha yurub	Categoría:Capitales de Europa
Category:Somaliland	Categoría:Somalilandia
Template:POW	Plantilla:PDG
Template:H:title	Plantilla:Etiqueta
Category:Caafimaadka	Categoría:Salud
Template:Country data Canada	Plantilla:Geodatos Canadá
Template:Clickable button 2	Plantilla:Botón enlazable 2
Template:Flag	Plantilla:Bandera2
Template:Country data Malawi	Plantilla:Geodatos Malaui
Template:Country data South Yemen	Plantilla:Geodatos Yemen del Sur
Template:Country data Uganda	Plantilla:Geodatos Uganda
Template:Country data Yemen	Plantilla:Geodatos Yemen
Template:Lang-pl	Plantilla:Lang-pl
Category:Buuraha Soomaaliya	Categoría:Montañas de Somalia
Category:Maamulada Soomaaliya	Categoría:Estados de Somalia
The Narrative	The Narrative
Portal:Xisaab	Portal:Matemática
Trojany	Trojany
Template:HMXA	Plantilla:Revalidar AD
Category:Wadamada Aasiya	Categoría:Países de Asia
Portal:Qaynuun	Portal:Derecho
Category:Abidjan	Categoría:Abiyán
Category:Antananarifo	Categoría:Antananarivo
Lug (xubin)	Pierna
Category:Bamako	Categoría:Bamako
Template:Colonne	Plantilla:Columnas
Eray bixin	Terminología
Category:Jabuuti (magaalo)	Categoría:Yibuti (ciudad)
Category:Esperanto	Categoría:Esperanto
Template:Lang-am	Plantilla:Lang-am
Template:Lang-sv	Plantilla:Lang-sv
Category:Garoomaha Ciyaaraha Soomaaliya	Categoría:Estadios de fútbol de Somalia
Category:Taariikhda Somaliland	Categoría:Historia de Somalilandia
Khilaafadii Umawiyiinta	Califato Omeya
Portal:Kimistari	Portal:Química
Category:Linux	Categoría:Linux
Category:Siyaasada Soomaaliya	Categoría:Política de Somalia
Category:Komunistiyaasha	Categoría:Comunistas
Category:Qiyaasaha Masaafooyinka	Categoría:Unidades de longitud
Category:Midabada	Categoría:Color
Category:Triboli	Categoría:Trípoli
Category:Jaamacadaha Soomaaliya	Categoría:Universidades de Somalia
Wikipedia:Habka Maqaalada Cusub	Wikipedia:Qué es un artículo bueno
Template:Country data Somalia	Plantilla:Geodatos Somalia
Template:Image label begin	Plantilla:Etiqueta imagen inicio
Category:User en-1	Categoría:Wikipedia:Wikipedistas con nivel básico de inglés
Universidade Fundação Mineira de Educação e Cultura	Universidad FUMEC
Portal:Caafimaad	Portal:Medicina
Wikipedia:Tutorial (Talk pages)	Ayuda:Tutorial (páginas de discusión)
Wikipedia:Tutorial (Keep in mind)	Ayuda:Tutorial (políticas)
Template:Goob	Wikipedia:Café/Portal
Template:Wayback	Plantilla:Wayback
Wikipedia:Tutorial (Wrap-up and more info)	Ayuda:Tutorial (para terminar)
Wikipedia:Tutorial (Registration)	Ayuda:Tutorial (registro)
Template:For year month day	Plantilla:Edad en años, meses y días
Portal:Soomaaliya	Portal:Somalia
Template:Man/default	Plantilla:Man/die.net
Template:Weather box/colh	Plantilla:Clima/colh
Template:Weather box/colpastel	Plantilla:Clima/colpastel
Parvoviruses	Parvoviridae
Kim Cesarion	Kim Cesarion
Template:Infobox Weather/khad	Plantilla:Clima/line
Template:Infobox Weather/colp	Plantilla:Clima/colp
Template:Infobox Weather/colt	Plantilla:Clima/colt
Template:Weather box/cols	Plantilla:Clima/cols
Adnan Januzaj	Adnan Januzaj
Gobolada Soomaaliya	Regiones de Somalia
Barkhad Cabdi	Barkhad Abdi
Special:RecentChanges	Especial:CambiosRecientes
Category:Wabiyada Afrika	Categoría:Ríos de África
Madaxweyneyaashii Soomaaliya	Presidente de Somalia
