ئافرىقا	África
ياپونىيە	Japón
جەنۇبىي ئامېرىكا	América del Sur
نورۋېگىيە	Noruega
Shotlandiye	Escocia
Wélsh	Gales
ۋېنگرىيە	Hungría
ئىسپانىيە	España
ئامېرىكا قوشما شىتاتلىرى	Estados Unidos
بېلگىيە	Bélgica
ليۇكسېمبۇرگ	Luxemburgo
يەر شارى	Tierra
گېئورگى ۋاشىنگتون	George Washington
فىنلاندىيە	Finlandia
شۋېتسىيە	Suecia
دانىيە	Dinamarca
لەھىستان	Polonia
لىتۋا	Lituania
ئىتالىيە	Italia
شۋېتسارىيە	Suiza
ئاۋستىرىيە	Austria
گرېتسىيە	Grecia
تۈركىيە جۇمھۇرىيىتى	Turquía
پورتۇگالىيە	Portugal
ياۋروپا	Europa
ئاسىيا	Asia
شىمالىي ئامېرىكا	América del Norte
ۋىكىپېدىيە	Wikipedia
گوللاندىيە	Países Bajos
Nyu York Shehiri	Nueva York
ۋاشىنگتون	Washington D. C.
San Fransisko	San Francisco (California)
Bérlin	Berlín
Los Anjélés	Los Ángeles
كومپيۇتېر	Computadora
بېرن	Berna
Jenwe	Ginebra
سيۇرىخ	Zúrich
خەلقارالىق تور	Internet
باراك ئوباما	Barack Obama
ئۇرۇگۋاي	Uruguay
London	Londres
كايرو	El Cairo
ئالما	Manzana
پارىژ	París
مېكسىكا	México
Kaliforniye Shitati	California
Boston	Boston
مارس	Marte (planeta)
كېنىيە	Kenia
ئېفىئوپىيە	Etiopía
گانا جۇمھۇرىيىتى	Ghana
شىر	Panthera leo
فرانسىيە	Francia
ئېسپېرانتو	Esperanto
ئىت	Canis lupus familiaris
بۈيۈك بېرىتانىيە	Reino Unido
مۈشۈك	Felis silvestris catus
جۇڭخۇا خەلق جۇمھۇرىيىتى	República Popular China
فرانسۇز تىلى	Idioma francés
برازىلىيە	Brasil
روسىيە	Rusia
قارا دېڭىز	Mar Negro
Toronto	Toronto
Alabama Shitati	Alabama
San Pawlo	São Paulo
Kwébék	Quebec
ۋىكىپېدىيە ۋەخپى	Fundación Wikimedia
جىمى ۋالىس	Jimmy Wales
گېرمانىيە	Alemania
بېلورۇسسىيە	Bielorrusia
نېمىس تىلى	Idioma alemán
ئىسلاندىيە	Islandia
ئېستونىيە	Estonia
ساتۇرن	Saturno (planeta)
ئايروپىلان	Avión
جورج ۋولكېر بۇش	George W. Bush
لاتۋىيە	Letonia
ئۇكرائىنا	Ucrania
چېخ جۇمھۇرىيەتى	República Checa
سلوۋاكىيە	Eslovaquia
سلوۋېنىيە	Eslovenia
مولدوۋا	Moldavia
رۇمىنىيە	Rumania
بۇلغارىيە	Bulgaria
Rim	Roma
ماكېدونىيە	República de Macedonia
ئالبانىيە	Albania
گرېنلاندىيە	Groenlandia
كرودىيە	Croacia
بوسنىيە ۋە ھېرسېگوۋىنا	Bosnia y Herzegovina
ئەزەربەيجان	Azerbaiyán
ئاندوررا	Andorra
سىپرۇس	Chipre
گرۇزىيە	Georgia
قازاقىستان	Kazajistán
مالتا	Malta
موناكو	Mónaco
چېرنوگورىيە	Montenegro
ۋاتىكان شەھىرى	Ciudad del Vaticano
سان مارىنو	San Marino
Bryussél	Región de Bruselas-Capital
كۇبا	Cuba
بېلىز	Belice
باربادوس	Barbados
ئاممىباپ ئاپتوموبىل	Volkswagen
ھىندونېزىيە	Indonesia
Wolfgang Amadeus Mozart	Wolfgang Amadeus Mozart
بىتخوۋىن	Ludwig van Beethoven
تۈرك تىلى	Idioma turco
جەنۇبىي ئافرىقا	Sudáfrica
ئالجىرىيە	Argelia
ئۆزبېكىستان	Uzbekistán
Poznan	Poznań
Tashkent	Taskent
Warshawa	Varsovia
ياۋروۋىزىيون ناخشا مۇسابىقىسى	Festival de la Canción de Eurovisión
تېلېۋىزور	Televisión
ئىسلاندىيە تىلى	Idioma islandés
چىلى	Chile
ئەيسا مەسىھ	Jesús de Nazaret
گالىلېي	Galileo Galilei
مېركۇرىي	Mercurio (planeta)
تارىخ	Historia
ئالما شىركىتى	Apple
ۋېنېرا	Venus (planeta)
مۇھاببەت	Amor
يۇپىتېر	Júpiter (planeta)
سامان يولى سىستىمېسى	Vía Láctea
ئۇران (پلانىت)	Urano (planeta)
نىكولا ساركوزى	Nicolas Sarkozy
نېپتۇن	Neptuno (planeta)
ئاسترونومىيە	Astronomía
سىنگاپور	Singapur
پلۇتون	Plutón (planeta enano)
Montréal	Montreal
لىختېنشتېين	Liechtenstein
Kambrij	Cambridge
Facebook	Facebook
بىرىنچى دۇنيا ئۇرۇشى	Primera Guerra Mundial
Kolon	Colonia (Alemania)
سكوپليې	Skopie
Shchétsin	Szczecin
لاتىن تىلى	Latín
بەھرېيىن	Baréin
ئەرمېنىيە	Armenia
سېربىيە	Serbia
Istanbul	Estambul
ئاۋستىرالىيە	Australia
فىزىكا	Física
ئارگېنتىنا	Argentina
پېرۇ	Perú
بىئولوگىيە	Biología
شىمالىي چاۋشيەن	Corea del Norte
كامبوجا	Camboya
قۇرئان كەرىم	Corán
دىنوزاۋر	Dinosauria
ئىسلام دىنى	Islam
ليۇبليانا	Liubliana
Lion	Lyon
ياۋروپا ئىتتىپاقى	Unión Europea
سوفىيە	Sofía
شېئىر	Poesía
Milan	Milán
Turin	Turín
سوڭ	Ano
ئېۋېرېست	Monte Everest
ﻧﺎﭘﻮﻟﯧﺌﻮﻥ ﺑﻮﻧﺎﭘﺎﺭﺕ	Napoleón Bonaparte
ۋېزۇۋىي	Monte Vesubio
قۇياش	Sol
قۇياش سىستېمىسى	Sistema Solar
ھىدروگېن	Hidrógeno
گېلىي	Helio
چىش	Diente
لىتىي	Litio
بېرىللىي	Berilio
شەرقىي تىمور	Timor Oriental
ئوسلو	Oslo
Bonn	Bonn
سېرېرا	Ceres (planeta enano)
لىسبون	Lisboa
ئېرىدا	Eris (planeta enano)
دۇبائى	Dubái
بور	Boro
Wérsayl	Versalles
كاربون	Carbono
ۋولگا دەرياسى	Volga
ئازوت	Nitrógeno
ئوكسىگېن	Oxígeno
مۇزىكا	Música
Wénitsiye	Venecia
Rénn Shehiri	Rennes
Lil	Lille
Moskwa	Moscú
فىتور	Flúor
ئىتاليان تىلى	Idioma italiano
نىئون گازى	Neón
Sankt-Pétérburg	San Petersburgo
چاد	Chad
ناترىي	Sodio
ماگنىي	Magnesio
ئاليۇمىن	Aluminio
يېڭى زېلاندىيە	Nueva Zelanda
ھىندىستان	India
سىلىتسىي	Silicio
فرانسىي	Francio
Tuwalu	Tuvalu
فوسفور	Fósforo
تۆمۈر	Hierro
Ton’ga	Tonga
گۈڭگۈرت	Azufre
ساموئا	Samoa
سولومون تاقىم ئاراللىرى	Islas Salomón
ۋانۇئاتۇ	Vanuatu
خلور گازى	Cloro
پاپۇئا يېڭى گۋىنېيە	Papúa Nueva Guinea
پالاۋ	Palaos
ئارگون	Argón
ناۋرۇ	Nauru
مىكرونېزىيە فېدېراتسىيىسى	Estados Federados de Micronesia
كالىي	Potasio
كالتىسىي	Calcio
قوغۇشۇن	Plomo
مارشال تاقىم ئاراللىرى	Islas Marshall
كىرىباتى	Kiribati
موڭغۇلىيە	Mongolia
فىجى	Fiyi
سكاندىي	Escandio
تىتان	Titanio
ۋېنېسۇئېلا	Venezuela
چىڭگىزخان	Gengis Kan
ۋانادىي	Vanadio
Méané Shitati	Maine
خروم	Cromo
ئات	Equus ferus caballus
ئامستېردام	Ámsterdam
ھايۋانات	Animalia
سۇرىنام	Surinam
مانگان	Manganeso
پاراگۋاي	Paraguay
گايانا	Guyana
ئېكۋادور	Ecuador
رېنىي	Renio
كولومبىيە	Colombia
كوبالت	Cobalto
ۋولفرام	Wolframio
نىكېل	Níquel
بۇددا دىنى	Budismo
بولىۋىيە	Bolivia
مىس	Cobre
ترىنىداد ۋە توباگو	Trinidad y Tobago
سېنت ۋىنسېنت ۋە گرېنادىن ئاراللىرى	San Vicente y las Granadinas
سىنك	Cinc
Yéngi Xampishir Shitati	Nuevo Hampshire
سېنت ليۇسىيە	Santa Lucía
داۋېىنچى	Leonardo da Vinci
سېنت كىتس ۋە نېۋىس	San Cristóbal y Nieves
زەمبۇرۇغ	Fungi
يامايكا	Jamaica
گرېنادا	Granada (país)
Massachuséts Shitati	Massachusetts
گۋاتېمالا	Guatemala
باھاما	Bahamas
Konnéktikat Shitati	Connecticut
ئانتىگۇئا ۋە باربۇدا	Antigua y Barbuda
Haway Shitati	Hawái
ھوندۇراس	Honduras
دومىنىكا	Dominica
دومىنىكان جۇمھۇرىيەتى	República Dominicana
ھايتى	Haití
ئەل سالۋادور	El Salvador
ئىران	Irán
ئىراق	Irak
Alyaska Shitati	Alaska
كوستارىكا	Costa Rica
ئىسرائىلىيە	Israel
پاناما	Panamá
يەمەن	Yemen
پولەك تىلى	Idioma polaco
ئىئوردانىيە	Jordania
نىكاراگۇئا	Nicaragua
Florida Shitati	Florida
قىرغىزىستان	Kirguistán
Arizona Shitati	Arizona
كۇۋەيت	Kuwait
لائوس	Laos
لىۋان	Líbano
Orégon Shitati	Oregón
مالدىۋ ئاراللىرى	Maldivas
ئامېرىكا قىتئەسى	América
Yuta Shitati	Utah
مالايسىيا	Malasia
بىرما	Birmania
نېپال	Nepal
ئومان	Omán
پاكىستان	Pakistán
قاتار	Catar
سەئۇدى ئەرەبىستان	Arabia Saudita
سرىلانكا	Sri Lanka
ستالىن	Iósif Stalin
سۇرىيە	Siria
بىراتۇ	Platón
گاللىي	Galio
تاجىكىستان	Tayikistán
تەيۋەن	República de China
گېرمانىي	Germanio
تايلاند	Tailandia
ئارسېن	Arsénico
تۈركمەنىستان	Turkmenistán
سېلېن	Selenio
ئەرەب بىرلەشمە خەلىپىلىكى	Emiratos Árabes Unidos
بروم	Bromo
Platina	Platino
ۋيېتنام	Vietnam
Nowosibirski	Novosibirsk
جەنۇبىي چاۋشيەن	Corea del Sur
كرىپتون	Kriptón
ئافغانىستان	Afganistán
رۇبىدىي	Rubidio
ئالتۇن	Oro
قازان	Kazán
بانگلادېش	Bangladés
مالى	Malí
ئانگولا	Angola
بۇتان	Bután
برۇنېي	Brunéi
تانزانىيە	Tanzania
فىلىپپىن	Filipinas
ئوتتۇرا ئافرىقا جۇمھۇرىيىتى	República Centroafricana
جەنۇبى قۇتۇپ	Polo Sur
شىمالى قۇتۇپ	Polo Norte
ئىسساك نيوتۇن	Isaac Newton
ئالبېرىت ئېينىشتېين	Albert Einstein
سترونتسىي	Estroncio
ئىتترىي	Itrio
ۋىسمۇت	Bismuto
سېرىق رەڭ	Amarillo
توگو	Togo
تۇنىس	Túnez
زامبىيە	Zambia
زىمبابۋې	Zimbabue
بېيجىڭ شەھىرى	Pekín
تۇۋا	Tuvá
بېنىن	Benín
بوتسۋانا	Botsuana
بۇركىنا فاسو	Burkina Faso
بۇرۇندى	Burundi
كومور ئاراللىرى	Comoras
كونگو جۇمھۇرىيىتى	República del Congo
كونگو دېموكراتىك جۇمھۇرىيىتى	República Democrática del Congo
San Antonio	San Antonio (Texas)
جىبۇتى	Yibuti
پولونىي	Polonio
ئېكۋاتور گۋىنېيىسى	Guinea Ecuatorial
ئېرىترېيە	Eritrea
Yéngi Déhli	Nueva Delhi
تبىلىسى	Tiflis
ئاستاتىن	Ástato
گابون	Gabón
گامبىيە	Gambia
ۋىنېيە	Guinea
گۋىنېيە بىسسائۇ	Guinea-Bisáu
پىل چىشى قىرغىغى	Costa de Marfil
كامېرۇن	Camerún
يېشىل تۇمشۇق ئاراللىرى	Cabo Verde
لېسوتو	Lesoto
لىبېرىيە	Liberia
لىۋىيە	Libia
ماداگاسكار	Madagascar
مالاۋى	Malaui
Shtutgart	Stuttgart
ماۋرىتانىيە	Mauritania
ماۋرىتىئۇس	Mauricio
ماراكەش	Marruecos
موزامبىك	Mozambique
نامىبىيە	Namibia
نىگېر	Níger
نىگېرىيە	Nigeria
دارۋىن	Charles Darwin
ئۇگاندا	Uganda
رۋاندا	Ruanda
سىركونىي	Circonio
San Tomé we Prinsipé	Santo Tomé y Príncipe
سېنېگال	Senegal
سېيشېل ئاراللىرى	Seychelles
سيېررا لېئونې	Sierra Leona
سومالى	Somalia
نىئوبىي	Niobio
جولیس سیزر	Julio César
سۇدان	Sudán
سۋازىلېند	Suazilandia
مولبېدىن	Molibdeno
تېخېتىسىي	Tecnecio
Hamburg	Hamburgo
گۇجارات	Guyarat
بىرلەشكەن دۆلەتلەر تەشكىلاتى	Organización de las Naciones Unidas
گېئولوگىيە	Geología
Exmetabad	Ahmedabad
يۈرەك	Corazón
تېرە	Piel
پراگا	Praga
كۆك رەڭ	Azul
كۈمۈش	Plata
قەلەي	Estaño
ئۇران	Uranio
سۈرمە	Antimonio
پلوتونىي	Plutonio
نېپتونىي	Neptunio
كسېنون	Xenón
سېزىي	Cesio
پروتاكتىنىي	Protactinio
بارىي	Bario
تورىي	Torio
گافنىي	Hafnio
ئاكتىنىي	Actinio
تانتال	Tantalio
بىل كلىنتون	Bill Clinton
رادىي	Radio (elemento)
رادون	Radón
Bombay	Bombay
Michigan Shitati	Míchigan
پوئېرتو رىكو	Puerto Rico
Illinoyiz Shitati	Illinois
Shimaliy Dakota Shitati	Dakota del Norte
لومبارد	Lombardía
Jenubiy Dakota Shitati	Dakota del Sur
Montana Shitati	Montana
Wyoming Shitati	Wyoming
قۇدس	Jerusalén
Aydaxo Shitati	Idaho
Washin'giton Shitati	Washington (estado)
رۇزېرفوردىي	Rutherfordio
Néwada shitati	Nevada
دۇبنىي	Dubnio
سىبورگىي	Seaborgio
بوھرىي	Bohrio
ھاسسىي	Hassio
مېيتنېرىي	Meitnerio
Kolorado Shitati	Colorado
دارمستادتىي	Darmstadio
رۆنتگېنىي	Roentgenio
كوپېرنىي	Copernicio
تۈر:تۈرلەر يولباشچىسى	Categoría:Índice de categorías
ئاپېنىن تاغ تىزمىسى	Apeninos
ئالپ تاغلىرى	Alpes
پاسكال	Blaise Pascal
Gant	Gante
Chikago	Chicago
ئۇنۇنترىي	Ununtrio
فلېروۋىي	Flerovio
ئۇنۇنپېنتىي	Unumpentio
لىۋىرمورىي	Livermorio
ئۇنۇنسېپتىي	Ununseptio
ئۇنۇنئوكتىي	Ununoctio
Arném	Arnhem
ئىسپان تىلى	Idioma español
مونتېۋىدېئو	Montevideo
Filadélfiye	Filadelfia
Kalkutta	Calcuta
Déhli	Delhi
داكا	Daca
Ban'galor	Bangalore
Ömüchük	Araneae
ئىسلامئاباد	Islamabad
ظاصتاص يئضةن مئؤة	Fruto
مايمۇن	Mono
Wirginiye Shitati	Virginia
غەربىي ۋىرگىنىيە شىتاتى	Virginia Occidental
Nyuyork Shitati	Nueva York (estado)
سېرىي	Cerio
پرازېئودىمىي	Praseodimio
Rodé Arili Shitati	Rhode Island
نېئودىي	Neodimio
Maryland Shitati	Maryland
Délawiyer Shitati	Delaware
يېۋروپىي	Europio
Oxayo Shtati	Ohio
Pénsilwaniye Shitati	Pensilvania
Yéngi Jérséy Shtati	Nueva Jersey
فىنلاندىيە تىلى	Idioma finés
Indiyanna Shitati	Indiana
ئاپتوموبىل	Automóvil
Giorgiye Shitati	Georgia (Estados Unidos)
Zagréb	Zagreb
Téksas Shitati	Texas
Jenubiy Karolina Shitati	Carolina del Sur
سىتسىلىيە	Sicilia
مانىلا	Manila
ساردىنىيە ئارىلى	Cerdeña
Bordo	Burdeos
Buénos Ayrés	Buenos Aires
مېكسىكا شەھىرى	México, D. F.
توكيو	Tokio
Barsélona	Barcelona
Missisipi Shitati	Misisipi
Ténnéssi Shitati	Tennessee
Astana	Astaná
Yéngi Méksika Shitati	Nuevo México
ئافېنا	Atenas
Minnésota Shitati	Minnesota
باغداد	Bagdad
Karakas	Caracas
Wiskonsin Shitati	Wisconsin
Puna	Pune
AC مىلان	Associazione Calcio Milan
Lowa Shitati	Iowa
Nébraska Shitati	Nebraska
گۋاتېمالا شەھىرى	Ciudad de Guatemala
Kanzas Shitati	Kansas
ھىندى تىلى	Hindi
ماراتىچە	Idioma maratí
Missori Shitati	Misuri
Loyizanna Shitati	Luisiana
Kéntukki Shitati	Kentucky
Arkanzas Shtati	Arkansas
ئوردو تىلى	Urdu
Oklaxoma Shitati	Oklahoma
Potsdam	Potsdam
Hanofér	Hannover
Myunxén	Múnich
Drézdén	Dresde
ۋالىبول	Voleibol
Wyéna	Viena
Kopénhagén	Copenhague
Stokgolm	Estocolmo
Xélsinki	Helsinki
دۇبلىن	Dublín
رېيكياۋىك	Reikiavik
Tallin	Tallin
رىگا	Riga
براتىسلاۋا	Bratislava
Budapésht	Budapest
Danzig	Gdansk
Frankfort	Fráncfort del Meno
Wroklaw	Breslavia
لانتان	Lantano
جۈي	Prometio
چالغا	Samario
گادولنىي	Gadolinio
تېربىي	Terbio
Katolik dini	Catolicismo
ليۇكسېمبۇرگ شەھىرى	Luxemburgo (ciudad)
دىسپروزىي	Disprosio
ۋادۇز	Vaduz
ئىنجىل	Biblia
گولمىي	Holmio
ئېربىي	Erbio
فنوم پېن	Nom Pen
تۇلىي	Tulio
سايگون	Ciudad Ho Chi Minh
ئىتتېربىي	Iterbio
لۇتېتسىي	Lutecio
خانوي	Hanói
ھەقىقى ئەيسا چېركاۋى	Verdadera Iglesia de Jesús
ئىنگىلىز تىلى	Idioma inglés
Bangkok	Bangkok
ئاندوررا كەنتى	Andorra la Vieja
كۇئالالۇمپۇر	Kuala Lumpur
تەيبېي شەھىرى	Taipéi
ئامېرىتسىي	Americio
كىيۇرىي	Curio
Concepción, Chile	Concepción (Chile)
بېركېلىي	Berkelio
كالىفورنىي	Californio
ئېينشتېينىي	Einstenio
فېرمىي	Fermio
مېندېلېيېۋىي	Mendelevio
كىيېۋ	Kiev
نوبېلىي	Nobelio
لاۋرېنسىي	Lawrencio
كارېلىيە	República de Carelia
Ottawa	Ottawa
Manitoba Ölkisi	Manitoba
Albérta	Alberta
Nowa Skotiye Ölkisi	Nueva Escocia
يېرېۋان	Ereván
دارېسسالام	Dar es-Salam
خارتۇم	Jartum
Yéngi Brunswik Ölkisi	Nuevo Brunswick
Britani Kolumbiye	Columbia Británica
Saskachéwan	Saskatchewan
Néwfundland Ölkisi	Terranova y Labrador
Gherbiy Shimal Rayoni	Territorios del Noroeste
Yukon Rayoni	Yukón
Florénsa	Florencia
Ésén	Essen
كومى	Komi
Léypzig	Leipzig
Nyurnbérg	Núremberg
Édmonton	Edmonton
Man'géym	Mannheim
Wiktoriye, Britani Kolumbiye	Victoria (Columbia Británica)
Winnipég	Winnipeg
Halifaks	Halifax
Kwébék Shehiri	Quebec (ciudad)
ئېلېكترون	Electrón
Birmin'gxam	Birmingham
مىنىسكى	Minsk
مىكروسوفىت شىركىتى	Microsoft
پروتون	Protón
Kurow	Kurów
Naplés	Nápoles
Braunshwéyg	Brunswick
Madrid	Madrid
سۇ ئاستى كېمىسى	Submarino
مايكېل جېكسۇن	Michael Jackson
Bogota	Bogotá
لىما	Lima
Santiyago	Santiago de Chile
كىتو	Quito
سۇكرې	Sucre
ئاسۇنسىئون	Asunción
Öçke	Capra aegagrus hircus
Héydélbérg	Heidelberg
كاتماندۇ	Katmandú
سان خوسې (كوستارىكا)	San José (Costa Rica)
سان سالۋادور	San Salvador
Kanbérra	Canberra
Sidnéy	Sídney
يېشىل رەڭ	Verde
Mélburn	Melbourne
قىزىل رەڭ	Rojo
ماناگۇئا	Managua
رابات	Rabat
قۇيرۇقلۇق يۇلتۇز	Cometa
ئالجىر	Argel
تۇنىس شەھىرى	Túnez (ciudad)
ترىپولى	Trípoli
تېھران	Teherán
جاكارتا	Yakarta
Enqere	Ankara
رىياد	Riad
بېلگراد	Belgrado
ئادىگېيە	Adigueya
پرايا	Praia
دەمەشىق	Damasco
يامۇسسۇكرو	Yamusukro
فرانسىيىگە قاراشلىق گۋىئانا	Guayana Francesa
لومې	Lomé
ئاممان	Amán
بېيرۇت	Beirut
مۇسكات	Mascate
نىكوسىيە	Nicosia
دوھا	Doha
نايروبى	Nairobi
لۇساكا	Lusaka
ئامازون	Amazon.com
قۇياش تۇتۇلۇشى	Eclipse solar
كامپالا	Kampala
Mektep	Escuela
ھارارې	Harare
Prétoriye	Pretoria
Astiraxan	Astracán
Tiktak top	Tenis de mesa
Wikipedia:Sandbox	Wikipedia:Zona de pruebas
قالماقىستان	Kalmukia
Osasko	Osasco
Glasgow	Glasgow
Kuritiba	Curitiba
Orman	Bosque
بوغاز كۆۋرۈكى	Puente del Bósforo
كۇڭزى	Confucio
كوربين بيلو	Corbin Bleu
Surat	Surat
ياۋرۇ	Euro
ئامېرىكا دولىرى	Dólar estadounidense
يەر ئوتتۇرا دېڭىزى	Mar Mediterráneo
خاڭجۇ شەھىر	Hangzhou
مەسىھچىلىك	Cristianismo
Séatl	Seattle
Baltimor	Baltimore
ئادېلايدې	Adelaida (Australia)
داغىستان	Daguestán
Monzón	Monzón (Huesca)
گۇجارات تىل	Idioma guyaratí
پورتۇگال تىلى	Idioma portugués
مۇستاپا كامال	Mustafa Kemal Atatürk
چېچېنىيە	Chechenia
كۋېچۇئا تىلى	Lenguas quechuas
ئىنگۇشېتىيە	Ingusetia
شىمالىي ئوسېتىيە	Osetia del Norte-Alania
كاباردىنو-بالقارىستان	Kabardia-Balkaria
ئالماس	Diamante
ياپون تىلى	Idioma japonés
Énsklopédiye	Enciclopedia
ئۇيغۇرچە ۋىكىپىدىيە	Wikipedia:Portada
Latex	LaTeX
كوندېنساتور	Condensador eléctrico
قاراچاي-چېركېسىيە	Karacháyevo-Cherkesia
موردوۋىيە	Mordovia
ۋاسكېتبول	Baloncesto
چاڭجياڭ دەرياسى	Yangtsé
ئۇدمۇرتىيە	Udmurtia
مارى	Mari-El
ھىمالايا تاغ تىزمىسى	Himalaya
ئاند تاغلىرى	Cordillera de los Andes
قىيىلىق تاغلار	Montañas Rocosas
Kapétown	Ciudad del Cabo
چۇۋاشىيە	Chuvasia
تەڭرىتاغ	Tian Shan
كاۋكاز تاغ تىزمىسى	Montañas del Cáucaso
تاتارىستان	Tartaristán
1279-يىلى	1279
ۋېىنىست	Vincent van Gogh
باشقۇرتىستان	Baskortostán
Semerqend	Samarcanda
Buxara	Bujará
بېتلېخېم	Belén
Andalusiye	Andalucía
كايمان تاقىم ئاراللىرى	Islas Caimán
Kordowa	Córdoba (España)
شىئەن شەھىرى	Xi'an
كابۇل	Kabul
لاسا شەھىرى	Lhasa
غىلاپ	Vagina
تامىل تىلى	Idioma tamil
پەلسەپە	Filosofía
ئالەم ئايرۇپىلانى	Vuelo espacial
ئالتاي تاغ تىزمىسى	Macizo de Altái
تۈر:Candidates for speedy deletion	Categoría:Wikipedia:Borrar (definitivo)
ئالتاي	República de Altái
پىئانىنو	Piano
Hebe Camargo	Hebe Camargo
Portland, Orégon	Portland
ئانارخىزم	Anarquismo
لىبېرالىزىم	Liberalismo
فاشىسىت	Fascismo
مىللەتچىلىك	Nacionalismo
غەربىي ساھارا	Sahara Occidental
ھىلاري كلىنتون	Hillary Clinton
خاكاسىيە	Jakasia
Strasburg	Estrasburgo
ياكۇتىيە	República de Sajá
كرودىيە تىلى	Idioma croata
گائۇس	Carl Friedrich Gauss
بۇرياتىيە	Buriatia
جامىس جويىس	James Joyce
كاتالان تىلى	Idioma catalán
Burχa	Buda (concepto)
دىنسىزلىق	Ateísmo
لى بەي	Li Bai
دۇنيا بانكىسى	Banco Mundial
كونسېرۋاتىپ	Conservadurismo
شىمالىي ئاتلانتىك ئەھدى تەشكىلاتى	OTAN
نوبېل مۇكاپاتى	Premio Nobel
چىن شىخۇاڭ	Qin Shi Huang
خەن سۇلالىسى	Dinastía Han
فېمىنىزم	Feminismo
ئىدېئولوگىيە	Ideología
پەي توپ	Bádminton
يۈەن سۇلالىسى	Dinastía Yuan
كولۇمبو	Cristóbal Colón
يەھۇدىلار	Pueblo judío
سېرىق دەريا	Río Amarillo
قۇلاق	Oído
بۇرۇن	Nariz
كۆز	Ojo
مۇسكۇل	Músculo
Töge	Camelus
چۈمۈلە	Formicidae
سۈي سۇلالىسى	Dinastía Sui
گوللاندىيە تىلى	Idioma neerlandés
ماگرىت ساچىر	Margaret Thatcher
ياڭ جىيەن	Yang Jian
دېئوكسىرىبونۇكلېئىك كىسلاتا	Ácido desoxirribonucleico
سۇڭ سۇلالىسى	Dinastía Song
Çeyze	Solanum melongena
رۇس تىلى	Idioma ruso
ساخالىن	Isla de Sajalín
نېفىت ئېكىسپورت قىلغۇچى دۆلەتلەر تەشكىلاتى (OPEC)	Organización de Países Exportadores de Petróleo
خەلقئارا پۇل فوندى تەشكىلاتى	Fondo Monetario Internacional
دۇنيا سودا تەشكىلاتى	Organización Mundial del Comercio
سۋاھىلىچە	Idioma suajili
توكيو ئۇنىۋېرستېتى	Universidad de Tokio
خەنزۇ تىلى	Idioma chino
ئۆپكە	Pulmones
نەپەسلىنىش سىستېمى	Aparato respiratorio
رۇمىنىيە تىلى	Idioma rumano
بۇلغارىيە تىلى	Idioma búlgaro
يەر تەۋرەش	Terremoto
ماگادان	Magadán
تەبىئىي پەن	Ciencias naturales
فرانكلىن روزۋېلت	Franklin D. Roosevelt
ﺋﯩﺒﯩﻦ ﺳﯩﻨﺎ	Avicena
نىلسۇن ماندىلا	Nelson Mandela
مارتىن لوتىر كىڭ	Martin Luther King
Yanardag	Volcán
ئىسسىق بەلباغ سىكلونى	Ciclón tropical
تېلۇگۇ تىلى	Idioma télugu
گرۇزىن تىلى	Idioma georgiano
ئىقتىسادشۇناسلىق	Economía
يېن	Yen
قىزىل تۈلكە	Vulpes vulpes
ئىسكىرىپكا	Violín
چوڭ ئىسكىروپكا	Violonchelo
ئىسكەندەر زۇلقەرنەيىن	Alejandro Magno
ئۆمەر ئىبنى خەتتاب	Umar ibn al-Jattab
ئامۇ دەرياسى	Amu Daria
سۈت	Leche
سۇن جۇڭشەن	Sun Yat-sen
شياڭگاڭ	Hong Kong
Miami	Miami
كاراچى	Karachi
Rio dé Janéyro	Río de Janeiro
سوغۇق ئۇرۇش	Guerra Fría
شاڭخەي شەھىرى	Shanghái
Bilbaw	Bilbao
Séwéliye	Sevilla
چىڭ سۇلالىسى	Dinastía Qing
توماس ئىدىسون	Thomas Alva Edison
ئالبان تىلى	Idioma albanés
باسكى تىلى	Euskera
ئاراگون تىلى	Idioma aragonés
ئەرمەن تىلى	Idioma armenio
ئۇكرائىن تىلى	Idioma ucraniano
Walénsiye	Valencia
Malaga	Málaga
شۋېتسىيە تىلى	Idioma sueco
دانىش تىلى	Idioma danés
نورۋېگىيە تىلى	Idioma noruego
ليۇكسېمبۇرگ تىلى	Idioma luxemburgués
چېخ تىلى	Idioma checo
سلوۋاك تىلى	Idioma eslovaco
كارل ماركىس	Karl Marx
سلوۋېن تىلى	Idioma esloveno
ماجار تىلى	Idioma húngaro
ۋولتىر	Voltaire
ئېستون تىلى	Idioma estonio
لاتۋىيە تىلى	Idioma letón
لىتۋا تىلى	Idioma lituano
ھىندى دىنى	Hinduismo
بېلورۇس تىل	Idioma bielorruso
يېلىن	Mama
ئاتوم	Átomo
گرېك تىلى	Idioma griego
ئرېلاندىيە تىلى	Idioma irlandés
مالتا تىلى	Idioma maltés
پارس تىلى	Idioma persa
ئىسلام	Religión
كورىيەچە	Idioma coreano
Injilning birinchi tomi	Génesis
كانتونچە	Cantonés estándar
ئېكسودۇس	Éxodo
ۋيېتنام تىلى	Idioma vietnamita
كخمېر تىلى	Idioma camboyano
لائوس تىلى	Idioma lao
تايلاندچە	Idioma tailandés
بىرما تىلى	Idioma birmano
مالاي تىلى	Idioma malayo
ھىندونېزىيە تىلى	Idioma indonesio
موڭغۇل تىلى	Idioma mongol
Baku	Bakú
قازاق تىلى	Idioma kazajo
قىرغىز تىلى	Idioma kirguís
تاجىك تىلى	Idioma tayiko
ئۆزبېك تىلى	Idioma uzbeko
تۈركمەن تىلى	Idioma turcomano
يەھۇدى دىنى	Judaísmo
تىمپۇ	Timbu
باندار سەرى بەگاۋان	Bandar Seri Begawan
ئىبرانى تىلى	Idioma hebreo
ئەزەربەيجان تىلى	Idioma azerí
ماكېدون تىلى	Idioma macedonio
سېرب تىلى	Idioma serbio
سېربو-كرودىيىلىكلەر تىلى	Idioma serbocroata
بوسنىيە تىلى	Idioma bosnio
گالىسىيەچە	Idioma gallego
ۋېلش تىلى	Idioma galés
دىلى	Dili
شوتلاندىيە گائېل تىلى	Gaélico escocés
Wyéntyan	Vientián
مالې	Malé
Bishkek	Biskek
Düshenbe	Dusambé
جىگەر	Hígado
تلا	Bazo
بۆرەك	Riñón
دوۋساق	Vejiga urinaria
نېرۋا سىستىمېسى	Sistema nervioso
ئوكيانىيە	Océano
مۇھەممەد ئەلەيھىسسالام	Mahoma
ئىمام ئەلغازالىي	Al-Ghazali
رىچارد نىكسون	Richard Nixon
قورساق قىسم	Abdomen
داۋجياۋ دىنى	Taoísmo
سوپىزم (تەسەۋۋۇپ)	Sufismo
ۋېنا تومۇرى	Vena
بېنگال تىلى	Idioma bengalí
تىل	Lengua (anatomía)
پانكرېئاتىت	Páncreas
بويۇن	Cuello
ئېغىز بوشلۇقى	Boca
بوغۇز	Laringe
فالكلاند تاقىم ئاراللىرى	Islas Malvinas
سازاڭسىمان ئۆسۈكچە	Apéndice vermiforme
ئېلىزابېت II	Isabel II del Reino Unido
تاڭ سۇلالىسى	Dinastía Tang
كېننېدى	John F. Kennedy
تاڭ تەيزوڭ	Li Shimin
بالزاك	Honoré de Balzac
مىڭ سۇلالىسى	Dinastía Ming
جۇ يۈەنجاڭ	Zhū Yuánzhāng
رېگان	Ronald Reagan
زۇلۇچە	Idioma zulú
زازا تىلى	Zazaki
پلازما	Plasma (estado de la materia)
رىم گىلادىئاتورلار مەيدانى	Coliseo
Saragossa	Zaragoza
Bélfast	Belfast
ئېلېمېنتلارنىڭ دەۋرىي جەەدۋىلى	Tabla periódica de los elementos
قۇرۇق ئۈزۈم	Uva
ھەسەل	Miel
شېكەر	Azúcar
روبوت	Robot
ماشىنىسازلىق	Máquina
ئايلىنىش سىستېمىسى	Aparato circulatorio
ئىچكى ئاجراتما سىستېمىسى	Sistema endocrino
كىسلاتا	Ácido
سارايېۋو	Sarajevo
تۇز	Sal
فۇنكسىيە	Función matemática
مولېكۇلا	Molécula
ئېنېرگىيە	Energía
ئىنفرا قىزىل نۇر	Radiación infrarroja
ماسسا	Masa
مېتال	Metal
پولات	Acero
نانو تېخنىكىسى	Nanotecnología
ئەينەك	Vidrio
ۋاكۇئۇم	Vacío
ئېلېكترون ئىلمى	Electrónica
.توك (توك ئېقىمى)	Corriente eléctrica
ئىككى پۇتلۇق لامپا	Diodo
ئامېرىكىغا قاراشلىق ۋىرگىن تاقىم ئاراللىرى	Islas Vírgenes de los Estados Unidos
شېنياڭ شەھىرى	Shenyang
چۇڭچىڭ شەھىرى	Chongqing
تيەنجىن شەھىرى	Tianjín
Lahor	Lahore
ۋۇخەن شەھىرى	Wuhan
نۆۋەتتىكى ھادىسە	Anexo:Países
ناگويا	Nagoya
تاش قورال دەۋرى	Edad de Piedra
ئېيىق	Ursidae
فوتوسىنتېز رولى	Fotosíntesis
برېتون تىلى	Idioma bretón
پىرېنېي تاغلىرى	Pirineos
Détroyt	Detroit
بۇرج دۇبەي	Burj Khalifa
Sedichin Sépili	Gran Muralla China
ئاياسوڧيا	Santa Sofía
ئابباسىيلار خاندانلىقى	Califato abasí
سەلىپنىڭ شەرققە يۈرۈش قىلىشى	Cruzadas
موڭغۇل ئىمپېرىيىسى	Imperio mongol
ئوسمان ئىمپېرىيىسى	Imperio otomano
ئىسپانىيە-ئامېرىكا ئۇرۇشى	Guerra hispano-estadounidense
مىللى دارامەت	Producto interno bruto
ئېلېكتر	Electricidad
يادرو ئېنېرگىيىسى	Energía nuclear
ھور ماشىنىسى	Máquina de vapor
Antwérp	Amberes
باش سۆڭىكى	Cráneo
ئانار	Punica granatum
ئاپېلسىن	Citrus × sinensis
دۇنيا تىلى	Romanche
جۇاڭزۇ تىلى	Idioma chuang
ئۇيغۇر تىلى	Idioma uigur
سىنگال تىلى	Idioma cingalés
ناخۇئاتل تىلى	Náhuatl
مونتسەررات	Montserrat
خارۋارد ئۇنىۋېرسىتېتى	Universidad de Harvard
Pisa	Pisa
باشقۇرتچە	Idioma baskir
قېلىپ:Location map Earth	Plantilla:Mapa de localización de Tierra
باغلانغان ئۆردەك	Le Canard enchaîné
ئەرەب تىلى	Idioma árabe
كيۇسيۇ ئارىلى	Kyūshū
خونسيو ئارىلى	Honshū
شىكوكۇ	Región de Shikoku
كورسىكا ئارىلى	Córcega
ئاڧرىقانچە	Afrikáans
بۆرە بورسۇق	Gulo gulo
ئاۋمېن	Macao
خۇ جىنتاۋ	Hu Jintao
شى جىنپىڭ	Xi Jinping
زىراپە	Giraffa camelopardalis
شېنجېن شەھىرى	Shenzhen
گۇئاڭدوڭ ئۆلكىسى	Provincia de Cantón
گۇاڭشى جۇاڭزۇ ئاپتونۇم رايونى	Guangxi
سوۋېت ئىتتىپاقى	Unión Soviética
شياڭگاڭ ئۇنىۋېرستېتى	Universidad de Hong Kong
شياڭگاڭ جۇڭگو تىللىرى ئۇنۋېرسىتېتى	Universidad China de Hong Kong
رۇبلى	Rublo
پۇت	Pie
دولا	Hombro
قالقانبەز	Glándula tiroides
قېلىپ:Link FA	Plantilla:Destacado
Wikipedia:Tor Jamiyeti	Wikipedia:Café
Wérmont Shitati	Vermont
San Diyégo	San Diego (California)
San Xosé	San José (California)
Dénwér	Denver
Hyuston	Houston
Féniks	Phoenix
Dallas	Dallas
Austin	Austin
Mémfis, Ténnéssi	Memphis
Sharlot	Charlotte
Kolumbu, Oxéo	Columbus (Ohio)
گۇاڭجۇ شەھىرى	Cantón (China)
جىياڭ جىشى	Chiang Kai-shek
ۋېن جىياباۋ	Wen Jiabao
Guam Aril	Guam
ئامېرىكىغا قاراشلىق ساموئا	Samoa Americana
شىمالىي مارىئانا فېدېراتسىيىسى	Islas Marianas del Norte
نەنجىڭ شەھىرى	Nankín
بېيجىڭ ئۇنىۋېرسىتېتى	Universidad de Pekín
ئۈرۈمچى شەھىرى	Urumchi
جياڭسۇ ئۆلكىسى	Jiangsu
جېجياڭ ئۆلكىسى	Zhejiang
گۇئادەلوپە	Guadalupe (Francia)
مارتىنىكا	Martinica
شىزاڭ ئاپتونوم رايونى	Tíbet
دالاي لاما	Tenzin Gyatso
تۆگىقۇش	Struthio camelus
Sakraménto	Sacramento (California)
چاۋشيەن	Corea
لى كېچياڭ	Li Keqiang
Manchéstér	Mánchester
تۇركس ۋە كايكوس تاقىم ئاراللىرى	Islas Turcas y Caicos
ۋىتامىن A	Vitamina A
ياۋروپا چىمپيونلۇق لوڭقىسى	Liga de Campeones de la UEFA
پالمىزارلىق ئىپار مۈشۈكى	Paradoxurus hermaphroditus
Pyongyang	Pionyang
New Testament	Nuevo Testamento
ئادالەت ۋە تەرەققىيات پارتىيىسى	Partido de la Justicia y el Desarrollo (Turquía)
گۈللىنىش پارتىيىسى	Partido Republicano del Pueblo (Turquía)
مىللى دارامەت بويىچە دۆلەت تەرتىپى	Anexo:Países por PIB (nominal)
خېيلوڭجياڭ ئۆلكىسى	Heilongjiang
ما يىنجىئۇ	Ma Ying-jeou
بۇخارېست	Bucarest
پوئىرتورىكان مۇستەقىللىق پارتىيىسى	Partido Independentista Puertorriqueño
Tirana	Tirana
ئېشەك	Equus africanus asinus
سىچۈەن ئۆلكىسى	Sichuan
مۇھەممەر قەززافى	Muamar el Gadafi
بارس	Panthera tigris
چۆپ ئاش	Vermicelli
سامسۇڭ گۇرۇھى	Samsung
شىمالىي ياۋروپا	Escandinavia
كىشىنېۋ	Chisináu
بیلگیسايار مۈھەندیسلیغی	Ciencias de la computación
Şalom	Şalom
ئارۇبا	Aruba
خېبېي ئۆلكىسى	Hebei
پرىنسېتون ئۇنىۋېرستېتى	Universidad de Princeton
نېفىت	Petróleo
پېنسىلۋانىيە نېمىس تىلى	Alemán de Pensilvania
پرژىۋالسكى ياۋا ئات	Equus ferus przewalskii
قوي	Ovis
ئىرلاندىيە	Irlanda (isla)
Chéshir	Cheshire
Nortumbér Wilayiti	Northumberland
Staffordshir	Staffordshire
ﻟﯘﺷﯜﻥ	Lu Xun
Shimaliy Amptonshir	Northamptonshire
Bédfordshir	Bedfordshire
Kornwél	Cornualles
Bristol	Brístol
Déwonshir	Devon
خالتىلىق چاشقانلار ئائىلىسى	Macropodidae
Nashwil	Nashville
Xampishir	Hampshire
Bérkshir	Berkshire
Bukkinxamshir	Buckinghamshire
Ésséks	Essex
Ként	Kent
Ulanbatur	Ulán Bator
ئېرنېست ھېمىڭۋاي	Ernest Hemingway
Idinburg	Edimburgo
ئاشخاباد	Asjabad
پىياز	Allium cepa
پەمىدۇر	Solanum lycopersicum
جورج بۇش	George H. W. Bush
بالقانلار	Península balcánica
پروتېستانت دىنى	Protestantismo
سەلەنا	Selena Quintanilla Pérez
Atlanta	Atlanta
بېرمۇدا	Bermudas
باش	Cabeza
ۋېللىنگتون	Wellington (Nueva Zelanda)
روبوتلارنىڭ ئۈچ قانۇنى	Tres leyes de la robótica
ئالفېرد نوبىل	Alfred Nobel
لیلا چڑھاو	Lila Downs
907-يىلى	907
Wankuwér	Vancouver
Liwérpol	Liverpool
Brémén	Bremen
يېڭى نورۋېگىيە تىلى	Nynorsk
پوند ستېرلىڭ	Libra esterlina
ئانگۋىللا	Anguila (dependencia)
فائېروس تىل	Idioma feroés
مۈشۈك ئائىلىسى	Felidae
ISO 3166-1	ISO 3166-1
تاتار تىلى	Idioma tártaro
ئەنگلىيىگە قاراشلىق ۋىرگىن تاقىم ئاراللىرى	Islas Vírgenes Británicas
كىچىك سېسىق كۈزەنى	Mustela nivalis
فرىزانچە	Lenguas frisonas
ئاق ئاغمىخان	Mustela erminea
قارشىلىق	Resistencia eléctrica
ناۋاسسا ئاراللىرى	Isla de Navaza
سېنت بارتھېلەمي ئاراللىرى	San Bartolomé (Francia)
شىمالىي گېرمانىيە دىئالېكتى	Bajo alemán
ئاغمىخان ئائىلىسى	Mustelidae
ساينت مارتىن	Isla de San Martín
بۆكەن	Antílope
قارا بۇلغۇن	Martes zibellina
سۈنئىي ھەمراھ	Satélite artificial
قوتاز	Bos mutus
ب م ۋ	BMW
Kuk Taqim Aralliri	Islas Cook
رەشىدە داتى	Rachida Dati
شەرقىي ئاسىيا	Asia Oriental
ئوتتۇرا ئاسىيا	Asia Central
ئاق تۆش بۇلغۇن	Martes foina
ياۋا ئات	Equus ferus
ئامخارا تىلى	Idioma amhárico
Képinek	Lepidoptera
چاچ	Pelo
ھىجرىيە كالېندارى	Calendario musulmán
جيامۇسى شەھىرى	Jiamusi
كەبەك	Kebek
دىرىخلې	Peter Gustav Lejeune Dirichlet
ئاستۇرىيە تىلى	Asturiano (asturleonés de Asturias)
خىتاي	China (región)
قاما	Lutra lutra
چېڭدۇ شەھىر	Chengdú
يىلپىز	Panthera uncia
جېڭجۇ شەھىرى	Zhengzhou
تېرېسا ئانا	Teresa de Calcuta
DELL شىركىتى	Dell
فرانسىيىگە قاراشلىق پولىنېزىيە	Polinesia Francesa
618-يىلى	618
روژدېستۋو ئاراللىرى	Isla de Navidad
Krakow	Cracovia
بېيجىڭ پايتەخت ئايروپورتى	Aeropuerto Internacional de Pekín-Capital
تىراختور	Tractor Sazi FC
ۋېنىسىيە تىلى	Idioma véneto
تەيۋەن ئۇنۋېرسىتې	Universidad de Taiwán
جامى	Mezquita
تۇڭگان تىلى	Idioma dungano
كورسىكا تىلى	Idioma corso
فىلىپىنچە	Idioma filipino
چۇۋاش تىلى	Idioma chuvasio
قرىم تاتار تىلى	Idioma tártaro de Crimea
ھايتى كرېئول تىلى	Criollo haitiano
قارا قالپاق تىلى	Idioma karakalpako
ياۋا تىلى	Idioma javanés
مۈشۈكئېيىق	Ailuropoda melanoleuca
قالماق تىلى	Idioma calmuco
مانجۇ تىلى	Idioma manchú
كانناداچە	Idioma canarés
مۇڭغۇل تىللىرى	Lenguas mongólicas
پوچېركا	Mano
دۇفۇ	Du Fu
يېڭى كالېدونىيە	Nueva Caledonia
ئورىياچە	Idioma oriya
نېپال تىلى	Idioma nepalí
نېئاپول تىلى	Idioma napolitano
نورمان تىلى	Idioma normando
تېئودور روزېۋېلت	Theodore Roosevelt
تېلاۋىف	Tel Aviv
Nis	Niza
سىتسىلىيە تىلى	Idioma siciliano
ساردىنىيە تىلى	Idioma sardo
ژىيۇل ۋېرن	Julio Verne
سىندى تىلى	Idioma sindhi
سۇندا تىلى	Idioma sondanés
شونا تىلى	Idioma shona
Niué Arili	Niue
تاگالوگ تىلى	Idioma tagalo
تۈركى تىللار ئائىلىسى	Lenguas túrquicas
تونگاچە	Idioma tongano
ئۇرال تىللىرى	Lenguas urálicas
تىگرىنىيەچە	Idioma tigriña
Oksford	Oxford
تۇنگۇس مانجۇ تىللىرى	Lenguas tunguses
زاڭزۇ تىلى	Idioma tibetano
سارى ئۇغۇر	Yugur
ۋۇ تىلى	Chino wu
ۋىلسون	Woodrow Wilson
ياقۇت تىلى	Idioma yakuto
يورۇباچە	Idioma yoruba
سېسوتوچە	Sesotho
Rottérdam	Róterdam
Yéngi Orléan	Nueva Orleans
فۇشەن شەھىر	Foshan
ئوكسفورد ئۇنىۋېرسىتېتى	Universidad de Oxford
ئەھمىدى نىجات	Mahmud Ahmadineyad
Saynt Xéléna Arili	Isla Santa Elena
بارماق	Dedo
ساينت پىئېر ئارىلى ۋە مىكېلون تاقىم ئاراللىرى	San Pedro y Miquelón
ئون پەرھىز	Diez Mandamientos
Yohannésburg	Johannesburgo
قاپلان	Panthera pardus
Saltzburg	Salzburgo
X نۇرى	Rayos X
شىنجاڭ ئۇيغۇر ئاپتونوم رايونى	Sinkiang
Albukwér kwé	Albuquerque
Oklaxoma Shehiri	Oklahoma City
برىسبان	Brisbane
ئىسساك ئاسىموۋ	Isaac Asimov
جەنۇبىي گىئورگىيە ۋە ساندۋىچ ئاراللىرى	Islas Georgias del Sur y Sandwich del Sur (territorio británico de ultramar)
كۇۋائىت شەھىرى	Kuwait (ciudad)
ئەرەبلەر	Pueblo árabe
سۇمېرلار	Sumeria
كولومبو	Colombo
ئالمۇتا	Almatý
قانداغاي	Alces alces
ۋاللىس ۋە فۇتۇنا تاقىم ئاراللىرى	Wallis y Futuna
تاتار مىللىتى	Tártaros
خوككايدو ئارىلى	Hokkaidō
ئۇرال تاغلىرى	Montes Urales
ماددا	Materia
ئوساكا	Osaka
كامبرىج ئۇنىۋېرستېتى	Universidad de Cambridge
ئاكا-ئۇكا رايتلار	Hermanos Wright
گۇئارانچە	Idioma guaraní
شور دېڭىز	Mar de Aral
ئىستانبۇل بوغازى	Bósforo
Izmir	Esmirna
كەئەلىڭ كوكوس تاقىم ئاراللىرى	Islas Cocos
مېرسېدېس - بېنز	Mercedes-Benz
كۋېنسلاند	Queensland
Minnéapolis	Minneapolis
دەرەخ خالتىلىق ئېيىقى	Phascolarctos cinereus
2011-يىلدىكى ياپونىيە يەر تەۋرەش ۋە دېڭىز تاشقىنى	Terremoto y tsunami de Japón de 2011
لىنگالاچە	Idioma lingala
مالايالامچە	Malayalam
يىپەك يولى	Ruta de la seda
Kalgari	Calgary
ئوستىيىن	Jane Austen
قوڭۇر ئېيىق	Ursus arctos
كۇرد تىلى	Idioma kurdo
مولداۋىيە تىلى	Idioma moldavo
يېڭى تاش قۇرال دەۋرى	Neolítico
مورېسبى پورتى	Puerto Moresby
خىمىيىلىك رېئاكسىيە	Reacción química
لاھەي	La Haya
جۇاڭزۇ مىللىتى	Etnia zhuang
ئوسمانلى تۈركچىسى	Idioma turco otomano
يۇھاننا بايان قىلغان خۇش خەۋەر	Evangelio de Juan
توكېلاۋ تاقىم ئاراللىرى	Tokelau
تۋىچە	Idioma twi
چېڭلۇڭ	Jackie Chan
توخار تىلى	Lenguas tocarias
ئېلان	Publicidad
Zeytun	Olea europaea
ئاۋكلاند	Auckland
سەككىز دۆلەت گۇرۇھى (G8)	G8
ئاۋكادۇر	Persea americana
قىزىل قان دانىچىلىرى	Eritrocito
ئوقۇتقۇچى	Maestro
تىز	Articulación de la rodilla
ئۆرۈك	Prunus armeniaca
گلۇكوزا	Glucosa
Sint-Truiden	Sint-Truiden
ئالتاي تىللىرى سىستېمىسى	Lenguas altaicas
ناتالىيە پورتمەن	Natalie Portman
Ran'gon	Rangún
ناگاساكى	Nagasaki
يوكوخاما	Yokohama
ئادانا	Adana
لازېر نۇرى	Láser
Lyuju shehiri	Liuzhou
خەلق پۇلى يۈەنى	Yuan chino
Ritis	Leeds
رەجەپ تاييىپ ئەردوغان	Recep Tayyip Erdoğan
قىزغۇچ سېرىق	Naranja (color)
شىمال بۇغىسى	Rangifer tarandus
لۇقا بايان قىلغان خۇش خەۋەر	Evangelio de Lucas
كونا تاش قۇرال دەۋرى	Paleolítico
ئانتاليا ۋىلايىتى	Provincia de Antalya
ھەزرىتى ئەيسا ئەلچىلىرىنىڭ پائالىيەتلىرى	Hechos de los Apóstoles
پەرۋەز مۇشەررەڧ	Pervez Musharraf
ئادانا ۋىلايىتى	Provincia de Adana
تاشقا ئايلانغان جىسىم	Fósil
بۇرسا	Bursa
ئۇرۇق	Semilla
ئەنخۇي ئۆلكىسى	Anhui
خەلقئارا ئولىمپىك كومىتىتى	Comité Olímpico Internacional
ماڭلاي	Frente (anatomía)
ئىچكى موڭغۇل ئاپتونوم رايونى	Mongolia Interior
Nottingxam	Nottingham
راكېتا	Cohete
كۇردىستان	Kurdistán
ستانفورد ئۇنىۋېرستېتى	Universidad Stanford
فۇجيەن ئۆلكىسى	Fujian
Kanzas Shehiri, Missuri	Kansas City (Misuri)
كىچىك مۈشۈكئېيىق	Ailurus fulgens
موڭغۇل مىللىتى	Mongol (etnia)
ۋەھىيلەر	Apocalipsis
Sirtlan	Hyaenidae
كاسا	Nalga
خەينەن ئۆلكىسى	Hainan
رىمان	Bernhard Riemann
گەنسۇ ئۆلكىسى	Gansu
ئاق قان ھۈجەيرىسى	Leucocito
ئەنگلىيىلىكلەر	Pueblo inglés
ئاناتول فرانس	Anatole France
ئوتلاق ياۋا مۈشۈكى	Felis silvestris lybica
جەينەك	Articulación del codo
سۇجۇ شەھىرى	Suzhou
جاڭگال مولۇنى	Felis chaus
بېنگال مولۇنى تاغ مۈشۈكى	Prionailurus bengalensis
Wénju shehiri	Wenzhou
ۋۇشى شەھىرى	Wuxi
Shawshin shehiri	Shaoxing
خەنزۇ مىللىتى	Etnia han
نىڭبو شەھىرى	Ningbo
ئابدۇللاھ گۈل	Abdullah Gül
نېمىسلار	Alemanes
خاربىن شەھىرى	Harbin
Orkéstr	Orquesta
تۈرك قەھۋەسى	Café turco
قىزىل ياقۇت	Rubí
كەشمىر	Cachemira (región)
گالاتا ساراي	Galatasaray S.K
كەۋىن رۇد	Kevin Rudd
يۈننەن ئۆلكىسى	Yunnan
مالكولم X	Malcolm X
مەۋلانا جالالىددىن رۇمى	Yalal ad-Din Muhammad Rumi
Plimowt	Plymouth
شەندۇڭ ئۆلكىسى	Shandong
قول	Brazo
Dérbi	Derby
ياقۇت رەڭلىك	Esmeralda
كىرىستال	Cristal
خېنەن ئۆلكىسى	Henan
بۇرسا ۋىلايىتى	Provincia de Bursa
ئارتۋىن ۋىلايىتى	Provincia de Artvin
كىندىك	Ombligo
ئادىيامان ۋىلايىتى	Provincia de Adıyaman
لياۋنىڭ ئۆلكىسى	Liaoning
خىمىيىلىك باغ	Enlace químico
GNU	GNU
توچىگى ناھىيىسى	Prefectura de Tochigi
سېمونت	Cemento
جىلىن ئۆلكىسى	Jilin
ئافيون قاراھىسار ۋىلايىتى	Provincia de Afyonkarahisar
بېربېرلار	Bereberes
ئېچىتقۇ	Levadura
خۇنەن ئۆلكىسى	Hunan
ھونلار	Hunos
چىڭخەي ئۆلكىسى	Qinghai
ئۇيغۇر مىللىتى	Etnia uigur
بىلەجىك ۋىلايىتى	Provincia de Bilecik
خۇبېي ئۆلكىسى	Hubei
شەنشى ئۆلكىسى	Shanxi
يۈز	Mejilla
قوڭۇر رەڭلىك	Marrón
گۇيلىن ئۆلكىسى	Guizhou
بالىكەسىر ۋىلايىتى	Provincia de Balıkesir
كيوتو كىلىشىمنامىسى	Protocolo de Kioto sobre el cambio climático
ئانىلار بايرىمى	Día de la Madre
خەلقئارا ئىسلام كېڭىشى تەشكىلاتى	Organización para la Cooperación Islámica
چاناققالە ۋىلايىتى	Provincia de Çanakkale
مىياگى ناھىيىسى	Prefectura de Miyagi
Luknow	Lucknow
شېنشى ئۆلكىسى	Shaanxi
رىملىقلارغا يېزىلغان خەت	Epístola a los romanos
مالىكىي مەزھىبى	Malikí
ئوقۇغۇچى	Estudiante
Kobe	Kōbe
ئىۋاتە ناھىيىسى	Prefectura de Iwate
كولۇمبىيە ئۇنىۋېرستېتى	Universidad de Columbia
بوستون ئۇنىۋېرستېتى	Universidad de Boston
يالې ئۇنىۋېرسىتېتى	Universidad Yale
پېنسىلۋانىيە ئۇنىۋېرستېتى	Universidad de Pensilvania
Portland, Méané	Portland (Maine)
نيۇيورك ئۇنىۋېرستېتى	Universidad de Nueva York
ئىتاليانلار	Pueblo italiano
پارىژ مېتروسى	Metro de París
پىرىت	Pirita
فىلىپىلىكلەرگە يېزىلغان خەت	Epístola a los filipenses
ئېگىزلىك گېرمان تىلى	Lenguas altogermánicas
قېلىپ:Taxobox	Plantilla:Ficha de taxón
قارا ئېقىم	Corriente de Kuroshio
خەلق گېزىتى	Diario del Pueblo
جياڭشى ئۆلكىسى	Jiangxi
ئىلھام ئالىيېۋ	İlham Əliyev
زاردارى	Asif Ali Zardari
نۇرسۇلتان نازاربايېۋ	Nursultán Nazarbáyev
نىڭشيا خۇيزۇ ئاپتونۇم رايونى	Ningxia
ئىسلام كەرىموۋ	Islom Karimov
شۈجو شەھىرى	Xuzhou
Lyenyün'gang shehiri	Lianyungang
ساۋكات مىرزىيويەۋ	Shavkat Mirziyayev
خۇەيئەن شەھىرى	Huai'an
Yangjo shehiri	Yangzhou
Teyju shehiri, Jyangsu	Taizhou (Jiangsu)
Nentung shehiri	Nantong
جاڭجياڭ شەھىرى	Zhenjiang
چاڭجو شەھىر	Changzhou
ئەھمەد داۋۇد ئوغلۇ	Ahmet Davutoğlu
تەيجۇ شەھىرى	Taizhou (Zhejiang)
جۇشەن شەھىرى	Zhoushan
شىجياجۇاڭ شەھىرى	Shijiazhuang
تاڭشەن شەھىرى	Tangshan
Chinxuangdaw shehiri	Qinhuangdáo
خەندەن شەھىرى	Handan
Bawding shehiri	Báoding
پەنجاب تىلى	Idioma punjabí
پاشتوچە	Idioma pastún
ساڭجو شەھىرى	Cangzhou
Langfang shehiri	Langfang
Juxey shehiri	Zhuhai
شەنتۇ شەھىرى	Shantou
Xuyjo shehiri	Huizhou
Dongwen shehiri	Dongguan
Jongshen shehiri	Zhongshan
Uyghurche Wikipédiye	Wikipedia en uigur
مىقدار سۆز	Numeral (lingüística)
ئۆت خالتىسى	Vesícula biliar
Jaypur	Jaipur
فۇجو شەھىرى	Fuzhou
Nenping shehiri	Nanping
Putyen shehiri	Putian
Senming shehiri	Sanming
Chüenju shehiri	Quanzhou
شيامېن شەھىرى	Xiamen
Jyangju shehiri	Zhangzhou
Longyen shehiri	Longyan
Ningdé shehiri	Ningde
Shining shehiri	Xining
تاغىل سېسىق كۈزەن	Vormela peregusna
ئادەم ئەلەيھىسسالام	Adán
خۇئاڭشى شەھىرى	Huangshi
ئائومورى ناھىيىسى	Prefectura de Aomori
فۇكۇشىما ناھىيىسى	Prefectura de Fukushima
تەييۈەن شەھىرى	Taiyuan
داتۇڭ شەھىر	Datong
داليەن شەھىرى	Dalian
ئەنشەن شەھىرى	Anshan
يىڭكۇ شەھىرى	Yingkou
لياۋياڭ شەھەر	Liaoyang
يوزگات ۋىلايىتى	Provincia de Yozgat
چوڭ مېڭە پوستلاق ماددىسى	Corteza cerebral
ئوڭچى	Derecha política
كارل ۋون دونىتىز	Karl Dönitz
سۆسۈنە ياقۇت	Amatista
بىنگۆل ۋىلايىتى	Provincia de Bingöl
تايغان بۇغا	Cervus elaphus
ئارداھان ۋىلايىتى	Provincia de Ardahan
ئايدىن ۋىلايىتى	Provincia de Aydin
ئاماسيا ۋىلايىتى	Provincia de Amasya
قازاق مىللىتى	Kazajo (etnia)
ئاغرى ۋىلايىتى	Provincia de Ağrı
بۇردۇر ۋىلايىتى	Provincia de Burdur
كورىنتلىقلارغا يېزىلغان بىرىنچى خەت	Primera epístola a los corintios
باتمان ۋىلايىتى	Provincia de Batman
كۇرىل ئاراللىرى	Islas Kuriles
يېڭى يەر	Nueva Zembla
Patna	Patna
سۇلتان ئاخمەت جامىي	Mezquita Azul
ۋان ۋىلايىتى	Provincia de Van
كونيا ۋىلايىتى	Provincia de Konya
ئاكىتا ناھىيىسى	Prefectura de Akita
سېگولەن رويال	Ségolène Royal
بولۇ ۋىلايىتى	Provincia de Bolu
دېنىزلى ۋىلايىتى	Provincia de Denizli
شافىئىي مەزھىپى	Shafi'i
گىپىس	Yeso (mineral)
ئېڭەك	Barbilla
ئامېرىكا ياۋا كالىسى	Bison bison
Léyséstér	Leicester
ساكاريا ۋىلايىتى	Provincia de Sakarya
ئاقساراي ۋىلايىتى	Provincia de Aksaray
قارس ۋىلايىتى	Provincia de Kars
دىيارباقىر ۋىلايىتى	Provincia de Diyarbakır
مور	Seta
تەيبېي 101	Taipei 101
ئەدىرنە ۋىلايىتى	Provincia de Edirne
ظوسذث	Lactuca sativa
بىتلىس ۋىلايىتى	Provincia de Bitlis
ئىباراكى ناھىيىسى	Prefectura de Ibaraki
ھاتاي ۋىلايىتى	Provincia de Hatay
زىيا گۆكئالىپ	Ziya Gökalp
يۇگوسلاۋىيە سوتسىيالىست فېدېرال جۇمھۇرىيىتى	República Federativa Socialista de Yugoslavia
تۈرك	Pueblos túrquicos
بارتىن ۋىلايىتى	Provincia de Bartın
باش بارماق	Dedo pulgar
كوجائەلى ۋىلايىتى	Provincia de Kocaeli
تۈرك خاقانلىقى	Turcos
سازاڭسىمان مەددە	Caenorhabditis elegans
چاڭچۈن شەھىرى	Changchun
جىلىن شەھىرى	Ciudad de Jilin
ئېمۇ قۇشى	Dromaius novaehollandiae
خاككارى ۋىلايىتى	Provincia de Hakkâri
راۋالپىندى	Rawalpindi
Emir Kusturica	Emir Kusturica
ماشىنىىسازلىق ئىنژىنىرلىقى	Ingeniería mecánica
ئاينۇ مىللىتى	Ainu
ئورانگوتان	Hominoidea
يېشىل ياقۇت	Berilo
Markus bayan qilghan xush xewer	Evangelio de Marcos
ئازۇرىت	Azurita
بېلىز شەھىرى	Ciudad de Belice
قۇشۇق ئارىلى	Isla Kaşık
مارشال	Mariscal
Chuju shehiri	Chuzhou
Rékazé shehiri	Shigatse
قىرىم	Tártaros de Crimea
كىلون تېخنىكىسى	Clonación
پروڧېسسور	Profesor
كورىنتلىقلارغا يېزىلغان ئىككىنچى خەت	Segunda epístola a los corintios
مۇغلا ۋىلايىتى	Provincia de Muğla
ئاسىيا قارا ئېيىق	Ursus thibetanus
گۈلچىلىك	Jardinería
ئىغدىر ۋىلايىتى	Provincia de Iğdır
ياماگاتا ناھىيىسى	Prefectura de Yamagata
قاڭشارلىق بۆكەن	Saiga tatarica
كۈتاھيا ۋىلايىتى	Provincia de Kütahya
كۆك ياقۇت	Zafiro
كۈرەشچى ئايروپىلان	Avión de caza
ئېرتىش دەرياسى	Río Irtish
ئىبرانىيلارغا يېزىلغان خەت	Epístola a los hebreos
گالاتىيلىقلارغا يېزىلغان خەت	Epístola a los gálatas
شاڭ سۇلالىسى	Dinastía Shang
كىلىس ۋىلايىتى	Provincia de Kilis
تەكىرداغ ۋىلايىتى	Provincia de Tekirdağ
سان	Muslo
مانىسا ۋىلايىتى	Provincia de Manisa
كىچىك مېڭە	Cerebelo
كولوسىلىقلارغا يېزىلغان خەت	Epístola a los colosenses
ياقۇپ يازغان خەت	Epístola de Santiago
يۇھاننا يازغان بىرىنچى خەت	Primera epístola de Juan
فىلىمۇنغا يېزىلغان خەت	Epístola a Filemón
سالونىكىلىقلارغا يېزىلغان ئىككىنچى خەت	Segunda epístola a los tesalonicenses
پاۋىل كرۇگمەنن	Paul Krugman
سالونىكىلىقلارغا يېزىلغان بىرىنچى خەت	Primera epístola a los tesalonicenses
پېترۇس يازغان بىرىنچى خەت	Primera epístola de Pedro
پېترۇس يازغان ئىككىنچى خەت	Segunda epístola de Pedro
تىموتىيغا يېزىلغان بىرىنچى خەت	Primera epístola a Timoteo
ئېسكىموسلار	Esquimal
چىكاگو ئۇنىۋېرستېتى	Universidad de Chicago
ماردىن ۋىلايىتى	Provincia de Mardin
مالاتيا ۋىلايىتى	Provincia de Malatya
مۇش ۋىلايىتى	Provincia de Muş
يۇھاننا يازغان ئىككىنچى خەت	Segunda epístola de Juan
يۇھاننا يازغان ئۈچىنچى خەت	Tercera epístola de Juan
يەھۇدا يازغان خەت	Epístola de Judas
تىموتىيغا يېزىلغان ئىككىنچى خەت	Segunda epístola a Timoteo
تىتۇسغا يېزىلغان خەت	Epístola a Tito
قىرقلارەلى ۋىلايىتى	Provincia de Kırklareli
ئاليۇمىن ئوكسىدى	Corindón
مەرسىن ۋىلايىتى	Provincia de Mersin
ئوتتۇرا ئاسىيا ياۋا تۆگىسى	Camelus bactrianus
بۇشەھر ۋىلايىتى	Provincia de Bushehr
تەكلىماكان قۇملۇقى	Taklamakán
پاچاق	Pata
قاشقىئوغلاق	Nyctereutes procyonoides
ئاشمورە ۋە كارتىئەر ئاراللىرى	Islas Ashmore y Cartier
قىرشەھەر ۋىلايىتى	Provincia de Kırşehir
ئەردەبىل ۋىلايىتى	Provincia de Ardebil
سىنوپ ۋىلايىتى	Provincia de Sinop
Ajax	AJAX
ئاتىلار بايرىمى	Día del Padre
شۆلگەي بېزى	Glándula salival
سېرىق قاشتېشى	Topacio
بىھارى تىلى	Lenguas bihari
Teynen shehiri	Tainan
ۋىتامىنE	Vitamina E
سۇلتان توغرۇلبەگ	Tugrïl Beg
Xéngyang shehiri	Hengyang
مالاي ئېيىقى	Helarctos malayanus
زامان گېزىتى	Zaman
مانجۇ مىللىتى	Manchú
تېرەك	Populus tremula
ھېيدېلبېرگ ئۇنىۋېرستېتى	Universidad de Heidelberg
سۇلايمان دېمىرەل	Süleyman Demirel
ۋەيران بولۇش	Quiebra
ج.ۋىللارد گىببس	Josiah Willard Gibbs
پۇت بارمىقى	Dedos del pie
نىغدە ۋىلايىتى	Provincia de Niğde
ئوتتۇرا ئاناتولىيە رايونى	Región de Anatolia Central
قارا دېڭىز رايونى	Región del Mar Negro
شەرقىي ئاناتولىيە رايونى	Región de Anatolia Oriental
يەر ئوتتۇرا دېڭىزى رايونى	Región del Mediterráneo
ئېگېي رايونى	Región del Egeo
مارمارا رايونى	Región del Mármara
شەرقىي جەنۇبىي ئاناتولىيە رايونى	Región de Anatolia Suroriental
لېيدېن ئۇنىۋېرستېتى	Universidad de Leiden
مېڭە ئاستى بېزى	Hipófisis
تۈر:سىياسىي جۇغراپىيە	Geopolítica
مۇرادئۈچ	Murad III
ئىدىنبۇرگ ئۇنىۋېرستېتى	Universidad de Edimburgo
فارابى	Al-Farabi
كۆك قۇتان	Ardea purpurea
گەۋدە	Tronco (anatomía)
ياپونىيىلىك	Pueblo japonés
پامىر ئېگىزلىكى	Cordillera del Pamir
تولۇق كۇرس	Título de grado
تۆش بېزى	Timo
دۆڭچە مېڭىنىڭ ئاستى	Hipotálamo
ئېلېكتر سىغىمى	Capacidad eléctrica
يېشىل تاش	Malaquita
سولچى	Izquierda política
چاناق قەلئە ئۇرۇشى	Batalla de Galípoli
بىريۇزا(ياقۇت)	Turquesa
ئەخمەت نەدجەت سەزەر	Ahmet Necdet Sezer
ۋيېنا ئۇنىۋېرسىتېتى	Universidad de Viena
توشقانسىمان سۈلەيسۈن	Otocolobus manul
ئافيون قاراھىسار	Afyonkarahisar
ئوتتۇرا بارماق	Dedo medio
ئەبۇ مۇسا جابىر بىن ھەييام	Ŷabir ibn Hayyan
ئوشۇق	Tobillo
ئادىياما	Adıyaman
تاغ ئۆچكىسى	Capra ibex
پەنجاب	Punyab
شىيا سۇلالىسى	Dinastía Xia
جىنەن شەھىرى	Jinan
يول بەلگىسى	Señales de tráfico
چىڭداۋ شەھىرى	Qingdao
كالسېدونىيە	Calcedonia
ئاسىيا تېنچ ئوكيان ئىقتىسادىي ھەمكارلىق تەشكىلاتى	Foro de Cooperación Económica Asia-Pacífico
Glutséstér	Gloucester
قەشقەر شەھرى	Kasgar
ئىلام ۋىلايىتى	Provincia de Ilam
نەنچاڭ شەھىرى	Nanchang
بېشىكتاش گىمناستىكا كۇلۇبى	Beşiktaş Jimnastik Kulübü
تۈرك لىراسى	Lira turca
ئۆچكە	Capra
بورمودىلى	Modelo atómico de Bohr
ھەزىم يولى	Esófago
چاڭشا شەھىر	Changsha
ئۆكچە	Talón
كېكىردەك	Faringe
ئۇيغقاشتېشى	Jade
ۋىتامىن D	Vitamina D
2010 دۇنيا لوڭقىسى	Copa Mundial de Fútbol de 2010
نەسىرىدىن ئەپەندى	Nasreddin
سۇلايمانىيە جامىى	Mezquita de Süleymaniye
كاۋاپ	Kebab
Wéstminstér Shehiri	Ciudad de Westminster
نەننىڭ شەھىرى	Nanning
Durham	Durham
تۇرغۇت ئۆزال	Turgut Özal
ﮔﺎﮔﺎﯞﯗﺯ	Gagaúzos
بادام بەز	Amígdala (anatomía)
مۇھەممەد خاتەمى	Mohammad Jatamí
تورونتو ئۇنىۋېرستېتى	Universidad de Toronto
ساردونىكس	Ónix
تروچكىزم	Trotskismo
ياڭ جىننىڭ	Chen Ning Yang
Gawshyung	Kaohsiung
بىرىكمە ماتېرىيال	Material compuesto
مېڭە غولى	Tronco del encéfalo
تاموژنا	Aduana
كۈنمىڭ شەھىرى	Kunming
ۋىتامىنB	Vitaminas del grupo B
ئىسمەت ئىنۆنۈ	İsmet İnönü
مارگارېت ئاتۋود	Margaret Atwood
خۇيزۇ مىللىتى	Etnia hui
لەنجۇ شەھىرى	Lanzhou
Halva	Halva
لى جىڭداۋ	Tsung-Dao Lee
ماگىستىر	Maestría
كۆرسەتكۈچ بارماق	Dedo índice
ئوتتۇرا مېڭە	Mesencéfalo
ئۇپسالا ئۇنىۋېرستېتى	Universidad de Uppsala
Multan	Multan
خېفېي شەھىر	Heféi
ھىيلە	Muñeca (anatomía)
ئىپار مۈشۈك ئائىلىسى	Viverridae
ئارقار	Ovis ammon
كوپېنھاگېن ئۇنىۋېرستېتى	Universidad de Copenhague
قارساق	Vulpes corsac
لوياڭ شەھىرى	Luoyang
زئەكئى مئۈرئەن	Zeki Müren
كۇئېنلۇن تاغ تىزمىسى	Kunlun
تىبەت مىللىتى	Etnia tibetana
لوندون ئىمپېرىيە ئىنستېتۇت	Imperial College London
يىلىك	Bulbo raquídeo
گۇيلىن شەھىرى	Guilin
گېئوتىت	Goethita
Xeyko shehir	Haikou
مولتىمىتىر	Multímetro
چىپار بۇغا	Cervus nippon
بەل	Miembro (anatomía)
يۇگوسلاۋىيە پادىشاھلىقى	Reino de Yugoslavia
ئېۋېنكى مىللىتى	Etnia evenki
راھىبە	Monja
سېرىق ياۋا مۈشۈك	Catopuma temminckii
گۇيياڭ شەھىرى	Guiyang
نامسىز بارماق	Dedo anular
لىمبىك سىستېما	Sistema límbico
تۇرپان	Turfán
ئىلى دەرياسى	Río Ilí
مېڭە كۆۋرۈكى	Puente troncoencefálico
دەريا بۇغىسى	Hydropotes inermis
ﺑﺎﻟﻘﺎﺭ ﻣﯩﻠﻠﯩﺘﻰ	Balkarios
ﻧﻮﻏﺎﻱ ﻣﯩﻠﻠﯩﺘﻰ	Nogayos
گلاسگوۋ ئۇنىۋېرستېتى	Universidad de Glasgow
توخارلار	Tocarios
ئابادە	Abade
ئىستانبۇل ئۇنىۋېرسىتېتى	Universidad de Estambul
Tuwa	Pueblo tuvano
بۇرما مۈڭگۈزلۈك بۆكەن	Budorcas taxicolor
ئېلېكترون قەۋەت	Capa electrónica
مۇھەررىر	Edición (proceso)
مىكروسكوپ	Microscopio
كېمىنىڭ يان تىرەكلىرى	Costilla
جاڭ خىڭ	Zhang Heng
جاڭ چيەن	Zhang Qian
Juko shehiri	Zhoukou
جۇگىلىياڭ	Zhuge Liang
زىبو شەھىرى	Zibo
ۋىتامىن C	Vitamina C
سۇلتان ئالىپ ئارىسلان	Alp Arslan
مەن، ماشىنا ئادەم (كىنو)	Yo, robot (película)
جۇڭخۇا خەلق جۇمھۇرىيىتىنىڭ ئاساسىي قانۇنى	Constitución de la República Popular China
قاشتېشى	Jaspe
تگرین اعظم	Tigranes II el Grande
كۆكمۇچ	Capsicum
چۆل مۈشۈكى	Felis silvestris bieti
جۇڭگو شىنخۇا ئاگېنتلىقى	Xinhua
Lankastér	Lancaster (Lancashire)
لىجياڭ شەھىرى	Lijiang
چىچىخار شەھىرى	Qiqihar
ئۇزۇن قۇيرۇق بۇغا	Elaphurus davidianus
سېرىق تەنلىكلەر	Mongoloide
Keyféng shehiri	Kaifeng
پارىژ ئۇنىۋېرسىتىتى	Universidad de París
مياۋزۇ مىللىتى	Miao
بېيخەي شەھىرى	Beihai
يەنتەي شەھىرى	Yantai
ﻗﯘﻣﯩﻖ	Cumuco
يىنچۈئەن شەھىرى	Yinchuan
سەئىد قۇتوب	Sayyid Qutb
ئېيقسىمان ئىپار مۈشۈك	Arctictis binturong
ئامستېردام ئۇنىۋېرستېتى	Universidad de Ámsterdam
ماتېرىيال	Material
دۇڭزۇ مىللىتى	Dong (etnia)
تارىم ئويمانلىقى	Cuenca del Tarim
بۈيۈك ئويۇن	El Gran Juego
لازۇرىت	Lapislázuli
قاراماي يۇقىر سۇرئەتلىك يولى	Carretera del Karakórum
داغۇر مىللىتى	Daur
ساكاريا دەرياسى	Río Sakarya
ﺭﺍﺩﯨﺸﺸﯧﯟ	Aleksandr Radíshchev
ئوۋتېز	Joyce Carol Oates
مۇدەنجياڭ شەھىرى	Mudanjiang
ناشى مىللىتى	Naxi
ۋاشىنگتون ئۇنىۋېرستېتى	Universidad de Washington
زونگۇلداق ۋىلايىتى	Provincia de Zonguldak
سېرىق بوغۇز بولغۇن	Martes flavigula
شىزاڭ ياۋا ئېشىكى	Equus hemionus kiang
بىرمىنگام ئۇنىۋېرستېتى	Universidad de Birmingham
چىمەلتەك	Meñique de la mano
بىلەك	Antebrazo
ماتېرىيال ئىلمى	Ciencia de materiales
ھەنبەلىي مەزھىبى	Hanafí
سەي لۇن	Cai Lun
قوڭۇر بۇغا	Rusa unicolor
مىچىگان ئۇنىۋېرستېتى	Universidad de Míchigan
ﺋﺎﻗﺴﺎﻱ ﭼﯩﻦ	Aksai Chin
مانچېستېر ئۇنىۋېرستېتى	Universidad de Mánchester
تارپان	Equus ferus ferus
امينة ساندال	Emina Jahović
ئاق تەنلىكلەر	Blanco (persona)
تارىم دەرياسى	Río Tarim
مىننېسوتا ئۇنىۋېرستېتى	Universidad de Minnesota
ئورخان پامۇك	Orhan Pamuk
ئەرتۇغرۇل غازى	Ertuğrul
ﻗﺎﺭﺍ ﭼﺎﻱ ﻣﯩﻠﻠﯩﺘﻰ	Karacháis
نەجمەتتىن ئەرباقان	Necmettin Erbakan
ﺋﺎﻟﺘﺎﻱ مىللىتى	Altáis
Teyjong shehiri	Taichung
ﻛﺎﺷﻜﺎﻱ	Kashgai
مىللەتچى ھەركەت پارتىيىسى	Partido de Acción Nacionalista
ھەيبەلى ئارىلى	Heybeliada
ﭼﯘﯞﺍﺵ ﻣﯩﻠﻠﯩﺘﻰ	Pueblo chuvasio
گيېموسخۇس بۇغىسى	Hyemoschus aquaticus
ئىسپارتا ۋىلايىتى	Provincia de Isparta
قوڭۇر يىلپىز	Neofelis
چىقچىق	Porzana parva
سېرىق ئاغمىخان	Mustela sibirica
شىزاڭ بۆكىن	Pantholops hodgsonii
چانقىرى ۋىلايىتى	Provincia de Çankırı
چورۇم ۋىلايىتى	Provincia de Çorum
ئىران ئەزەربەيجان	Azerbaiyán iraní
تۈركىيە بۈيۈك مىللەت مەجلىسى	Asamblea Nacional de Turquía
بەيزۇ مىللىتى	Bai
ئوسمانىيە ۋىلايىتى	Provincia de Osmaniye
تۇرپان ئويمانلىغى	Depresión de Turfán
1.خاتىرەمدىكى ئامېرىكا	ABC News
Putbol	Fútbol (homonimia)
رابىيە قادىر	Rebiya Kadeer
سەزەن ئاقسۇ	Sezen Aksu
جاندان ارچتین	Candan Erçetin
ۋەن مارۋىجىك	Bert van Marwijk
Hidayet Türkoghli	Hidayet Türkoğlu
داچىڭ شەھىر	Daqing
لىزۇ مىللىتى	Li (etnia)
سۇلتان مەلىك شاھ	Malik Shah I
مەھمەت ئەلىي تالات	Mehmet Ali Talat
مېلبۇرن ئۇنىۋېرستېتى	Universidad de Melbourne
Dünxuang Shehiri	Dunhuang
لوپنۇر	Lop Nor
Senya shehiri	Sanya
Dostum	Abdul Rashid Dostum
ئەكمەلىتتىن ئىھسان ئوغلۇ	Ekmeleddin İhsanoğlu
مۇستاپا ساندال	Mustafa Sandal
تاغ بورسۇقى	Melogale moschata
سالار مىللىتى	Salar (etnia)
كيوتو ئۇنىۋېرستېتى	Universidad de Kioto
بادام؛بادام؛بادام	Cuerpo amigdalino
ئىستانبۇل تېخنىكا ئۇنىۋېرسىتېتى	Universidad Politécnica de Estambul
ئىزمىر ۋىلايىتى	Provincia de Esmirna
ئاد قەۋمى	A'ad
بۇغدىيەك	Nuez de Adán
بېڭبۇ شەھەرى	Bengbu
خۇەينەن شەھىرى	Huainan
مائەنشەن شەھىرى	Maanshan
ئەنچىڭ شەھىرى	Anqing
ياۋزۇ مىللىتى	Yao
كرىستىن دەلفى	Christine Delphy
ئەرزۇرۇم ۋىلايىتى	Provincia de Erzurum
روبوتلار ۋە ئىمپىرىيە	Robots e Imperio
يۇنۇس ئەمرە	Yunus Emre
پرژىۋالسكى بۆكىنى	Procapra przewalskii
ئەپراسىياپ	Afrasiab
شانلى ئۇرفا ۋىلايىتى	Provincia de Sanliurfa
شهرزاد	Scheherezade (compositor)
ترابزون ۋىلايىتى	Provincia de Trebisonda
برىتانى كولۇمبىيە ئۇنىۋېرستېتى	Universidad de Columbia Británica
Metta bayan qilghan xush xewer	Evangelio de Mateo
ئەلبورز ۋىلايىتى	Provincia de Elburz
كاناي	Tráquea (desambiguación)
خوجا ئەھمەد يەسەۋى	Ahmad Yasavi
Tekshi choqqiliq tagh shehiri	Pingdingshan
شىنشياڭ شەھىرى	Xinxiang
Nenyang shehiri	Nanyang
Shinyang shehiri	Xinyang
ئەفەسلىكلەرگە يېزىلغان خەت	Epístola a los Efesios
زەمچە	Alumbre de potasio
ﺋﯩﻜﻜﯩﻨﭽﻰ ﻗﯩﺘﯩﻤﻠﯩﻖ ﯬﭘﻴﯘﻥ ﯰﺭﯗﺷﻰ	Segunda Guerra del Opio
ئاقسۇ ۋىلايىتى	Prefectura de Aksu
ئاقسۇ شەھىرى	Ciudad de Aksu
تېتراپىررول	Tetrapirrol
ميەنياڭ شەھىرى	Mianyang
ھلا رەڭ	Rosa (color)
نەۋشەھەر ۋىلايىتى	Provincia de Nevşehir
نازارې	Nazaret
سۇماترا بۆكىنى	Capricornis sumatraensis
دۈزجە ۋىلايىتى	Provincia de Düzce
سۈبھىدىكى روبوتلار	Los robots del amanecer
قۇندۇز ئۇرۇقدىشى	Lutra
بەشىكتاش	Beşiktaş
برىستول ئۇنىۋېرستېتى	Universidad de Brístol
ئاق بوغۇز بۆكەن	Gazella subgutturosa
يىزۇ مىللىتى	Yi
روزا ھېيت	Eid al-Fitr
كۆكمەت	Pseudois nayaur
يالىڭاچ قۇياش	El sol desnudo
نوتتىڭخام ئۇنىۋېرستېتى	Universidad de Nottingham
نەمەنگان ۋىلايىتى	Provincia de Namangán
ھانى مىللىتى	Hani
پولات قەلئەلەر	Las bóvedas de acero
گىرەسۇن ۋىلايىتى	Provincia de Giresun
گۈمۈشخانە ۋىلايىتى	Provincia de Gümüşhane
سىئىرت ۋىلايىتى	Provincia de Siirt
قاھرامان ماراش ۋىلايىتى	Provincia de Kahramanmaraş
قارامان ۋىلايىتى	Provincia de Karaman
سامسۇن ۋىلايىتى	Provincia de Samsun
ئۆزبېك مىللىتى	Uzbeko (etnia)
ئەسكىشەھەر ۋىلايىتى	Provincia de Eskişehir
بايبۇرت ۋىلايىتى	Provincia de Bayburt
ئۇشاق ۋىلايىتى	Provincia de Uşak
يالوۋا ۋىلايىتى	Provincia de Yalova
ئەلازىغ ۋىلايىتى	Provincia de Elazığ
سىۋاس ۋىلايىتى	Provincia de Sivas
غازى ئانتەپ ۋىلايىتى	Provincia de Gaziantep
قارابۈك ۋىلايىتى	Provincia de Karabük
ئەرزىنجان ۋىلايىتى	Provincia de Erzincan
ئوردۇ ۋىلايىتى	Provincia de Ordu
كاستامونۇ ۋىلايىتى	Provincia de Kastamonu
توقات ۋىلايىتى	Provincia de Tokat
نورۇز بايرىمى	Nouruz
كايسەرى ۋىلايىتى	Provincia de Kayseri
رىزە ۋىلايىتى	Provincia de Rize
تاجىك مىللىتى	Tayikos
مۇھەممەد ئىقبال	Muhammad Iqbal
پارسلار	Pueblo persa
قاراقالپاقىستان	Karakalpakia
قىرىققالە ۋىلايىتى	Provincia de Kırıkkale
قىرغىز مىللىتى	Kirguís (etnia)
شاڭخەي ھەمكارلىق تەشكىلاتى	Organización de Cooperación de Shanghái
تۈركىيە دەرىجىدىن تاشقىرى ئايلانمىسى	Superliga de Turquía
تاركان	Tarkan
ﻳﺎﻗﯘﺕ ﻣﯩﻠﻠﯩﺘﻰ	Yakutos
فەرغانە ئويمانلىقى	Valle de Ferganá
فەرغانە	Ferganá
Kanzas Shehiri, Kanzas	Kansas City (Kansas)
پەرغانە ۋىلايىتى	Provincia de Ferganá
بۇخارا ۋىلايىتى	Provincia de Bujará
ئەنجان ۋىلايىتى	Provincia de Andillán
سەمەرقەنت ۋىلايىتى	Provincia de Samarcanda
سۇرخاندەريا ۋىلايىتى	Provincia de Surjandarín
چاغاتاي خان	Chagatai
سىردەريا ۋىلايىتى	Provincia de Sirdarín
سىدنېي ئۇنىۋېرستېتى	Universidad de Sídney
خارەزىم ۋىلايىتى	Provincia de Corasmia
نەۋايى ۋىلايىتى	Provincia de Navoi
قاشقادەريا ۋىلايىتى	Provincia de Kashkadar
تاشكەنت ۋىلايىتى	Provincia de Taskent
جىزاق ۋىلايىتى	Provincia de Djizaks
ئاۋكلاند ئۇنىۋېرستېتى	Universidad de Auckland
قاراخانىيلار خانلىقى	Qarajanida
چىپار بۆكەن	Naemorhedus goral
ئوغۇزلار	Oğuz
كۆمۈرچەك	Tejido cartilaginoso
جەنۋە ئۇنىۋېرستېتى	Universidad de Ginebra
قىزىل تاغ	Montañas Flameantes
تارىم توشقىنى	Lepus yarkandensis
قۇربان ھېيت	Eid al-Adha
تىمساھ	Alligator
ئىستانبۇل ۋىلايىتى	Provincia de Estambul
Kökxot shehiri	Hohhot
بەزگە مۇناسىۋەتلىك	Amígdala faríngea
يەكەن دەرياسى	Río Yarkand
باۋتۇ شەھىر	Baotou
ھېنرىخ ھېينى مۇكاپاتى	Premio Heinrich Heine
كىنالى ئارىلى	Kınalıada
رومبىسىمان كرىستال كاتەكچىسى	Sistema cristalino trigonal
تۇجيا مىللىتى	Tujia
تېھران ۋىلايىتى	Provincia de Teherán
موناش ئۇنىۋېرستېتى	Universidad de Monash
كىچىك مونتياك	Muntiacus crinifrons
ئۇلترا ئۆتكۈزگۈچ	Clasificación de los superconductores
رېگان ئىقتىسادشۇناسلىقى	Reaganomía
دۇلۇڭ مىللىتى	Derung
تۇنجەلى ۋىلايىتى	Provincia de Tunceli
ئارال شەھرى	Aral (Sinkiang)
خوتەن دەرياسى	Río Hotan
چىپار يۈز قوڭغارچا	Paguma larvata
مۇز تاغ ئاتا	Muztagh Ata
ئالبېرتا ئۇنىۋېرستېتى	Universidad de Alberta
قوي گۆشى	Carne de cordero
تارباغاتاي ۋىلايىتى	Tacheng
قوڭۇر تاغ	Kongur
خەينە بۇغىسى	Rucervus eldii
شىرناق ۋىلايىتى	Provincia de Şırnak
قالقانسىمان يان بەز	Glándula paratiroides
قۇمۇل شەھىرى	Ciudad de Kumul
ئوساكا ئۇنىۋېرستېتى	Universidad de Osaka
ﺗﻮﻓﺎ ﻣﯩﻠﻠﯩﺘﻰ	Tofalar
قاراماي شەھىرى	Karamay
بۇيى مىللىت	Buyei
سۈلەيسۈن	Lynx (animal)
سەدەف ئارىلى	Sedef
نان	Naan
سېرىق مۇنتجاك بۇغىسى	Muntiacus reevesi
دۇنيا ئۇيغۇر قۇرۇلتىيى	Congreso Mundial Uigur
بۆرەك ئۈستى بېزى	Glándula suprarrenal
لىمفا ئىشلەپچىقىرىدىغان	Sistema linfático
يانپاش	Pelvis
ISO 639-1	ISO 639-1
تەيۋەن بۆكىنى	Capricornis swinhoei
ISO 639-2	ISO 639-2
يۇڭ تاجلىق بۇغا	Elaphodus cephalophus
ھىمالايا چۇپۇرلۇق قويى	Hemitragus jemlahicus
ئاق تۇمشۇق بۇغا	Przewalskium albirostris
ئۇرال - ئالتاي تىللىرى سېستىمىسى	Lenguas uralo-altaicas
تيېرى مېيىسسان	Thierry Meyssan
شېزۇ مىللىتى	She
قەشقەر ۋىلايىتى	Prefectura de Kasgar
نەي	Ney (instrumento musical)
تىن تىننىڭ سەرگۈزەشتىلىرى	Las aventuras de Tintín
دۇڭشياڭ مىللىتى	Dongxiang
لاخۇ مىللىتى	Lahu
بازا	Fundación (novela)
قارىقۇيرۇق	Procapra gutturosa
چوڭ ئىپار مۈشۈك	Viverra zibetha
ئۈرۈمچى دىۋوپۇ خەلقئارا ئايروپورتى	Aeropuerto Internacional de Urumchi-Diwopu
ئالتاي ۋىلايىتى	Altay
ۋۇجياچۈ شەھىرى	Wujiaqu
ئايدىڭكۆل	Lago Aiding
بابۇر	Babur
جەرەنبۇلاق رايونى	Baijiantan
بايىنغولىن موڭغۇل ئاپتونوم ئوبلاستى	Prefectura autónoma mongol de Bayingolin
بونان مىللىتى	Bonan
قارا تەنلىكلەر	Negro (persona)
ئورخۇن ئۇيغۇر خانلىقى	Kanato uigur
بورىس ۋاسىلىيىۋ	Borís Vasíliev
كورلا شەھىرى	Korla
بازا ۋە ئىمپىرىيە	Fundación e Imperio
دەيزۇ مىللىتى	Dai
مېنبا مىللىتى	Monba
شەرقىي تۈركىستان	Turquestán Oriental
چياڭزۇ مىللىتى	Qiang
ۋازۇ مىللىتى	Va
5-ئىيۇل ۋەقەسى	Disturbios en Urumchi de julio de 2009
تاجىسىمان يۇرەك قان تومۇر كېسىلى	Cardiopatía isquémica
ISO 639-3	ISO 639-3
ئىلى قازاق ئاپتونوم ۋىلايىتى	Prefectura autónoma kazaja de Ilí
شىخەنزە شەھىرى	Shihezi
دوكتور ئاسپرانتى	Doctorado
ئاچاڭ مىللىتى	Achang
تۇزۇ مىللىتى	Tu (etnia)
ئېگىز تاغ بۆكىنى	Procapra picticaudata
ئىككىنچى بازا	Segunda Fundación
لوبا مىللىتى	Lhoba
لىسۇ مىللىتى	Lisu
QQ	QQ
تېڭشۈن شىركىتى	Tencent Holdings
قىزىلسۇ قىرغىز ئاپتونوم ئوبلاستى	Prefectura autónoma kirguís de Kizilsu
كۋېنسلاند ئۇنىۋېرستېتى	Universidad de Queensland
غۇلجا شەھىرى	Gulja
نۇزۇ مىللىتى	Nu (etnia)
مۇلاۋ مىللىتى	Mulao
بورتالا موڭغۇل ئاپتونوم ئوبلاستى	Prefectura autónoma mongol de Bortala
پۇمى مىللىتى	Pumi
قئارئاهوجئا	Ruinas de Gaochang
布朗族	Blang
تاشقۇرقان تاجىك ئاپتونوم ناھىيىسى	Condado autónomo de Tashkurgán
روبوت چاتما رومانى	Serie de los robots
قىزىل بۆكەن	Naemorhedus baileyi
ياردەم:ياردەم	Ayuda:Contenidos
خوتەن ناھىيىسى	Condado de Jotán
بازىنىڭ چېتى	Los límites de la Fundación
تاشقۇرغان	Tashkurgán
چوڭ تەخسە توخۇ قورۇمىسى	Dapanji
شەرقى تۈركىستان جۇمھۇرىيىتى	Primera República del Turkestán Oriental
تۇمشۇق شەھىرى	Tumshuke
بۈيۈك ئارال	Büyükada
خوتەن ۋىلايىتى	Prefectura de Jotán
قۇمۇل ۋىلايىتى	Kumul
سانجى خۇيزۇ ئاپتونوم ئوبلاستى	Prefectura autónoma hui de Changji
كۈيتۇن شەھىرى	Kuytun
سانجى شەھىرى	Changji
فارس ۋىلايىتى	Fars
بۇرگاز ئارىلى	Burgazada
تۇدۇڭخابا رايونى	Toutunhe
ئاشقازان	Estómago
ئېلىك	Capreolus
شىبە مىللىتى	Xibe
كىنو مىللىتى	Jino
ئورۇنچون مىللىتى	Oroqen
ئەنقەرە ئۇنىۋېرسىتېتى	Universidad de Ankara
پېشاۋار	Peshawar
دۇتار	Dutar
كونا تاڭنامە	Libro de Tang
تۇخۇم نەيچىسى	Trompa uterina
ئېسفەھان ۋىلايىتى	Provincia de Isfahán
تۈر:تۈركىيە	Categoría:Turquía
تۈر:ئۆسۈملۈك	Categoría:Plantae
تۈر:فىزىكا	Categoría:Física
تۈر:تەبىئىي پەن	Categoría:Ciencias naturales
تۈر:Geografia	Categoría:Geografía
قەشقەر دەرياسى	Río Kasgar
لەغمەن	Lamian
دوگانا	Dogana
ماخۇاتېڭ	Ma Huateng
سالانق تەشمەسى	Túnel de Salang
سىۋرى ئارىلى	Sivriada
ياسسى ئارىلى	Yassıada
تۈر:خرىستىئان دىنى	Categoría:Cristianismo
بارلاس قەبىلىسى	Barlas
ئەنقەرە ۋىلايىتى	Provincia de Ankara
قاراقاش دەرياسى	Río Karakash
يورۇڭقاش دەرياسى	Río Yurungkash
چەرچەن دەرياسى	Río Qiemo
قاراباغ	Karabaj
ئىراق ۋە شام ئىسلام دۆلىتى	Estado Islámico (organización terrorista)
ماجيەن	Muhammad Ma Jian
پوزىترونىك مىڭە	Cerebro positrónico
پۇشتۇ مىللىتى	Pastún
مۇقام	Muqam
گېئورگى بۇچنېر ئەدەبىيات مۇكاپاتى	Premio Georg Büchner
ئابدۇرېھىم ئۆتكۈر	Abdurehim Ötkür
كېسەل	Pantorrilla
ﺩﯨﻠﺒﻪﺭ ﻳﯘﻧﯘﺱ	Dilber
بىنەپشە رەڭ	Púrpura
سەيپىدىن ئەزىزى	Saifuddin Azizi
ئەركىن ئابدۇللا	Erkin Abdulla
Ördek	Pato
قېلىپ:Tl	Plantilla:Ep
قېلىپ:Userbox	Usuario:Userbox/Userbox
Wikipedia:Administrators	Wikipedia:Bibliotecarios
تۈر:جۇڭخۇا مىللەتلىرى	Categoría:Etnias de China
مىسىر	Egipto
قېلىپ:Bot	Plantilla:Bot
كانادا	Canadá
Wikipedia:ھەققىدە	Wikipedia:Acerca de
قېلىپ:Flagicon	Plantilla:Bandera
قېلىپ:Documentation	Plantilla:Documentación
Sung Jae-gi	Sung Jae-ki
مۇزات دەرياسى	Río Muzat
قېلىپ:Softredirect	Plantilla:Redirección suave
قېلىپ:Delete	Plantilla:Destruir
تۈر:تىل	Categoría:Lenguas
Wikipedia:General disclaimer	Wikipedia:Limitación general de responsabilidad
قېلىپ:Navbox	Plantilla:Navegación
خالتىلىق چاشقان	Canguro
قېلىپ:!	Plantilla:!
قېلىپ:Tnavbar	Plantilla:Navbar
قېلىپ:Babel	Plantilla:Babel
قېلىپ:Commons	Plantilla:Commons
قېلىپ:Reflist	Plantilla:Listaref
قېلىپ:Stub	Plantilla:Esbozo
قېلىپ:Location map/Info	Plantilla:Mapa de localización/Info
تۈر:كىشلىك ئالاقە	Categoría:Comunicación humana
تۈر:User fr-1	Categoría:Wikipedia:Wikipedistas con nivel básico de francés
قېلىپ:Country showdata	Plantilla:Mostrar geodatos
قېلىپ:Country data NEP	Plantilla:Geodatos Nepal
تۈر:User en-4	Categoría:Wikipedia:Wikipedistas con nivel experto de inglés
تۈر:User en	Categoría:Wikipedia:Wikipedistas con conocimientos de inglés
تۈر:User zh	Categoría:Wikipedia:Wikipedistas con conocimientos de chino
تۈر:User zh-N	Categoría:Wikipedia:Wikipedistas con nivel nativo de chino
تۈر:User en-2	Categoría:Wikipedia:Wikipedistas con nivel intermedio de inglés
قېلىپ:Infobox	Plantilla:Ficha
قېلىپ:Legend	Plantilla:Leyenda
قېلىپ:Country data	Plantilla:Geodatos
تۈر:دۆلەت	Categoría:Estado
قېلىپ:IPA	Plantilla:AFI
قېلىپ:Unreferenced	Categoría:Wikipedia:Artículos que necesitan referencias
تۈر:User ja-N	Categoría:Wikipedia:Wikipedistas con nivel nativo de japonés
تۈر:سانائەت	Categoría:Industrias
قېلىپ:Infobox person	Plantilla:Ficha de persona
تۈر:User az	Categoría:Wikipedia:Wikipedistas con conocimientos de azerí
تۈر:User sk	Categoría:Wikipedia:Wikipedistas con conocimientos de eslovaco
تۈر:User fr	Categoría:Wikipedia:Wikipedistas con conocimientos de francés
تۈر:User ja	Categoría:Wikipedia:Wikipedistas con conocimientos de japonés
تۈر:User mn	Categoría:Wikipedia:Wikipedistas con conocimientos de mongol
تۈر:User az-3	Categoría:Wikipedia:Wikipedistas con nivel avanzado de azerí
تۈر:User fr-3	Categoría:Wikipedia:Wikipedistas con nivel avanzado de francés
تۈر:User ja-3	Categoría:Wikipedia:Wikipedistas con nivel avanzado de japonés
تۈر:User tr-3	Categoría:Wikipedia:Wikipedistas con nivel avanzado de turco
تۈر:User tr-1	Categoría:Wikipedia:Wikipedistas con nivel básico de turco
تۈر:User fr-4	Categoría:Wikipedia:Wikipedistas con nivel experto de francés
تۈر:User fr-2	Categoría:Wikipedia:Wikipedistas con nivel intermedio de francés
تۈر:User ja-2	Categoría:Wikipedia:Wikipedistas con nivel intermedio de japonés
تۈر:User kk-2	Categoría:Wikipedia:Wikipedistas con nivel intermedio de kazajo
تۈر:User tr-2	Categoría:Wikipedia:Wikipedistas con nivel intermedio de turco
تۈر:User ko-N	Categoría:Wikipedia:Wikipedistas con nivel nativo de coreano
تۈر:User fr-N	Categoría:Wikipedia:Wikipedistas con nivel nativo de francés
تۈر:User ru-N	Categoría:Wikipedia:Wikipedistas con nivel nativo de ruso
تۈر:User fr-5	Categoría:Wikipedia:Wikipedistas con nivel profesional de francés
تۈر:User sk-N	Categoría:Wikipedia:Wikipedistas con nivel nativo de eslovaco
تۈر:User de	Categoría:Wikipedia:Wikipedistas con conocimientos de alemán
تۈر:User de-2	Categoría:Wikipedia:Wikipedistas con nivel intermedio de alemán
تۈر:User de-3	Categoría:Wikipedia:Wikipedistas con nivel avanzado de alemán
تۈر:User de-4	Categoría:Wikipedia:Wikipedistas con nivel experto de alemán
تۈر:User de-N	Categoría:Wikipedia:Wikipedistas con nivel nativo de alemán
شىراز	Shiraz
تۈر:User en-3	Categoría:Wikipedia:Wikipedistas con nivel avanzado de inglés
تۈر:User en-N	Categoría:Wikipedia:Wikipedistas con nivel nativo de inglés
تۈر:User es	Categoría:Wikipedia:Wikipedistas con conocimientos de español
تۈر:User es-1	Categoría:Wikipedia:Wikipedistas con nivel básico de español
تۈر:User es-N	Categoría:Wikipedia:Wikipedistas con nivel nativo de español
تۈر:User ja-1	Categoría:Wikipedia:Wikipedistas con nivel básico de japonés
تۈر:User kk	Categoría:Wikipedia:Wikipedistas con conocimientos de kazajo
تۈر:User kk-4	Categoría:Wikipedia:Wikipedistas con nivel experto de kazajo
تۈر:User ko	Categoría:Wikipedia:Wikipedistas con conocimientos de coreano
تۈر:User ru-1	Categoría:Wikipedia:Wikipedistas con nivel básico de ruso
قېلىپ:Table Greekletters	Plantilla:Letras griegas
باشقۇرغۇچى مەشغۇلات قوللانمىسى	Ayuda:Guía para bibliotecarios
تۈر:User ru	Categoría:Wikipedia:Wikipedistas con conocimientos de ruso
تۈر:User tr	Categoría:Wikipedia:Wikipedistas con conocimientos de turco
تۈر:User tr-4	Categoría:Wikipedia:Wikipedistas con nivel experto de turco
تۈر:User tr-N	Categoría:Wikipedia:Wikipedistas con nivel nativo de turco
تۈر:User uz	Categoría:Wikipedia:Wikipedistas con conocimientos de uzbeko
ۋىكىپېدىيە:ھۆججەت ئىشلىتىش پىرىنسىپى	Wikipedia:Política de uso de imágenes
قېلىپ:Infobox City Japan	Plantilla:Ficha de localidad de Japón
تۈر:ۋىتامىنلار	Categoría:Vitaminas
تۈر:User zh-1	Categoría:Wikipedia:Wikipedistas con nivel básico de chino
تۈر:خىمىيىۋى ئېلېمېنت	Categoría:Elementos químicos
تۈر:لېكسىكولوگىيە	Categoría:Lexicología
تۈر:ئۆزبېكىستان	Categoría:Uzbekistán
تۈر:ئاتوم يادرو فىزىكىسى	Categoría:Física nuclear
ئەينەك تالا	Plástico reforzado con vidrio
سەۋزە	Daucus carota
تۈر:جۇڭخۇا خەلق جۇمھۇرىيىتى	Categoría:República Popular China
تۈر:ئېتمولوگىيە	Categoría:Etimología
قېلىپ:Flag	Plantilla:Bandera2
تۈر:بىيولوگ	Categoría:Biólogos
تراگۇلۇس بۇغىسى	Tragulidae
تۈر:خاس ئات ئىلمى	Categoría:Onomástica
تۈر:Uyghur tili	Categoría:Idioma uigur
تۈر:User en-1	Categoría:Wikipedia:Wikipedistas con nivel básico de inglés
تۈر:User de-1	Categoría:Wikipedia:Wikipedistas con nivel básico de alemán
تاش	Roche
خوتەن شەھىرى	Ciudad de Jotán
ئالاھىدە:RecentChanges	Especial:CambiosRecientes
تۈر:User ja-4	Categoría:Wikipedia:Wikipedistas con nivel experto de japonés
غاز	Ganso
