IYunayithedi Steyitsi	Estados Unidos
Abantu	Homo sapiens
Switserii	Suiza
Ubhiya	Cerveza
Europe	Europa
I-Wikipedia	Wikipedia
ENetherlands	Países Bajos
Ikhompyutha	Computadora
EGeneva	Ginebra
Eyomqungu	Enero
Eyomdumba	Febrero
Eyokwindla	Marzo
Tshazimpuzi	Abril
Canzibe	Mayo
Eyesilimela	Junio
Eyekhala	Julio
Eyethupha	Agosto
Eyomsintsi	Septiembre
Eyedwarha	Octubre
Eyenkanga	Noviembre
Eyomnga	Diciembre
Ingonyama	Panthera leo
Inja	Canis lupus familiaris
Ikati	Felis silvestris catus
Intlanzi	Pisces
Brasil	Brasil
IRashiya	Rusia
IJamani	Alemania
IsiJamani	Idioma alemán
UThixo	Dios
Inqwelo-ntaka	Avión
Imfazwe	Guerra
Inye	Uno
Zimbini	Dos
Zintathu	Tres
Zine	Cuatro
Zintlanu	Cinco
Iqanda	Cero
Wolfgang Amadeus Mozart	Wolfgang Amadeus Mozart
UMzantsi Afrika	Sudáfrica
Iveyn	Vino
Amanzi	Agua
IChile	Chile
UYesu Kristu	Jesús de Nazaret
Imbali	Historia
Ulwimi	Lenguaje
IAstronomi	Astronomía
ISyensya	Ciencia
Ezemidlalo	Deporte
I-Mathematics	Matemáticas
IFiziki	Física
IBayoloji	Biología
Uxolo	Paz
UKat	Sol
Isibhakabhaka	Cielo
Incwadi	Libro
Umculo	Música
William Shakespeare	William Shakespeare
UStevie Wonder	Stevie Wonder
Itshesi	Ajedrez
IsiColombia	Colombia
I-Fungi	Fungi
Unomathotholo	Radiocomunicación
Igolide	Oro
I-South Pole	Polo Sur
Mauritania	Mauritania
INigeria	Nigeria
Julius Caesar	Julio César
Hamburg	Hamburgo
IJioloji	Geología
IJerusalem	Jerusalén
E-Chicago	Chicago
UBusika	Invierno
EKwindla	Otoño
Isiqhamo	Fruto
Imali	Dinero
Uetersen	Uetersen
Augustus	César Augusto
IHanoveri (eJamani)	Hannover
Frankfurt	Fráncfort del Meno
IBhayibhile	Biblia
Lenkonzo enyanisekileyo ka Krestu	Verdadera Iglesia de Jesús
IsiNgesi	Idioma inglés
Concepción	Concepción (Chile)
Końskowola	Końskowola
Inyoka	Serpentes
IKhemistri	Química
1 Eyokwindla	1 de marzo
18 Eyekhala	18 de julio
Ibhola ekhatywayo	Fútbol
UMichael Jackson	Michael Jackson
Ibhokhwe	Capra aegagrus hircus
Ukukhululeka	Libertad
I-Nile	Nilo
Category:Templates	Categoría:Wikipedia:Plantillas
E-Pitoli	Pretoria
Umlambo	Río
Osasco	Osasco
Curitiba	Curitiba
Confucius	Confucio
Category:Izibalo	Categoría:Matemáticas
Yentaka	Aves
Mustafa Kemal Atatürk	Mustafa Kemal Atatürk
Iphepha Elingundoqo	Wikipedia:Portada
Iqakamba	Críquet
Ibhola yombhoxo	Rugby
IKapa	Ciudad del Cabo
EThekwini	Durban
Ifilosofi	Filosofía
Category:Candidates for speedy deletion	Categoría:Wikipedia:Borrar (definitivo)
I-Democracy	Democracia
IsiHolani	Idioma neerlandés
Vladimir Putin	Vladímir Putin
Igazi	Sangre
Imvula	Lluvia
Nelson Mandela	Nelson Mandela
I-logic	Lógica
Alexander Makedon	Alejandro Magno
Ikofu	Café
Intaba	Montaña
UbuKumkani bamaBritane	Imperio británico
Genesis	Génesis
Eksodus	Éxodo
Iilwandle	Océano
IChelsea	Chelsea Football Club
Umlomo	Boca
Ronald Reagan	Ronald Reagan
IsiZulu	Idioma zulú
Ihagu	Sus
Umthi	Árbol
Inyama	Carne
Imifuno	Verdura
Amazwi alula omculo wefowuni	Teléfono
Ityiwa	Sal
I-Karate	Karate
Iphepha	Papel
Google Maps	Google Maps
Isifo sephepha	Tuberculosis
Umlinganiselo	Medición
IsiXhosa	Idioma xhosa
IsiBhulu	Afrikáans
Itafile	Mesa
Template:Link FA	Plantilla:Destacado
Ithoba	Nueve
FIFuRoni da Futboll	Copa Mundial de Fútbol
Rafael Correa	Rafael Correa
ISosioloji	Sociología
Sixhenxe	Siete
Sibhozo	Ocho
Die Antwoord	Die Antwoord
Itswele	Allium cepa
Zintandathu	Seis
Paltoga	Paltoga
Entrena	Entrena
Ishumi	Diez
Iqwarhashe	Cebra
IsiPedi	Sesotho sa leboa
Valparaíso	Valparaíso
IsiSotho	Sesotho
UWhitney Houston	Whitney Houston
Imithetho elishumi	Diez Mandamientos
EGoli	Johannesburgo
USathane	Satanás
Ipolisa	Policía
Umhlaba	Suelo
Ibuzi	Rattus
Ishumi elinambini	Doce
Ishumi elinanye	Once
Ishumi elinantathu	Trece
EBloemfontein	Bloemfontein
Ishumi elinane	Catorce
Ishumi elinantlanu	Quince
Ishumi elinesibhozo	Dieciocho
Ishumi elinesithoba	Diecinueve
Ishumi elinesixhenxe	Diecisiete
Ishumi elinesithandathu	Dieciséis
Amashumi amabini	Veinte
Nonkala	Brachyura
Al Pacino	Al Pacino
Desmond Tutu	Desmond Tutu
IMayini	Minería
Iziphaluka zaseBritane eziphesheya kolwandle	Territorio británico de ultramar
Template:Commons Categories	Plantilla:Commonscat
Isifo sentsholongwane i-Ebola	Enfermedad por el virus del Ébola
Ixoxo	Anura
UJacob Zuma	Jacob Zuma
2014 FIFuRoni da Futboll	Copa Mundial de Fútbol de 2014
IPhondo yaKwaZulu-Natala	KwaZulu-Natal
Ulwaluko	Circuncisión
Ibandla LamaBapist	Iglesias bautistas
IBhayi	Puerto Elizabeth
IPhondo yaNtshona-Koloni	Provincia Occidental del Cabo
Umlenga	Anguilliformes
IPhondo laseMpuma-Koloni	Provincia Oriental del Cabo
IPhondo yaMpumalanga	Mpumalanga
IPhondo yaseMntla-Koloni	Provincia Septentrional del Cabo
IPhondo yaRhawuti	Gauteng
IPhondo yaLimpopo	Provincia de Limpopo
Zenzile Miriam Makeba	Miriam Makeba
Nkosazana Dlamini-Zuma	Nkosazana Dlamini-Zuma
Frederik de Klerk	Frederik de Klerk
Kgalema Motlanthe	Kgalema Motlanthe
IPhondo yaseMntla-Ntshona	Provincia del Noroeste
Iankile	Ancla
2010 FIFuRoni da Futboll	Copa Mundial de Fútbol de 2010
Idessert	Postre
UMarvin Gaye	Marvin Gaye
I-discourse	Discurso
Uluhlu lweendawo eMzantsi Afrika	Provincias de Sudáfrica
Robben island	Isla Robben
Iipijama	Pijama
Banovci (Nijemci)	Banovci (Nijemci)
Freshlyground	Freshlyground
Iilwimi zaseAfrika	Lenguas de África
AmaXhosa	Xhosa
Pieter Willem Botha	Pieter Willem Botha
Google Street View	Google Street View
Steve Biko	Steve Biko
IPhondo yaFreyistata	Estado Libre de Orange
Ibhanti	Belt
Umlungu	Blanco (persona)
U-Winnie Madikizela Mandela	Winnie Madikizela
Étienne Mourrut	Étienne Mourrut
FIFA	FIFA
U-Helen Zille	Helen Zille
UBilly Ocean	Billy Ocean
Marek Grechuta	Marek Grechuta
ULucky Dube	Lucky Dube
Mateyu	Evangelio de Mateo
Walter Sisulu	Walter Sisulu
Incwadi ka Mormoni	Libro de Mormón
I-Transkei	Transkei
Izifundo zoguqulo	Traductología
I-Freedom Front Plus	Frente de la Libertad
ULebu Mathosa	Lebo Mathosa
Mangosuthu Buthelezi	Gatsha Mangosutu Buthelezi
I-Yunivesithi yasePitoli	Universidad de Pretoria
E-UNISA	Universidad de Sudáfrica
Pigazzano	Pigazzano
Iinkonzo Zeelwimi Zesizwe	National Language Services
Ugqirha	Doctor en Medicina
E-Tiburon	Tiburón (California)
Kayamandi	Kayamandi
Mthatha	Mthatha
IYunivesithi yaseStellenbosch	Universidad de Stellenbosch
Nkosi sikelel iAfrika	Nkosi Sikelel' iAfrika
Saganaki	Saganaki
Category:IJamani	Categoría:Alemania
Category:UMzantsi Afrika	Categoría:Sudáfrica
Iilwimi zaseMzantsi Afrika	Idiomas de Sudáfrica
Category:ENetherlands	Categoría:Países Bajos
Category:ISyensya	Categoría:Ciencia
Ukucinezeleka kwamanina	Violencia contra la mujer
Qunu	Qunu
Category:Oluhlu	Categoría:Anexos
Template:Tl	Plantilla:Ep
Category:Amazwe	Categoría:Países
Wikipedia:Requests for adminship	Wikipedia:Candidaturas a bibliotecario
Category:Hidden categories	Categoría:Wikipedia:Categorías ocultas
I-Accounting	Contabilidad
Template:Bot	Plantilla:Bot
Template:Flagicon	Plantilla:Bandera
Template:Documentation	Plantilla:Documentación
Wikipedia:Community Portal	Portal:Comunidad
Category:User languages	Categoría:Wikipedia:Wikipedistas por idioma
Sung Jae-gi	Sung Jae-ki
IZenzo	Buenas obras
CTICC	Centro Internacional de Convenciones de Ciudad del Cabo
Template:Softredirect	Plantilla:Redirección suave
Template:Ukucima	Plantilla:Destruir
The Sims	Los Sims (saga)
Category:Ulwimi	Categoría:Lenguas
Category:Ikhalenda	Categoría:Calendarios
Category:Wikipedia	Categoría:Wikipedia
Wikipedia:General disclaimer	Wikipedia:Limitación general de responsabilidad
Wikipedia:Statistics	Wikipedia:Estadísticas
Template:!	Plantilla:!
Wikipedia:Vital articles	Wikipedia:Lista de artículos que toda Wikipedia debería tener
Category:Afrika	Categoría:África
Category:Eyekhala	Categoría:Julio
Category:Amanani	Categoría:Números
Category:Eyesilimela	Categoría:Junio
Category:IPhondo yaMpumalanga	Categoría:Mpumalanga
Category:Ubuchwepheshe	Categoría:Electrónica
Category:Ilali	Categoría:Localidades rurales
Category:IBhayibhile	Categoría:Biblia
Category:Amaxwebhu	Categoría:Documentos
Category:Iincwadi	Categoría:Libros
Category:Inyanga	Categoría:Meses
Template:Wikisource	Plantilla:Wikisource
Template:Babel	Plantilla:Babel
Template:Commons	Plantilla:Commons
Template:Link GA	Plantilla:Bueno
Template:Reflist	Plantilla:Listaref
Template:Stub	Plantilla:Esbozo
Template:See also	Plantilla:VT
Category:Uluhlu lweendawo eMzantsi Afrika	Categoría:Provincias de Sudáfrica
Template:Pn	Plantilla:Página requerida
Template:SIL	Plantilla:Doc ISO3
Template:USA	Plantilla:USA
Template:Country data Indonesia	Plantilla:Geodatos Indonesia
Category:User fr-1	Categoría:Wikipedia:Wikipedistas con nivel básico de francés
Template:Country showdata	Plantilla:Mostrar geodatos
Template:Infobox School	Plantilla:Ficha de escuela
Template:Location map	Plantilla:Mapa de localización
Category:User en-4	Categoría:Wikipedia:Wikipedistas con nivel experto de inglés
Category:User en	Categoría:Wikipedia:Wikipedistas con conocimientos de inglés
Category:User en-2	Categoría:Wikipedia:Wikipedistas con nivel intermedio de inglés
Template:Infobox	Plantilla:Ficha
Template:Cite web	Plantilla:Cita web
Template:Country data	Plantilla:Geodatos
Template:Coor URL	Plantilla:Coor URL
Category:User hi	Categoría:Wikipedia:Wikipedistas con conocimientos de hindi
Template:Flagicon/core	Plantilla:Bandera icono
Category:Country data templates	Categoría:Wikipedia:Plantillas de geodatos
Template:Both	Plantilla:Ambas
Template:Location map USA	Plantilla:Mapa de localización de Estados Unidos
Template:Flag/core	Plantilla:Bandera icono-país
Template:User	Plantilla:U
Template:Emergency-bot-shutoff	Plantilla:Paro de emergencia del bot
Category:User ja-N	Categoría:Wikipedia:Wikipedistas con nivel nativo de japonés
Template:Br separated entries	Plantilla:Br separated entries
Category:User gsw-1	Categoría:Wikipedia:Wikipedistas con nivel básico de alemán suizo
Template:Infobox person	Plantilla:Ficha de persona
Template:Coord	Plantilla:Coord
Template:Citation/make link	Plantilla:Obra citada/enlace
Category:User az	Categoría:Wikipedia:Wikipedistas con conocimientos de azerí
Category:User be	Categoría:Wikipedia:Wikipedistas con conocimientos de bielorruso
Category:User hr	Categoría:Wikipedia:Wikipedistas con conocimientos de croata
Category:User sk	Categoría:Wikipedia:Wikipedistas con conocimientos de eslovaco
Category:User eo	Categoría:Wikipedia:Wikipedistas con conocimientos de esperanto
Category:User et	Categoría:Wikipedia:Wikipedistas con conocimientos de estonio
Category:User fr	Categoría:Wikipedia:Wikipedistas con conocimientos de francés
Category:User gl	Categoría:Wikipedia:Wikipedistas con conocimientos de gallego
Category:User hu-N	Categoría:Wikipedia:Wikipedistas con nivel nativo de húngaro
Category:User id	Categoría:Wikipedia:Wikipedistas con conocimientos de indonesio
Category:User ia	Categoría:Wikipedia:Wikipedistas con conocimientos de interlingua
Category:User ja	Categoría:Wikipedia:Wikipedistas con conocimientos de japonés
Category:User it-3	Categoría:Wikipedia:Wikipedistas con nivel avanzado de italiano
Category:User cs-1	Categoría:Wikipedia:Wikipedistas con nivel básico de checo
Category:User da-1	Categoría:Wikipedia:Wikipedistas con nivel básico de danés
Category:User et-1	Categoría:Wikipedia:Wikipedistas con nivel básico de estonio
Category:User fi-1	Categoría:Wikipedia:Wikipedistas con nivel básico de finés
Category:User gl-1	Categoría:Wikipedia:Wikipedistas con nivel básico de gallego
Category:User hi-1	Categoría:Wikipedia:Wikipedistas con nivel básico de hindi
Category:User ar-1	Categoría:Wikipedia:Wikipedistas con nivel básico de árabe
Category:User be-2	Categoría:Wikipedia:Wikipedistas con nivel intermedio de bielorruso
Category:User da-2	Categoría:Wikipedia:Wikipedistas con nivel intermedio de danés
Category:User fr-2	Categoría:Wikipedia:Wikipedistas con nivel intermedio de francés
Category:User ia-2	Categoría:Wikipedia:Wikipedistas con nivel intermedio de interlingua
Category:User tr-2	Categoría:Wikipedia:Wikipedistas con nivel intermedio de turco
Category:User hr-N	Categoría:Wikipedia:Wikipedistas con nivel nativo de croata
Category:User fr-N	Categoría:Wikipedia:Wikipedistas con nivel nativo de francés
Category:User af	Categoría:Wikipedia:Wikipedistas con conocimientos de afrikaans
Category:User af-1	Categoría:Wikipedia:Wikipedistas con nivel básico de afrikáans
Category:User als	Categoría:Wikipedia:Wikipedistas con conocimientos de Alemannisch
Category:User als-1	Categoría:Wikipedia:Wikipedistas con nivel básico de Alemannisch
Category:User ar	Categoría:Wikipedia:Wikipedistas con conocimientos de árabe
Category:User cs	Categoría:Wikipedia:Wikipedistas con conocimientos de checo
Category:User da	Categoría:Wikipedia:Wikipedistas con conocimientos de danés
Category:User sk-N	Categoría:Wikipedia:Wikipedistas con nivel nativo de eslovaco
Category:User de	Categoría:Wikipedia:Wikipedistas con conocimientos de alemán
Category:User de-2	Categoría:Wikipedia:Wikipedistas con nivel intermedio de alemán
Category:User de-3	Categoría:Wikipedia:Wikipedistas con nivel avanzado de alemán
Category:User de-N	Categoría:Wikipedia:Wikipedistas con nivel nativo de alemán
Category:User el	Categoría:Wikipedia:Wikipedistas con conocimientos de griego antiguo
Category:User en-3	Categoría:Wikipedia:Wikipedistas con nivel avanzado de inglés
Category:User en-N	Categoría:Wikipedia:Wikipedistas con nivel nativo de inglés
Category:User eo-1	Categoría:Wikipedia:Wikipedistas con nivel básico de esperanto
Category:User es	Categoría:Wikipedia:Wikipedistas con conocimientos de español
Category:User es-1	Categoría:Wikipedia:Wikipedistas con nivel básico de español
Category:User es-2	Categoría:Wikipedia:Wikipedistas con nivel intermedio de español
Category:User es-4	Categoría:Wikipedia:Wikipedistas con nivel experto de español
Category:User es-N	Categoría:Wikipedia:Wikipedistas con nivel nativo de español
Category:User gsw	Categoría:Wikipedia:Wikipedistas con conocimientos de alemán suizo
Category:User hu	Categoría:Wikipedia:Wikipedistas con conocimientos de húngaro
Category:User it	Categoría:Wikipedia:Wikipedistas con conocimientos de italiano
Category:User it-1	Categoría:Wikipedia:Wikipedistas con nivel básico de italiano
Category:User ja-1	Categoría:Wikipedia:Wikipedistas con nivel básico de japonés
Category:User tr	Categoría:Wikipedia:Wikipedistas con conocimientos de turco
Category:User tr-N	Categoría:Wikipedia:Wikipedistas con nivel nativo de turco
Template:Spaces	Plantilla:Spaces
Template:Country data United States	Plantilla:Geodatos Estados Unidos
Template:Refbegin	Plantilla:Refcomienza
Template:Citation/core	Plantilla:Obra citada/núcleo
E-Paradise Cay	Paradise Cay (California)
Umnqathe	Daucus carota
Sinenjongo High School	Escuela Secundaria Sinenjongo
Template:Flag	Plantilla:Bandera2
Template:Country data Texas	Plantilla:Geodatos Texas
Trojany	Trojany
Category:IDolophu	Categoría:Localidades
Category:User en-1	Categoría:Wikipedia:Wikipedistas con nivel básico de inglés
Category:User de-1	Categoría:Wikipedia:Wikipedistas con nivel básico de alemán
Category:User da-N	Categoría:Wikipedia:Wikipedistas con nivel nativo de danés
Template:Location map~	Plantilla:Mapa de localización~
Template:Location map+	Plantilla:Mapa de localización+
Wikipedia:VisualEditor	Wikipedia:Editor visual
Module:Citation/CS1/Whitelist	Módulo:Citas/Whitelist
Template:Location map/decdeg	Plantilla:Mapa de localización/decdeg
Wikipedia Zero	Wikipedia Zero
Module:Arguments	Módulo:Argumentos
Special:RecentChanges	Especial:CambiosRecientes
Module:Citation/CS1	Módulo:Citas
Module:Citation/CS1/Configuration	Módulo:Citas/Configuración
Category:User ja-4	Categoría:Wikipedia:Wikipedistas con nivel experto de japonés
Module:HtmlBuilder	Módulo:HtmlBuilder
Module:String	Módulo:String
Module:Coordinates	Módulo:Coordenadas
Module:Math	Módulo:Math
Module:Infobox	Módulo:Ficha
Industrial and Mining Water Research Unit	Industrial and mining water research unit
