阿非利加洲	África
日本	Japón
挪威	Noruega
英格蘭	Inglaterra
蘇格蘭	Escocia
愛爾蘭共和國	Irlanda
匈牙利	Hungría
西班牙	España
美國	Estados Unidos
比利時	Bélgica
盧森堡	Luxemburgo
宇宙	Universo
坤輿	Tierra
死	Muerte
人	Homo sapiens
華盛頓	George Washington
芬蘭	Finlandia
瑞典	Suecia
丹麥	Dinamarca
波蘭	Polonia
立陶宛	Lituania
義大利	Italia
瑞士	Suiza
奧地利	Austria
希臘共和國	Grecia
土耳其	Turquía
啤酒	Cerveza
葡萄牙	Portugal
歐羅巴洲	Europa
亞細亞洲	Asia
南極洲	Antártida
維基大典	Wikipedia
荷蘭	Países Bajos
紐約市	Nueva York
華盛頓哥倫比亞特區	Washington D. C.
柏林	Berlín
電腦	Computadora
共筆臺	MediaWiki
倫敦	Londres
巴黎	París
安卓	Android
谷歌	Google
墨西哥	México
太平洋	Océano Pacífico
熒惑	Marte (planeta)
衣索比亞	Etiopía
迦納	Ghana
法國	Francia
世界語	Esperanto
犬	Canis lupus familiaris
英國	Reino Unido
貓	Felis silvestris catus
中華人民共和國	República Popular China
法蘭西語	Idioma francés
維基爾雅	Wikcionario
乙醇	Etanol
巴西	Brasil
醇	Alcohol
俄羅斯	Rusia
光導纖維	Fibra óptica
正方形	Cuadrado
圓周率	Número π
共筆	Wiki
魁北克	Quebec
維基媒體基金會	Fundación Wikimedia
威霽彌	Jimmy Wales
德國	Alemania
白俄羅斯	Bielorrusia
德語	Idioma alemán
冰島	Islandia
愛沙尼亞	Estonia
鎮星	Saturno (planeta)
飛機	Avión
一	Uno
二	Dos
三	Tres
〇	Cero
無限	Infinito
拉脫維亞	Letonia
烏克蘭	Ucrania
捷克	República Checa
斯洛伐克	Eslovaquia
羅馬尼亞	Rumania
保加利亞	Bulgaria
羅馬	Roma
馬其頓	República de Macedonia
格陵蘭	Groenlandia
哈薩克	Kazajistán
古巴	Cuba
印度尼西亞	Indonesia
莫扎特	Wolfgang Amadeus Mozart
貝多芬	Ludwig van Beethoven
南非	Sudáfrica
商博良	Jean-François Champollion
阿爾及利亞	Argelia
水	Agua
電視	Televisión
智利	Chile
耶穌	Jesús de Nazaret
伽利略	Galileo Galilei
辰星	Mercurio (planeta)
史	Historia
蘋果公司	Apple
太白	Venus (planeta)
語言	Lenguaje
愛	Amor
歲星	Júpiter (planeta)
銀河	Vía Láctea
大霹靂	Teoría del Big Bang
天王星	Urano (planeta)
英文維基大典	Wikipedia en inglés
海王星	Neptuno (planeta)
新加坡	Singapur
格致	Ciencia
冥王星	Plutón (planeta enano)
列支敦士登	Liechtenstein
希特勒	Adolf Hitler
臉書	Facebook
第一次世界大戰	Primera Guerra Mundial
第二次世界大戰	Segunda Guerra Mundial
烏邦土	Ubuntu
數學	Matemáticas
拉丁語	Latín
巴林	Baréin
塞爾維亞	Serbia
月	Luna
澳大利亞	Australia
物理	Física
阿根廷	Argentina
秘魯	Perú
生物學	Biología
朝鮮民主主義人民共和國	Corea del Norte
柬埔寨	Camboya
古蘭經	Corán
恐龍	Dinosauria
回教	Islam
大英百科	Enciclopedia Británica
歐羅巴聯盟	Unión Europea
朋友	Amistad
馬里亞納海溝	Fosa de las Marianas
珠穆朗瑪峰	Monte Everest
拿破崙一世	Napoleón Bonaparte
恆星	Estrella
日	Sol
巴斯特	Louis Pasteur
光年	Año luz
大洋洲	Oceanía
太陽系	Sistema Solar
氫	Hidrógeno
氦	Helio
維基共享	Wikimedia Commons
鋰	Litio
鈹	Berilio
日（曆法）	Día
東帝汶	Timor Oriental
夜	Noche
黑洞	Agujero negro
穀神星	Ceres (planeta enano)
妊神星	Haumea (planeta enano)
鳥神星	Makemake (planeta enano)
鬩神星	Eris (planeta enano)
硼	Boro
碳	Carbono
氮	Nitrógeno
氧	Oxígeno
行星	Planeta
威尼斯	Venecia
火影忍者	Naruto
莫斯科	Moscú
氟	Flúor
義大利語	Idioma italiano
氖	Neón
鈉	Sodio
鎂	Magnesio
鋁	Aluminio
紐西蘭	Nueva Zelanda
印度	India
硅	Silicio
磷	Fósforo
鐵	Hierro
硫	Azufre
東	Este
氯	Cloro
巴布亞新幾內亞	Papúa Nueva Guinea
莎士比亞	William Shakespeare
氬	Argón
鉀	Potasio
鈣	Calcio
鉛	Plomo
蒙古國	Mongolia
鈧	Escandio
鈦	Titanio
委內瑞拉	Venezuela
成吉思汗	Gengis Kan
釩	Vanadio
鉻	Cromo
阿姆斯特丹	Ámsterdam
動物	Animalia
錳	Manganeso
哥倫比亞	Colombia
鈷	Cobalto
鎢	Wolframio
鎳	Níquel
佛教	Budismo
玻利維亞	Bolivia
銅	Cobre
千里達及托巴哥	Trinidad y Tobago
植物	Plantae
鋅	Cinc
真菌	Fungi
牙買加	Jamaica
夏威夷	Hawái
海地	Haití
伊朗	Irán
伊拉克	Irak
哥斯大黎加	Costa Rica
以色列	Israel
巴拿馬	Panamá
科威特	Kuwait
老撾	Laos
馬爾地夫	Maldivas
亞美利加洲	América
馬來西亞	Malasia
緬甸	Birmania
尼泊爾	Nepal
阿曼	Omán
巴基斯坦	Pakistán
卡達國	Catar
沙特阿拉伯	Arabia Saudita
斯里蘭卡	Sri Lanka
斯大林	Iósif Stalin
柏拉圖	Platón
鎵	Galio
神奇寶貝	Pokémon
中華民國	República de China
鍺	Germanio
泰國	Tailandia
砒	Arsénico
硒	Selenio
溴	Bromo
鉑	Platino
越南	Vietnam
大韓民國	Corea del Sur
氪	Kriptón
阿富汗	Afganistán
江南風	Gangnam Style
銣	Rubidio
金	Oro
蘇彝士運河	Canal de Suez
孟加拉國	Bangladés
蘇格拉底	Sócrates
安哥拉	Angola
不丹	Bután
汶萊	Brunéi
汞	Mercurio (elemento)
菲律賓	Filipinas
中非	República Centroafricana
鉈	Talio
南極	Polo Sur
北極	Polo Norte
牛頓	Isaac Newton
鍶	Estroncio
釔	Itrio
鉍	Bismuto
尚比亞	Zambia
津巴布韋	Zimbabue
北京市	Pekín
南蘇丹	Sudán del Sur
海參崴	Vladivostok
波札那	Botsuana
剛果民主共和國	República Democrática del Congo
吉布提	Yibuti
加蓬	Gabón
甘地	Mahatma Gandhi
利比亞	Libia
馬達加斯加	Madagascar
摩洛哥	Marruecos
莫桑比克	Mozambique
納米比亞	Namibia
尼日利亞	Nigeria
烏干達	Uganda
索馬里	Somalia
凱撒	Julio César
蘇丹	Sudán
斯威士蘭	Suazilandia
鍀	Tecnecio
天演	Evolución biológica
聯合國	Organización de las Naciones Unidas
地理學	Geografía
腦	Cerebro
布拉格	Praga
銀	Plata
錫	Estaño
鈾	Uranio
鈈	Plutonio
碘	Yodo
氙	Xenón
銫	Cesio
鐳	Radio (elemento)
氡	Radón
賈坎德邦	Jharkhand
耶路撒冷	Jerusalén
印度洋	Océano Índico
科索沃	Kosovo
蕭邦	Frédéric Chopin
Category:類	Categoría:Índice de categorías
帕斯卡	Blaise Pascal
冬	Invierno
春	Primavera
夏	Verano
秋	Otoño
薩達姆·海珊	Sadam Husein
拉登	Osama bin Laden
西班牙語	Idioma español
巴赫	Johann Sebastian Bach
泉幣	Dinero
奧古斯都	César Augusto
諾基亞	Nokia
德克薩斯州	Texas
布宜諾斯艾利斯	Buenos Aires
東京都	Tokio
密西西比河	Río Misisipi
錫金	Sikkim
尼爾杭思朗	Neil Armstrong
斯德哥爾摩	Estocolmo
墓誌	Epitafio
里加	Riga
聖經	Biblia
金邊	Nom Pen
真耶穌教會	Verdadera Iglesia de Jesús
英語	Idioma inglés
曼谷	Bangkok
臺北市	Taipéi
鎇	Americio
康賽普西翁	Concepción (Chile)
緬尼托巴	Manitoba
孔斯科沃拉	Końskowola
公元二千年	2000
二〇〇三年	2003
二〇〇二年	2002
二〇〇一年	2001
二〇一二年	2012
二〇一一年	2011
二〇一〇年	2010
二〇〇九年	2009
二氧化碳	Dióxido de carbono
二〇一三年	2013
二〇一四年	2014
二〇一五年	2015
二〇〇八年	2008
二〇〇四年	2004
二〇〇五年	2005
二〇〇六年	2006
二〇〇七年	2007
一氧化碳	Monóxido de carbono
戴高樂	Charles de Gaulle
一九九二年	1992
一九九一年	1991
一九九〇年	1990
一九九三年	1993
一九九四年	1994
一九九五年	1995
一九九六年	1996
可縮放矢量圖形	Scalable Vector Graphics
萊比錫	Leipzig
一九九七年	1997
一九九八年	1998
一九九九年	1999
食物	Alimento
光速	Velocidad de la luz
公曆一月一日	1 de enero
公曆一月二日	2 de enero
公曆一月三日	3 de enero
公曆一月四日	4 de enero
矮行星	Planeta enano
公曆一月五日	5 de enero
公曆一月六日	6 de enero
電子	Electrón
公曆一月七日	7 de enero
公曆一月八日	8 de enero
公曆一月九日	9 de enero
公曆一月十日	10 de enero
公曆一月十一日	11 de enero
公曆一月十二日	12 de enero
公曆一月十三日	13 de enero
公曆一月十四日	14 de enero
公曆一月十五日	15 de enero
工業革命	Revolución Industrial
苯	Benceno
微軟	Microsoft
質子	Protón
庫魯夫	Kurów
公曆二月五日	5 de febrero
公曆二月八日	8 de febrero
化學	Química
中子	Neutrón
公曆二月廿九日	29 de febrero
公曆三月十四日	14 de marzo
一九八九年	1989
一九八八年	1988
一九八七年	1987
一九八六年	1986
一九八五年	1985
一九八四年	1984
一九八三年	1983
一九八二年	1982
一九八一年	1981
一九八〇年	1980
一九七〇年	1970
一九七一年	1971
一九七二年	1972
一九七三年	1973
一九七四年	1974
一九七五年	1975
一九七六年	1976
一九七七年	1977
一九七八年	1978
一九七九年	1979
一九六九年	1969
公曆四月五日	5 de abril
衛星	Satélite natural
公曆五月四日	4 de mayo
土衛六	Titán (satélite)
一九六八年	1968
一九六七年	1967
一九六六年	1966
一九六五年	1965
一九六四年	1964
公曆六月廿日	20 de junio
公曆七月廿三日	23 de julio
足球	Fútbol
一九六三年	1963
一九六二年	1962
公曆九月十日	10 de septiembre
公曆十二月卅一日	31 de diciembre
公曆十月十日	10 de octubre
灶神星	(4) Vesta
查理曼	Carlomagno
木衛一	Ío (satélite)
木衛四	Calisto (satélite)
木衛二	Europa (satélite)
木衛三	Ganímedes (satélite)
火	Fuego
新南威爾士州	Nueva Gales del Sur
土衛二	Encélado (satélite)
天衛三	Titania (satélite)
海衛一	Tritón (satélite)
雅加達	Yakarta
一九六一年	1961
Category:模板	Categoría:Wikipedia:Plantillas
一九六〇年	1960
小行星	Asteroide
日食	Eclipse solar
二進制	Sistema binario
阿斯圖里亞斯	Asturias
維基大典:沙盒	Wikipedia:Zona de pruebas
卡爾梅克共和國	Kalmukia
代數學	Álgebra
地圖	Mapa
阿拉貢自治區	Aragón
前卅三年	33 a. C.
硫酸	Ácido sulfúrico
同海機場	Aeropuerto de Đồng Hới
Category:大韓民國紀事	Categoría:Historia de Corea del Sur
Category:日本史	Categoría:Historia de Japón
伯力	Jabárovsk
Category:越南史	Categoría:Historia de Vietnam
孔子	Confucio
莎拉伯恩哈特	Sarah Bernhardt
Category:伊拉克史	Categoría:Historia de Irak
南加州大学	Universidad del Sur de California
Category:數學	Categoría:Matemáticas
Category:蒙古史	Categoría:Historia de Mongolia
Category:人造語言	Categoría:Lenguas artificiales
文藝復興	Renacimiento
歐元	Euro
美金	Dólar estadounidense
地中海	Mar Mediterráneo
遼	Dinastía Liao
杭州市	Hangzhou
基督教	Cristianismo
Template:然也	Plantilla:A favor
金朝	Dinastía Jin (1115-1234)
柏林圍牆	Muro de Berlín
稻	Arroz
大陸	Continente
京	Capital (política)
Template:門	Plantilla:Portal
一九四八年	1948
艾爾瑪善鎮	Almazán
黃現璠	Huang Xianfan
一九四五年	1945
一九五八年	1958
日語	Idioma japonés
百科全書	Enciclopedia
維基大典:卷首	Wikipedia:Portada
一九五九年	1959
Template:正典	Plantilla:Artículo bueno
電晶體	Transistor
棒球	Béisbol
奧林匹克運動會	Juegos olímpicos
長江	Yangtsé
喜瑪拉雅山	Himalaya
落磯山	Montañas Rocosas
韃靼斯坦共和國	Tartaristán
一二六三年	1263
古斯巴達	Esparta
埃斯特雷馬杜拉	Extremadura
安達盧西亞	Andalucía
麥加	La Meca
毛澤東	Mao Zedong
西安市	Xi'an
拉薩市	Lhasa
哲學	Filosofía
Category:速刪候	Categoría:Wikipedia:Borrar (definitivo)
茶	Té
馬可·波羅	Marco Polo
一三六三年	1363
共產主義	Comunismo
一三六八年	1368
迦太基	Cartago
大英博物館	Museo Británico
巴拉頓湖	Lago Balatón
蒙庇利埃	Montpellier
Category:天文	Categoría:Astronomía
吉他	Guitarra
同性戀	Homosexualidad
漢堡包	Hamburguesa
夸克	Quark
高斯	Carl Friedrich Gauss
一六四四年	1644
一六四五年	1645
Category:恒星	Categoría:Estrellas
李白	Li Bai
伽羅華	Évariste Galois
政府	Gobierno
秦始皇帝	Qin Shi Huang
秦二世皇帝	Qin Er Shi
中東	Oriente Medio
漢	Dinastía Han
漢太祖高皇帝	Liu Bang
漢世宗孝武皇帝	Emperador Wu
聖女貞德	Juana de Arco
王莽	Wang Mang
意理	Ideología
帝國主義	Imperialismo
漢更始帝	Liu Xuan
漢世祖光武皇帝	Liu Xiu
共和	República
漢顯宗孝明皇帝	Emperador Ming de Han
國	Estado
漢孝和皇帝	Emperador He de Han
漢孝靈皇帝	Emperador Ling de Han
元	Dinastía Yuan
德意志第三帝國	Alemania nazi
哥倫布	Cristóbal Colón
庫克船長	James Cook
科爾蒂斯	Hernán Cortés
鄭和	Zheng He
大堡礁	Gran barrera de coral
巴拿馬運河	Canal de Panamá
晉	Dinastía Jin (265-420)
黃河	Río Amarillo
晉元帝	Emperador Yuan de Jin
隋	Dinastía Sui
西夏	Imperio tangut
脫氧核酸	Ácido desoxirribonucleico
趙宋	Dinastía Song
宋太祖	Song Taizu
宋徽宗	Song Huizong
宋高宗	Song Gaozong
宋理宗	Lizong
宋度宗	Duzong
歐拉	Leonhard Euler
一七七四年	1774
一七七五年	1775
一七七六年	1776
一八六六年	1866
一八六七年	1867
一八六八年	1868
晝	Mañana
拿破崙二世	Napoleón II Bonaparte
砒霜	Trióxido de arsénico
法律	Derecho
一七九四年	1794
世界人權宣言	Declaración Universal de los Derechos Humanos
一七九五年	1795
一七九六年	1796
漢語	Idioma chino
細胞	Célula
全球暖化	Calentamiento global
禪宗	Zen
鼠標	Ratón (informática)
聖奧思定	Agustín de Hipona
精靈	Hada
朊	Proteína
理則	Lógica
龍捲風	Tornado
幾何	Geometría
語法	Gramática
熱帶氣旋	Ciclón tropical
計學	Economía
語言學	Lingüística
文字	Sistema de escritura
阿拉伯字	Alfabeto árabe
漢字	Sinograma
西里爾字母	Alfabeto cirílico
孫子兵法	El arte de la guerra
Category:音樂	Categoría:Música
紅樓夢	Sueño en el pabellón rojo
Category:法國史	Categoría:Historia de Francia
哈利波特	Harry Potter
放手銃	Masturbación
法文維基大典	Wikipedia en francés
死刑	Pena de muerte
人權	Derechos humanos
乳	Leche
山	Montaña
沙漠	Desierto
孫文	Sun Yat-sen
薩拉丁	Saladino
阿育王	Aśoka
阿克巴大帝	Akbar
香港	Hong Kong
韓戰	Guerra de Corea
南北戰爭	Guerra de Secesión
首爾特別市	Seúl
上海市	Shanghái
清	Dinastía Qing
越戰	Guerra de Vietnam
歐几里得	Euclides
巴斯克語	Euskera
星座	Constelación
拉脫維亞語	Idioma letón
原子	Átomo
宗教	Religión
朝鮮語	Idioma coreano
笛卡兒	René Descartes
官話	Chino mandarín
越南語	Idioma vietnamita
猶太教	Judaísmo
老子	Lao-Tsé
電鼠	Pikachu
尼采	Friedrich Nietzsche
司馬遷	Sima Qian
斯密亞丹	Adam Smith
朱熹	Zhu Xi
廷巴克圖	Tombuctú
洋	Océano
阿奎那	Tomás de Aquino
英王維多利亞	Victoria del Reino Unido
釋迦牟尼	Buda Gautama
馬丁·路德	Martín Lutero
儒家	Confucianismo
腹	Abdomen
陰脈	Vena
福克蘭群島	Islas Malvinas
陽脈	Arteria
唐	Dinastía Tang
威爾斯王妃黛安娜	Diana de Gales
唐太宗	Li Shimin
唐玄宗	Emperador Xuanzong de Tang
唐宣宗	Xuanzong II
明	Dinastía Ming
明太祖	Zhū Yuánzhāng
明惠宗	Jianwen
明成祖	Yongle
明仁宗	Hongxi
明宣宗	Xuande
明英宗	Zhu Qizhen
明代宗	Jingtai
明憲宗	Chenghua
明孝宗	Hongzhi
明武宗	Zhengde
明世宗	Jiajing
明穆宗	Longqing
明神宗	Emperador Wanli
明光宗	Taichang
明熹宗	Tianqi
明思宗	Chongzhen
電漿	Plasma (estado de la materia)
北斗七星	El Carro (asterismo)
金正日	Kim Jong-il
元素週期表	Tabla periódica de los elementos
自殺	Suicidio
九一一事件	Atentados del 11 de septiembre de 2001
電話	Teléfono
梵語	Sánscrito
化合物	Compuesto químico
算術	Aritmética
食鹽	Sal
化學元素	Elemento químico
方程	Ecuación
映射	Función matemática
角	Ángulo
分子	Molécula
加速度	Aceleración
能量	Energía
弈	Go
金屬	Metal
氣體	Gas
液體	Líquido
固體	Sólido
船舶	Buque
農	Agricultura
速度	Velocidad
納米科技	Nanotecnología
勾股定理	Teorema de Pitágoras
證明	Demostración matemática
數	Número
複數	Número complejo
公斤	Kilogramo
公尺	Metro
大麥	Hordeum vulgare
繪畫	Pintura
華爾街	Wall Street
美國總統	Presidente de los Estados Unidos
東南亞	Sudeste Asiático
瀋陽市	Shenyang
重慶市	Chongqing
天津市	Tianjín
武漢市	Wuhan
史前	Prehistoria
古埃及	Antiguo Egipto
白令海峽	Estrecho de Bering
古希臘	Antigua Grecia
傑弗遜	Thomas Jefferson
希臘文維基大典	Wikipedia en griego
麥	Triticum
格里曆	Calendario gregoriano
拉丁文維基大典	Wikipedia en latín
麻雀 (棋牌)	Mahjong
鹽	Sal (química)
牛頓（單位）	Newton (unidad)
度量衡	Medición
萬國公制	Sistema Internacional de Unidades
集論	Teoría de conjuntos
哈里發塔	Burj Khalifa
長城	Gran Muralla China
整數	Número entero
球	Esfera
大憲章	Carta Magna
阿兹特克	Mexica
上塞納省	Altos del Sena
東羅馬帝國	Imperio bizantino
奧斯曼帝國	Imperio otomano
國內生產總值	Producto interno bruto
銃	Arma de fuego
伊比利半島	Península ibérica
坦克	Tanque (desambiguación)
實數	Número real
楈枒	Cocos nucifera
桃	Prunus persica
湘語	Chino xiang
冰酪	Helado
文胸	Sostén (prenda de vestir)
阿拉伯語	Idioma árabe
本州	Honshū
四國	Región de Shikoku
地中海氣候	Clima mediterráneo
科西嘉	Córcega
頂級域名	Dominio de nivel superior
斯洛文尼亞語維基大典	Wikipedia en esloveno
百度	Baidu
澳門	Macao
尖沙咀	Tsim Sha Tsui
土衛一	Mimas (satélite)
土衛四	Dione (satélite)
土衛三	Tetis (satélite)
土衛五	Rea (satélite)
廣東省	Provincia de Cantón
廣西壯族自治區	Guangxi
蘇聯	Unión Soviética
香港中文大學	Universidad China de Hong Kong
亡神星	(90482) Orcus
塞德娜	(90377) Sedna
孟德斯鳩	Montesquieu
青馬大橋	Puente de Tsing Ma
維基大典:卓著	Wikipedia:Artículos destacados
Template:Link FA	Plantilla:Destacado
維基大典:會館	Wikipedia:Café
釜山廣域市	Busan
廣州市	Cantón (China)
蔣中正	Chiang Kai-shek
南京市	Nankín
君士坦丁堡	Constantinopla
首爾地鐵	Metro de Seúl
北京大學	Universidad de Pekín
清華大學	Universidad Tsinghua
烏魯木齊市	Urumchi
江蘇省	Jiangsu
浙江省	Zhejiang
鄧小平	Deng Xiaoping
新好男孩	Backstreet Boys
西藏自治區	Tíbet
圓	Circunferencia
歐氏幾何	Espacio euclídeo
周恩來	Zhou Enlai
中國共產黨	Partido Comunista de China
馮諾曼	John von Neumann
偽基大典	Uncyclopedia
太平山	Cumbre Victoria
公理	Axioma
清聖祖	Emperador Kangxi
朝鮮文維基大典	Wikipedia en coreano
檀香山	Honolulu
紋章	Heráldica
曼徹斯特聯足球俱樂部	Manchester United Football Club
平壤直轄市	Pionyang
模 (代數)	Módulo (matemática)
訓民正音	Hunminjeongeum
九	Nueve
清高宗	Emperador Qianlong
司徒華	Szeto Wah
蕭伯納	George Bernard Shaw
黑龍江省	Heilongjiang
香港島	Isla de Hong Kong
鹼金屬	Alcalino
非金屬	No metal
鹵素	Halógeno
稀有氣體	Gases nobles
維基大典:正典	Wikipedia:Artículos buenos
四川省	Sichuan
舊約	Antiguo Testamento
聖誕節	Navidad
三角形	Triángulo
印歐語系	Lenguas indoeuropeas
穆阿邁爾·格達費	Muamar el Gadafi
獨島	Rocas de Liancourt
江南區	Gangnam-gu
大田廣域市	Daejeon
大邱廣域市	Daegu
仁川國際機場	Aeropuerto Internacional de Incheon
仁川廣域市	Incheon
京畿道	Gyeonggi
自然數	Número natural
萬國音標字	Alfabeto Fonético Internacional
河北省	Hebei
革奴自由文檔許可協議	Licencia de documentación libre de GNU
蛋撻	Tartaleta de huevo
臺灣	Isla de Taiwán
紐約	Nueva York (desambiguación)
汝矣島	Yeouido
公元元年	1
魯迅	Lu Xun
八	Ocho
馬德堡半球	Hemisferios de Magdeburgo
主禱文	Padre nuestro
蒜	Allium sativum
白	Blanco (color)
黑	Negro (color)
六九八年	698
巴爾幹半島	Península balcánica
七二七年	727
墨索里尼	Benito Mussolini
四方	Punto cardinal
十	Diez
原子序	Número atómico
九一八年	918
公元百年	100
五七〇年	570
四時	Estaciones del año
二二二年	222
利物浦	Liverpool
鐵達尼號	RMS Titanic
五五二年	552
同位素	Isótopo
蜚蠊	Blattodea
功率	Potencia (física)
螢	Lampyridae
索布語	Lenguas sorbias
一八一二年戰爭	Guerra anglo-estadounidense de 1812
頂點	Vértice (geometría)
大理國	Reino de Dali
福岡市	Fukuoka
建城	Ab urbe condita
日本海	Mar del Japón
宮古列島	Islas Miyako
中亞	Asia Central
琉球國	Reino de Ryūkyū
伽倻	Confederación Gaya
朝鮮國	Dinastía Joseon
高麗國	Goryeo
大韓帝國	Imperio de Corea
渤海國	Balhae
高句麗	Goguryeo
百濟	Baekje
新羅	Silla (Corea)
扶餘	Reino de Buyeo
奧匈帝國	Imperio austrohúngaro
吸血鬼日記	The Vampire Diaries (serie de televisión)
馬雅	Cultura maya
印加國	Imperio incaico
縣	Condado
韓非子	Han Feizi
錦州市	Jinzhou
導數	Derivada
黃帝	Emperador amarillo
釣魚臺列嶼	Islas Senkaku
中國	China (región)
成都市	Chengdú
咖啡廳	Cafetería
蒲公英	Taraxacum
雪豹	Panthera uncia
白話維基大典	Wikipedia en chino
二二一年	221
五四三年	543
五三六年	536
二三〇年	230
二〇二年	202
一九二年	192
總統	Presidente
五五五年	555
五七一年	571
滿洲國	Manchukuo
二三一年	231
二二五年	225
三一一年	311
二二〇年	220
三一三年	313
五八七年	587
五四八年	548
五四九年	549
五五一年	551
五五七年	557
二二三年	223
二二四年	224
二一九年	219
大運河	Gran Canal de China
五八九年	589
華佗	Hua Tuo
三〇四年	304
五五〇年	550
五八六年	586
五八八年	588
五五四年	554
二二九年	229
五八三年	583
二六五年	265
二六三年	263
五八五年	585
五八二年	582
五五六年	556
四二〇年	420
二八〇年	280
五八一年	581
五五八年	558
國立臺灣大學	Universidad de Taiwán
國立中山大學	Universidad Nacional Sun Yat-sen
東干語	Idioma dungano
客家語	Chino hakka
切羅基語	Idioma cheroqui
羅素悖論	Paradoja de Russell
五六九年	569
贛語	Chino gan
爪哇語	Idioma javanés
司馬光	Sima Guang
滿語	Idioma manchú
弧度	Radián
五五三年	553
三〇七年	307
五八四年	584
杜甫	Du Fu
人口	Población
瓦爾帕萊索	Valparaíso
青銅	Bronce
情報及特殊使命局	Mosad
尼亞加拉瀑布	Cataratas del Niágara
吳語	Chino wu
昭和天皇	Hirohito
基地組織	Al Qaeda
穆罕默德二世	Mehmed II
希臘神話	Mitología griega
秦	Estado Qin
新疆維吾爾族自治區	Sinkiang
郵局	Oficina de Correos
萬國首都全覽	Anexo:Capitales de Estado
周	Dinastía Zhou
形而上學	Metafísica
白宮	Casa Blanca
北海道	Hokkaidō
科科斯（基林）群島	Islas Cocos
胡志明	Hồ Chí Minh
蘇軾	Su Shi
明尼阿波利斯	Minneapolis
集	Conjunto
順化市	Huế
閩東語	Min Dong
閩南語	Chino min nan
離子	Ion
壯族	Etnia zhuang
南斯拉夫	Yugoslavia
長毛象	Mammuthus
四邊形	Cuadrilátero
三船敏郎	Toshirō Mifune
文言	Chino clásico
線	Recta
甲烷	Metano
孫武	Sun Tzu
中央情報局	Agencia Central de Inteligencia
語法學	Sintaxis
聯合國安全理事會	Consejo de Seguridad de las Naciones Unidas
眼鏡	Gafas
火柴	Fósforo (utensilio)
多邊形	Polígono (geometría)
市場	Mercado
南海	Mar de la China Meridional
朝鮮世宗	Sejong el Grande
俳句	Haiku
黃海	Mar Amarillo
今上天皇	Akihito
橫濱市	Yokohama
普魯士	Prusia
前四年	4 a. C.
柳州市	Liuzhou
皇帝	Emperador
索契	Sochi
壓強	Presión
龍貓	Mi vecino Totoro
线粒体	Mitocondria
號	Nombre de estilo
吠陀	Vedas
橢圓	Elipse
杠杆	Palanca
自由亞洲電臺	Radio Free Asia
蟹	Brachyura
前九十年	90 a. C.
酸鹼度	PH
美國革命	Guerra de Independencia de los Estados Unidos
安徽省	Anhui
前九十一年	91 a. C.
忠清北道	Chungcheong del Norte
忠清南道	Chungcheong del Sur
內蒙古自治區	Mongolia Interior
金日成	Kim Il-sung
慶尚南道	Gyeongsang del Sur
慶尚北道	Gyeongsang del Norte
全羅北道	Jeolla del Norte
全羅南道	Jeolla del Sur
濟州特別自治道	Jeju
鬱陵島	Ulleungdo
巴別塔	Torre de Babel
蔚山廣域市	Ulsan
光州廣域市	Gwangju
一元二次方程	Ecuación de segundo grado
李斯特	Franz Liszt
美式足球	Fútbol americano
前八十七年	87 a. C.
哥德爾	Kurt Gödel
摩爾	Mol
華國鋒	Hua Guofeng
烷烴	Alcano
希爾伯特	David Hilbert
前九十五年	95 a. C.
黃金分割	Número áureo
福建省	Fujian
班夫國家公園	Parque nacional Banff
查士丁尼一世	Justiniano I
前七十四年	74 a. C.
慶州市	Gyeongju
安東市	Andong
尚州市	Sangju
阿貝爾·塔斯曼	Abel Tasman
海南省	Hainan
功	Trabajo (física)
漢語拼音	Pinyin
莽原氣候	Sabana
甘肅省	Gansu
蘇州市	Suzhou
溫州市	Wenzhou
無錫市	Wuxi
湖州市	Huzhou
紹興市	Shaoxing
崑山市	Kunshan
寧波市	Ningbo
紙鳶	Cometa (juego)
前二〇一年	201 a. C.
前二〇二年	202 a. C.
哈爾濱市	Harbin
油	Aceite
拓撲學	Topología
文身	Tatuaje
金融學	Finanzas
雲南省	Yunnan
多項式	Polinomio
山東省	Shandong
中南半島	Indochina
天擇	Selección natural
地質年代	Escala temporal geológica
壟斷	Monopolio
河南省	Henan
遼寧省	Liaoning
席德	Rodrigo Díaz de Vivar
刳剔者傑克	Jack el Destripador
前一五六年	156 a. C.
列奧尼達一世	Leónidas I
前一三九年	139 a. C.
前一二二年	122 a. C.
前二〇六年	206 a. C.
西爾門·拉什迪	Salman Rushdie
前二〇三年	203 a. C.
化學鍵	Enlace químico
槍	Lanza
前一四一年	141 a. C.
僧院	Monasterio
白堊紀	Cretácico
前二〇九年	209 a. C.
皮薩羅	Francisco Pizarro
點	Punto (geometría)
骰子	Dado
吉林省	Jilin
東海	Mar de China Oriental
前二三二年	232 a. C.
湖南省	Hunan
青海省	Qinghai
前一九七年	197 a. C.
前二〇七年	207 a. C.
前一八八年	188 a. C.
矢	Flecha
前二〇五年	205 a. C.
鮨	Sushi
前二〇八年	208 a. C.
湖北省	Hubei
山西省	Shanxi
魔方	Cubo de Rubik
伊洛瓦底省	Ayeyarwady
貴州省	Guizhou
京都議定書	Protocolo de Kioto sobre el cambio climático
聯合國大會	Asamblea General de las Naciones Unidas
乙酸	Ácido acético
安達曼海	Mar de Andamán
前二〇四年	204 a. C.
胡適	Hu Shih
莊子	Zhuangzi
清孝欽顯皇后	Cixí
陝西省	Shaanxi
Template:共享類	Plantilla:Commonscat
三八三年	383
德文維基大典	Wikipedia en alemán
拋物線	Parábola (matemática)
尿素	Urea
平假名	Hiragana
波斯文維基大典	Wikipedia en persa
質數	Número primo
五七二年	572
南北朝	Dinastías Meridionales y Septentrionales
劉宋	Dinastía Liu Song
吾世	Minecraft
罷工	Huelga
李舜臣汝諧	Yi Sun Sin
泰國地方	Provincias de Tailandia
中華人民共和國地方	Organización territorial de la República Popular China
日本都道府縣	Anexo:Prefecturas de Japón por superficie y población
氧化物	Óxido
合數	Número compuesto
因數	Divisibilidad
口琴	Armónica
朝鮮灣	Bahía de Corea
Template:Taxobox	Plantilla:Ficha de taxón
繩文時代	Período Jōmon
魔法少女小圓	Puella Magi Madoka Magica
太極	Taiji
平行	Paralelismo (matemática)
周宣王	Rey Xuan de Zhou
百家姓	Cien apellidos de familia
極品飛車	Need for Speed
海鳥	Ave marina
琉球語	Lenguas ryukyuenses
閩語	Chino min
江西省	Jiangxi
阿卜杜拉·本·阿卜杜勒-阿齊茲·沙特	Abdalá bin Abdelaziz
寧夏回族自治區	Ningxia
揚州市	Yangzhou
鎮江市	Zhenjiang
哈薩克文維基大典	Wikipedia en kazajo
嘉興市	Jiaxing
金華市	Jinhua
衢州市	Quzhou
台州市	Taizhou (Zhejiang)
舟山市	Zhoushan
石家莊市	Shijiazhuang
亞當與夏娃	Adán y Eva
卡金納答	Kakinada
珠海	Zhuhai
韶關市	Shaoguan
東莞市	Dongguan
維吾爾文維基大典	Wikipedia en uigur
俄羅斯正教會	Iglesia ortodoxa rusa
鯢	Andrias davidianus
空師	Fuerza aérea
大名	Daimio
色盲檢測圖	Cartas de Ishihara
威氏鷸	Gallinago delicata
哈布斯堡氏	Casa de Habsburgo
中央銀行	Banco central
福州市	Fuzhou
南平市	Nanping
莆田市	Putian
三明市	Sanming
泉州市	Quanzhou
廈門市	Xiamen
漳州市	Zhangzhou
龍岩市	Longyan
寧德市	Ningde
西寧市	Xining
西遊記	Viaje al Oeste
三國演義	Romance de los Tres Reinos
水滸傳	A la orilla del agua
鄂州市	Ezhou
福島縣	Prefectura de Fukushima
豬油	Manteca de cerdo
新竹縣	Condado de Hsinchu
鞍山市	Anshan
羅馬治世	Paz romana
克羅內克	Leopold Kronecker
康托爾	Georg Cantor
戴德金	Julius Wilhelm Richard Dedekind
寒武紀	Cámbrico
十六元數	Sedeniones
神聖羅馬皇帝腓特烈一世	Federico I Barbarroja
前三八七年	387 a. C.
盲文	Braille (lectura)
千葉縣	Prefectura de Chiba
賽珍珠	Pearl S. Buck
聯合國秘書長	Secretaría General de Naciones Unidas
龐加萊	Henri Poincaré
西北水道	Paso del Noroeste
十進制	Sistema de numeración decimal
烯烴	Alqueno
皇祚	Himno Nacional de Japón
氣壓	Presión atmosférica
箸	Palillos
片假名	Katakana
民之旨	Jana-Gana-Mana
臺北一零一	Taipei 101
化學式	Fórmula química
群 (代數)	Grupo (matemática)
天安門	Puerta de Tian'anmen
水星領航員	ARIA (manga)
三角函數	Función trigonométrica
六四事件	Protestas de la Plaza de Tiananmén de 1989
趙紫陽	Zhao Ziyang
胡耀邦	Hu Yaobang
安樂死	Eutanasia
姓氏	Apellido
醛	Aldehído
規	Compás (instrumento)
物質之量	Cantidad de sustancia
平安北道	P'yŏngan del Norte
咸鏡南道	Hamgyŏng del Sur
島國	País insular
華山	Monte Hua
桃園市	Taoyuan
尺規作圖	Regla y compás
京都府	Prefectura de Kioto
絕對值	Valor absoluto
羅賓漢	Robin Hood
表數法	Sistema de numeración
大阪府	Prefectura de Osaka
瑪瑙	Ágata (mineral)
愛媛縣	Prefectura de Ehime
圓錐曲線	Sección cónica
海平面	Nivel del mar
玄武	Genbu
羅馬皇帝表	Anexo:Emperadores romanos
矢量空間	Espacio vectorial
距	Distancia
臺灣海峽	Estrecho de Taiwán
山口縣	Prefectura de Yamaguchi
市盈率	Price-to-earnings ratio
神奈川縣	Prefectura de Kanagawa
中國地方	Región de Chūgoku
長野縣	Prefectura de Nagano
殷商	Dinastía Shang
色諾芬	Jenofonte
兵庫縣	Prefectura de Hyōgo
廣州恆大淘寶蹴鞠會	Guangzhou Evergrande
關係 (數學)	Relación binaria
等價	Relación de equivalencia
主格	Caso nominativo
泰國灣	Golfo de Tailandia
螳螂	Mantodea
維基大典:書海	Wikipedia:Fuentes de libros
征夷大將軍	Shōgun
春節	Año Nuevo chino
切腹	Harakiri
色盲	Daltonismo
阿什莫爾島與卡捷島	Islas Ashmore y Cartier
農曆	Calendario chino
可樂	Bebida de cola
高知縣	Prefectura de Kōchi
道德經	Dào Dé Jing
萬有引力	Ley de gravitación universal
坐標幾何	Geometría analítica
芬瑟島	Isla Fraser
蹴鞠	Cuju
臺南市	Tainan
阮籍	Ruan Ji
與格	Caso dativo
摩爾質量	Masa molar
滿洲族	Manchú
義大利半島	Península itálica
袁枚	Yuan Mei
汽水	Gaseosa
天象館	Planetario
微積分	Cálculo
岳陽市	Yueyang
東寧	Reino de Tungning
李斯	Li Si
雲林縣	Condado de Yunlin
碗	Cuenco
全等	Congruencia (geometría)
維多利亞港	Puerto de Victoria
義勇軍進行曲	Yiyongjun Jinxingqu
數理物理	Física matemática
紅花	Carthamus tinctorius
庖人	Cocinero
大正天皇	Emperador Taishō
毛納洛峰	Mauna Loa
富牌國際機場	Aeropuerto de Phú Bài
修道院	Abadía
符節	Contraseña
環 (代數)	Anillo (matemática)
環球小姐	Miss Universo
香川縣	Prefectura de Kagawa
曲線	Curva
白求恩	Norman Bethune
中日戰爭	Guerra sino-japonesa
平面幾何	Geometría euclidiana
葉問	Ip Man
基數	Número cardinal
二元運算	Operación binaria
餘弦定理	Teorema del coseno
新幹線	Shinkansen
雙曲線	Hipérbola
星際爭霸	StarCraft
反射	Reflexión (física)
近視	Miopía
代數數	Número algebraico
夏后氏	Dinastía Xia
連續	Función continua
教廷諸屬國	Estados Pontificios
濟南市	Jinan
十一月革命	Revolución de Noviembre
中國抗日戰爭	Segunda guerra sino-japonesa
青島市	Qingdao
PSP	PlayStation Portable
葛利斯五八一丙	Gliese 581 c
官能團	Grupo funcional
世氣公會	Organización Meteorológica Mundial
見即所得	WYSIWYG
新西班牙代王領	Virreinato de Nueva España
織田信長	Oda Nobunaga
向日葵	Helianthus annuus
南昌市	Nanchang
中壢區	Zhongli
玫瑰之名	El nombre de la rosa
幾何原本	Elementos de Euclides
米高·哥連斯	Michael Collins (líder irlandés)
金本位	Patrón oro
直積	Producto cartesiano
艾狄胥	Paul Erdős
四元數	Cuaternión
長沙市	Changsha
有機化合物	Compuesto orgánico
明治天皇	Emperador Meiji
源實朝	Minamoto no Sanetomo
蜉蝣	Ephemeroptera
伊藤博文	Itō Hirobumi
絞刑	Ahorcamiento
門:史	Portal:Historia
電極	Electrodo
阿拉伯數字	Números arábigos
股骨	Fémur
子集	Subconjunto
海東青	Falco rusticolus
日文維基大典	Wikipedia en japonés
繁體字	Caracteres chinos tradicionales
甲午戰爭	Primera guerra sino-japonesa
克里希那穆提	Jiddu Krishnamurti
宦官	Eunuco
汀九橋	Puente Ting Kau
選擇公理	Axioma de elección
行星環	Anillo planetario
青藏高原	Meseta tibetana
拓撲空間	Espacio topológico
古文書	Paleografía
數學符表	Anexo:Símbolos matemáticos
錫克金廟	Templo Dorado
卡奔塔利亞灣	Golfo de Carpentaria
度量空間	Espacio métrico
千分比	Por mil
交換群	Grupo abeliano
高雄市	Kaohsiung
華盛頓歐文	Washington Irving
易經	I Ching
弩	Ballesta
渤海	Mar de Bohai
甑帶瘡	Herpes zóster
西楚霸王	Xiang Yu
戰艦	Acorazado
海倫公式	Fórmula de Herón
昆明市	Kunming
天氣預報	Pronóstico del tiempo
人蔘	Panax ginseng
回族	Etnia hui
蘭州市	Lanzhou
期貨	Contrato de futuros
鰂	Sepiida
林則徐	Lin Hse Tsu
三國	Tres Reinos
春秋時代	Primaveras y Otoños
戰國	Reinos Combatientes
名偵探柯南	Detective Conan
區間	Intervalo (matemática)
清宣統帝	Puyi
併集	Unión de conjuntos
簡化字	Caracteres chinos simplificados
合肥市	Heféi
交集	Intersección de conjuntos
常染色體	Autosoma
啓	Qǐ
簡歷	Currículum vítae
蝴蝶效應	Efecto mariposa
豐臣秀吉	Toyotomi Hideyoshi
假名	Kana
民律大全	Corpus iuris civilis
白鱀豚	Lipotes vexillifer
弦	Cuerda (geometría)
平昌郡	Pyeongchang
泰國國際航空	Thai Airways
北九州市	Kitakyūshū (Fukuoka)
匈奴	Xiongnu
孟子	Mencio
桂林市	Guilin
海口市	Haikou
無機化合物	Compuesto inorgánico
域 (代數)	Cuerpo (matemáticas)
海拔	Altitud
挪威廣播公司	Norsk Rikskringkasting
中原	Llanura Central (China)
道	Tao
世界語維基大典	Wikipedia en esperanto
刺身	Sashimi
中泰國	Tailandia Central
高錳酸鉀	Permanganato de potasio
鴉片戰爭	Primera Guerra del Opio
魔鬼之詩篇	Los versos satánicos
有序對	Par ordenado
金屬鍵	Enlace metálico
書面挪威語維基大典	Wikipedia en noruego
序數	Número ordinal (teoría de conjuntos)
南京大屠殺	Masacre de Nankín
吳廷琰	Ngô Đình Diệm
複式記帳	Partida doble
麵	Fideo
化學符號	Anexo:Elementos químicos por símbolo
路易斯安那購地案	Compra de la Luisiana
扇	Abanico
平安時代	Período Heian
旦	Orto
韓信點兵	Teorema chino del resto
梅涅勞斯定理	Teorema de Menelao
無窮小	Infinitesimal
屏東縣	Condado de Pingtung
單鏡筒反光相機	Cámara réflex
雙城子	Ussuriisk
張飛	Zhang Fei
張衡	Zhang Heng
張遼	Zhang Liao
張騫	Zhang Qian
張三丰	Zhang Sanfeng
張載	Chang Tsai
張仲景	Zhang Zhong Jing
趙	Estado Zhao
鄭成功	Koxinga
鄭玄	Cheng Hsuan
鎮海區	Distrito de Zhenhai
周敦頤	Zhou Dunyi
周公亶父	Rey Tai de Zhou
周瑜	Zhou Yu
周作人	Zhou Zuoren
諸葛亮	Zhuge Liang
慶良間群島	Islas Kerama
壯學	Estudios zhuang
烏克蘭語維基大典	Wikipedia en ucraniano
阿拉伯文維基大典	Wikipedia en árabe
金孟加拉	Himno nacional de Bangladés
希伯來文維基大典	Wikipedia en hebreo
洞里薩湖	Tonlé Sap
賈姆謝德布爾	Jamshedpur
越南文維基大典	Wikipedia en vietnamita
負數	Número negativo
中醫	Medicina china tradicional
高松市	Takamatsu
中華人民共和國憲法	Constitución de la República Popular China
提格兰二世	Tigranes II el Grande
珠江	Río de las Perlas
泰西格致史	Historia de la ciencia
五帝	Tres augustos y cinco emperadores
瑪格麗特一世	Margarita I de Dinamarca
日本國會	Dieta de Japón
先哥倫布	América precolombina
英聯邦王國	Monarquía en la Mancomunidad de Naciones
彼得一世島	Isla Pedro I
墓碑	Lápida
十二銅表法	Ley de las XII Tablas
漢魏武王	Cao Cao
斬首	Decapitación
垂直	Perpendicularidad
無窮集合	Conjunto infinito
冪集	Conjunto potencia
魚鉤	Anzuelo
齊齊哈爾市	Qiqihar
椰蟹	Birgus latro
俄文維基大典	Wikipedia en ruso
平行公理	Quinto postulado de Euclides
春武里府	Provincia de Chon Buri
西線無戰事	Sin novedad en el frente (novela)
嘧啶	Pirimidina
泰王國歌	Phleng Chat
冬至	Solsticio de invierno
中國中央電視臺	Televisión Central de China
圖蘭朵	Turandot
巴列維王朝	Dinastía Pahlaví
天皇	Emperador de Japón
熱帶雨林氣候	Clima ecuatorial
袁世凱	Yuan Shikai
北海市	Beihai
袋鼠島	Isla Canguro
君士坦丁堡普世宗主教區	Iglesia ortodoxa de Constantinopla
辛普生沙漠	Desierto de Simpson
雷曼兄弟公司	Lehman Brothers
娜塔莎·北鼎斐	Natasha Bedingfield
開集	Conjunto abierto
測地線	Geodésica
塞瓦定理	Teorema de Ceva
健陀羅	Gandhara
愛爾蘭共和國總統	Anexo:Presidente de Irlanda
內積空間	Espacio prehilbertiano
金奎植	Kim Kyu-Sik
江戶	Edo
金九	Kim Koo
泰山	Monte Tai
荀況	Xun Zi
九江市	Jiujiang
反氫	Antihidrógeno
占婆	Champa
倒數	Inverso multiplicativo
黃道兇賊	Asesino del Zodiaco
陰陽五行	Wu Xing
盧溝橋事變	Incidente del Puente de Marco Polo
關羽	Guan Yu
龜	Testudines
阮福晪	Bảo Đại
元 (釋義)	Yuan
空集	Conjunto vacío
祖沖之	Zu Chongzhi
羅馬 (釋義)	Roma (desambiguación)
左氏春秋	Zuo Zhuan
連通	Grafo conexo
瀨戶內海	Mar Interior de Seto
自由民主黨	Partido Liberal Democrático (Japón)
環	Loop
利瑪竇	Matteo Ricci
原富	La riqueza de las naciones
技術分析	Análisis técnico
哆啦A夢	Doraemon
宋卡府	Provincia de Songkhla
甲米府	Provincia de Krabi
拉廊府	Provincia de Ranong
伏羲	Fuxi
宜蘭縣	Condado de Yilan (Taiwán)
法家	Legalismo (filosofía china)
九龍	Kowloon
瑪麗·安·尼科爾斯	Mary Ann Nichols
素叻府	Provincia de Surat Thani
成本	Coste
桐艾府	Provincia de Trat
五代	Cinco Dinastías
瑪麗·簡·凱利	Mary Jane Kelly
森理世	Riyo Mori
補集	Complemento de un conjunto
靖國神社	Santuario Yasukuni
博他侖府	Provincia de Phatthalung
鹽田	Salina
班武里府	Provincia de Prachuap Khiri Khan
洛坤府	Provincia de Nakhon Si Thammarat
春蓬府	Provincia de Chumphon
新北市	Nuevo Taipéi
臺中市	Taichung
漢昭烈皇帝	Liu Bei
干支	Ciclo sexagenario
三國志	Registros de los Tres Reinos
金門縣	Kinmen
嘉義市	Chiayi
基隆市	Keelung
副省級市	Ciudad-subprovincia de la República Popular China
從眾	Argumento ad populum
牢不可破之聯盟	Himno nacional de la Unión Soviética
相似	Semejanza (geometría)
大韓高宗	Emperador Gojong
摩托羅拉	Motorola
賢哲賽義巴巴	Sai Baba de Shirdi
雪景球	Bola de nieve (juguete)
淨土宗	Tierra Pura
伊麗莎白·史泰德	Elizabeth Stride
安妮·查普曼	Annie Chapman
聖德太子	Príncipe Shōtoku
沈括	Shen Kuo
貴金屬	Metal precioso
懿德天皇	Emperador Itoku
史記	Memorias históricas
早稻田大學	Universidad de Waseda
孫吳	Wu (reino)
論語	Analectas de Confucio
泰華農民銀行	Banco Kasikorn
尚眞王	Shō Shin
平清盛	Taira no Kiyomori
創意公用授權條款	Licencias Creative Commons
澳洲聯邦銀行	Commonwealth Bank of Australia
拉臘·杜塔	Lara Dutta
小野田寬郎	Hirō Onoda
清太宗	Hung Taiji
楊貴妃	Yang Guifei
蔡琰	Cai Wenji
推古天皇	Emperatriz Suiko
漢孝成班婕妤	Consorte Ban
清德宗	Emperador Guangxu
鎖國	Aislacionismo
戈登	Charles George Gordon
清世祖	Emperador Shunzhi
清太祖	Nurhaci
進數	Número p-ádico
卡拉卡拉敕令	Edicto de Caracalla
明智光秀	Akechi Mitsuhide
綏靖天皇	Emperador Suizei
阮攸	Nguyễn Du
白居易	Bai Juyi
吳大帝	Sun Quan (emperador Da de Wu)
屈原	Qu Yuan
魏世祖文皇帝	Cao Pi
神農	Shennong
小淵惠三	Keizō Obuchi
帝舜	Emperador Shun
安寧天皇	Emperador Annei
發勃耳	Jean Henri Fabre
張國榮	Leslie Cheung
蔣經國	Chiang Ching-kuo
王維	Wang Wei
後醍醐天皇	Emperador Go-Daigo
陶潛	Tao Yuanming
桓武天皇	Emperador Kanmu
林彪	Lin Biao
清世宗	Emperador Yongzheng
呂布	Lü Bu
鴨脷洲	Ap Lei Chau
清穆宗	Emperador Tongzhi
韓愈	Han Yu
王安石	Wang Anshi
德川吉宗	Tokugawa Yoshimune
米芾	Mi-Fei
拓撲閉包	Clausura topológica
閉集	Conjunto cerrado
閉開集	Conjunto clopen
曹魏	Wei (reino)
作格	Caso ergativo
尖竹汶府	Provincia de Chanthaburi
陳省身	Shiing-Shen Chern
第十五屆亞洲運動會	Juegos Asiáticos de 2006
基斯孔哈拉斯	Kiskunhalas
覆蓋	Recubrimiento (matemática)
竭澤而漁	Sobrepesca
通格	Caso absolutivo
清仁宗	Emperador Jiaqing
正親町天皇	Emperador Ōgimachi
董卓	Dong Zhuo
林語堂	Lin Yutang
孫臏	Sun Bin
杜牧	Du Mu
孫堅	Sun Jian
石田三成	Ishida Mitsunari
大韓純宗	Emperador Sunjong de Corea
婆羅多舞	Bharatanatyam
歐陽脩	Ouyang Xiu
清宣宗	Emperador Daoguang
清文宗	Emperador Xianfeng
北柳府	Provincia de Chachoengsao
羅勇府	Provincia de Rayong
袁紹	Yuan Shao
柳宗元	Liu Zongyuan
司馬懿	Sima Yi
福澤諭吉	Fukuzawa Yukichi
安慶市	Anqing
安祿山	An Lushan
六安市	Lu'an
呂不韋	Lü Buwei
武丁	Wu Ding
陳獨秀	Chen Duxiu
蒂邁歐篇	Timeo (diálogo)
魏 (釋義)	Wei
崇明島	Chongming
藤原定家	Fujiwara no Teika
坂本龍馬	Sakamoto Ryōma
王守仁	Wang Yangming
朝鮮太祖	Taejo de Joseon
陸遜	Lu Xun (Tres Reinos)
李鴻章	Li Hongzhang
南唐後主	Li Yu
顧愷之	Gu Kaizhi
中秋	Fiesta del Medio Otoño
李珥	Yi I
光中帝	Nguyễn Huệ
尹鑴	Yun Hyu
墓	Tumba
沙繳府	Provincia de Sa Kaeo
緊集	Espacio compacto
依善	Tailandia del Nordeste
高順	Gao Shun
成都雙流國際機場	Aeropuerto Internacional de Chengdú-Shuangliu
發翔羽	Pluma de vuelo
赤腹蠑螈	Cynops pyrrhogaster
南陽市	Nanyang
秋葉原	Akihabara
徐光啟	Xu Guangqi
虹吸	Sifón
南充市	Nanchong
北條時宗	Hōjō Tokimune
藤原道長	Fujiwara no Michinaga
戚繼光	Qi Jiguang
董仲舒	Dong Zhongshu
托勒密定理	Teorema de Ptolomeo
丸龜市	Marugame
鄧麗君	Teresa Teng
李清照	Li Qingzhao
明成皇后	Myeonseong de Joseon
殷墟	Yin Xu
夏帝履癸	Jié
詩經	Clásico de poesía
秋瑾	Qiu Jin
自斷	Autotomía
足利義量	Ashikaga Yoshikazu
戈公省	Provincia de Koh Kong
效用	Utilidad (economía)
大月氏	Yuezhi
吳三桂	Wu Sangui
甘寧	Gan Ning
元稹	Yuan Zhen
嵇康	Xi Kang
陳納德	Claire Chennault
太史慈	Taishi Ci
山口二矢	Otoya Yamaguchi
商帝辛	Di Xin
商湯	Shāng Tāng
噌汁	Sopa de miso
偏序	Conjunto parcialmente ordenado
康托爾定理	Teorema de Cantor
長島區	Ko Yao
新山一國際機場	Aeropuerto Internacional de Tan Son Nhat
晁衡	Abe no Nakamaro
安重根	An Jung-geun
朝鮮半島	Península de Corea
電車	Unidad eléctrica múltiple
和服	Kimono
遜尼派	Sunismo
朝鮮宣祖	Seonjo de Joseon
白翎島	Baengnyeong
汝矣島純福音教會	Iglesia del Evangelio Pleno de Yoido
哥德巴赫猜想	Conjetura de Goldbach
韓國銀行	Banco de Corea
三國遺事	Samguk Yusa
坤輿萬國全圖	Kunyu Wanguo Quantu
三國史記	Samguk Sagi
國家情報院	Servicio de Inteligencia Nacional de Corea del Sur
鬱陵郡	Condado de Ulleung
朝鮮漢字	Hanja
李埈鎔	Yi Jun-yong
李滉	Yi Hwang
國會議員	Parlamentario
摩爾體積	Volumen molar
傲遊瀏覽器	Maxthon
竹島 (鬱陵郡)	Jukdo
復旦大學	Universidad Fudan
可居島	Gageodo
馬羅島	Marado (isla)
牛島	Isla Udo
世宗文化會館	Centro de Sejong
萌	Moe
琉璃明王	Yuri de Koguryo
廣開土王	Gwanggaeto el Grande de Goguryeo
韓國放送公社	Korean Broadcasting System
涼宮春日系列	Suzumiya Haruhi no Yūutsu
直轄市	Municipio bajo jurisdicción central
莎阿南	Shah Alam
玉山	Yu Shan
大嶼山	Isla Lantau
楚	Chu
梅爾維爾島	Isla Melville (Australia)
北太平洋露脊鯨	Eubalaena japonica
海北藏族自治州	Prefectura autónoma tibetana de Haibei
蒼龍	Seiryū
中庸	Doctrina de la medianía
中國禮儀之爭	Disputa de los Ritos
鳳凰	Fenghuang
中正紀念堂	Salón Conmemorativo de Chiang Kai-shek
吳清源	Go Seigen
塔如濤群島	Tarutao
真言宗	Budismo Shingon
初音未來	Miku Hatsune
餛飩	Wantán
教會羅馬字	Peh-oe-ji
超濾法	Ultrafiltración
司馬相如	Sima Xiangru
吉田松陰	Yoshida Shōin
錢鍾書	Qian Zhongshu
嚴復	Yan Fu
帕覺柯	José Emilio Pacheco
泰文維基大典	Wikipedia en tailandés
猫眼林克	Link (The Legend of Zelda)
蘇通長江大橋	Puente Sutong
尼奧寵物	Neopets
包頭市	Baotou
板橋區	Panch'iao
壬辰倭亂	Invasiones japonesas de Corea (1592-1598)
魏鄧哀王	Cao Chong
小行星三千	(3000) Leonardo
軍曹	Keroro Gunsō
梁羽生	Liang Yu Sheng
原口證	Akira Haraguchi
新界	Nuevos Territorios
武漢天河國際機場	Aeropuerto Internacional de Wuhan-Tianhe
八桂學派	Escuela de Bagui
午餐肉	Spam (alimento)
呂底亞	Lidia
自焚	Quemarse a lo bonzo
廬山	Monte Lu
老撾之歌	Pheng Xat Lao
謝靈運	Xie Lingyun
夏禹	Yu el Grande
藤原氏	Clan Fujiwara
漢 (釋義)	Han
衡山	Monte Heng (Hunan)
杭思朗	Armstrong
香港語言學學會粵語拼音方案	Jyutping
刀	Dao (sable)
水龍頭	Llave de paso
子拓撲	Topología traza
廣州地鐵	Metro de Cantón
車裂	Desmembramiento
嘉定區	Jiading
金山區	Jinshan
性染色體	Alosoma
算術基本定理	Teorema fundamental de la aritmética
存活期	Tiempo de vida (informática)
稠密	Conjunto denso
崑曲	Kunqu
流亡政府	Gobierno en el exilio
古魯特島	Groote Eylandt
中文數字	Numeración china
天主教輔仁大學	Universidad Católica Fu Jen
武器貿易條約	Tratado de comercio de armas
Habanera	El amor es un pájaro rebelde
內田蝲蛄	Pacifastacus leniusculus
龜船	Barco Tortuga
永樂大典	Enciclopedia Yǒnglè
諡	Nombre póstumo
大東諸島	Islas Daitō
中央廣播電臺	Radio Taiwán Internacional
周文王	Rey Wen de Zhou
恆春丙戌地震	Terremoto de Hengchun de 2006
李時珍	Li Shizhen
東沙	Islas Pratas
張勳	Zhang Xun (República de China)
朝鮮八道	Ocho antiguas provincias de Corea
杭州灣	Bahía de Hangzhou
和珅	Heshen
韓服	Hanbok
施琅	Shi Lang
唐景崧	Tang Jingsong
朝香鳩彥	Príncipe Asaka
臭豆腐	Tofu maloliente
泉蓋蘇文	Yeon Gaesomun
王昌齡	Wang Changlin
段祺瑞	Duan Qirui
中國醫藥大學	Universidad China Droga
臺灣高速鐵路	Tren de Alta Velocidad de Taiwán
臺灣問題	Estatus político de la República de China
威化島	Isla Wihwa
富春山居圖	Morada en las montañas Fuchun
賈似道	Jia Sidao
三省六部	Tres departamentos y seis ministerios
黃金坪島	Isla Hwanggumpyong
國立中興大學	Universidad Nacional Chung Hsing
大腸包小腸	Salchicha pequeña en salchicha grande
黃庭堅	Huang Tingjian
彭佳嶼	Islote Pengjia
金農	Jin Nong
黃家駒	Wong Ka Kui
世界新七大奇蹟	Nuevas siete maravillas del mundo moderno
鑒真	Jianzhen
清明上河圖	El festival Qingming junto al río
臺北捷運	Metro de Taipéi
延邊州	Prefectura autónoma coreana de Yanbian
袁崇煥	Yuan Chonghuan
林紓	Lin Shu
日月潭	Lago de Sol y Luna
桃花島	Isla Taohua
貢丸	Bola de cerdo
龜山島	Isla Gueishan
攀牙灣	Bahía de Phang Nga
南漢高祖	Liu Yan
張世傑	Zhang Shijie
色戒	Lust, Caution
日本雅樂	Gagaku
墨家	Moísmo
拓撲量子場論	Teoría topológica cuántica de campo
印地文維基大典	Wikipedia en hindi
琴	Guqin
範空間	Espacio vectorial normado
有界	Acotado
乃蠻	Naimano
帝乙	Di Yi
盤庚	Pan Geng
平知盛	Taira no Tomomori
士燮	Shi Xie
魯	Estado de Lu
倫敦東隅	East End de Londres
申 (地支)	Signo del mono
歐羅巴	Europa (desambiguación)
性	Naturaleza humana
八元數	Octonión
結合代數	Álgebra asociativa
春秋	Anales de primavera y otoño
地級市	Ciudad-prefectura de la República Popular China
泰北	Tailandia del Norte
黃巾之亂	Rebelión de los Turbantes Amarillos
迴文數	Capicúa
水墨畫	Sumi-e
銀魂	Gintama
沖繩縣	Prefectura de Okinawa
香港城市大學	Universidad de la ciudad de Hong Kong
三國志人物列表	Anexo:Personajes de los Tres Reinos
百度大典	Baidu Baike
平衡球	Ballance
盤谷銀行	Banco de Bangkok
基 (拓撲)	Base (topología)
本草綱目	Bencao Gangmu
二虎歌	Frère Jacques
南越	Nanyue
赤壁之戰	Batalla de los Acantilados Rojos
超複數	Número hipercomplejo
奧海鎮	Ojai
天下通言	Lengua auxiliar
博者之謬	Falacia del apostador
古雅典	Antigua Atenas
漢傳佛教	Budismo chino
渭水	Río Wei
阿巴諾湖	Lago Albano
康熙字典	Diccionario de Kangxi
證明論	Teoría de la demostración
石	Koku
族 (數學)	Familia de conjuntos
李賀	Li He
仡佬族	Gelao
光圈	Número f (óptica)
禮記	Libro de los Ritos
內點	Interior (topología)
州際三十五號公路大橋	Puente I-35W del río Misisipi
萬葉假名	Man'yōgana
會計等式	Ecuación de contabilidad
姣童	Bishōnen
元朗區	Yuen Long
尚書	Clásico de historia
雲隙光	Rayos crepusculares
康威數	Número surreal
常用漢字	Jōyō kanji
天命	Mandato del Cielo
周界	Frontera (topología)
漢水	Río Han (Hanshui)
高昌	Ruinas de Gaochang
窮奇	Kamaitachi
文丁	Wen Ding
太甲	Tai Jia
武乙	Wu Yi de Shang
中華民國總統	Anexo:Presidente de la República de China
陸奧國	Provincia de Mutsu
東方計劃	Touhou Project
分液漏斗	Embudo de decantación
晉國	Estado Jin
魏	Estado Wei
單連通	Conjunto simplemente conexo
吳	Estado Wu
藁人之謬	Falacia del hombre de paja
京津城際鐵路	Línea de Alta Velocidad Pekín-Tianjín
地球之年歲	Edad de la Tierra
弗林德斯島 (塔斯曼尼亞)	Isla Flinders
坂上田村麻呂	Sakanoue no Tamuramaro
蘇洵	Su Xun
泰京銀行	Banco Krung Thai
數學科目分類	Mathematics Subject Classification
陸上風帆	Vehículo de vela
雷恩島	Isla Raine
兼六園	Kenroku-en
代數 (代數)	Álgebra sobre un cuerpo
羅勇市	Rayong
儋州市	Danzhou
汶川縣	Wenchuan
馬達納帕利	Madanapalle
越秀	Yuexiu
大都	Janbalic
倉頡	Cangjie
卡羅萊納箱龜	Terrapene carolina
凌遲	Muerte por mil cortes
周公季	Rey Ji de Zhou
美洲殖民	Colonización de los Estados Unidos
日本新字體	Shinjitai
朱鳥	Suzaku
周武王	Rey Wu de Zhou
元維基	Wikimedia Meta-Wiki
泉鏡花	Kyōka Izumi
去衣馳騁	Streaking
燭線	Gráfico de velas
陳	Estado de Chen
加藤清正	Katō Kiyomasa
泰南	Tailandia del Sur
南梁	Dinastía Liang
大學	Gran Saber
陸游	Lu You
閣帕岸島	Ko Pha Ngan
積拓撲	Topología producto
縣級市	Ciudad-condado de la República Popular China
夢蓮湖	Lago Moraine
說文解字	Shuowen Jiezi
白虎	Byakko
祁連山	Montañas Qilian
南華經	Libro de Zhuangzi
西班牙小姐	Miss España
中國共產黨中央政治局	Buró Político del Comité Central del Partido Comunista de China
厓山海戰	Batalla de Yamen
武漢大學	Universidad de Wuhan
亞米利加蝲蛄	Procambarus clarkii
源義仲	Minamoto no Yoshinaka
訓讀	Kun'yomi
中華人民共和國元帥	Yuan Shuai
日本舊字體	Kyūjitai
焚書坑儒	Quema de libros y sepultura de intelectuales
衛	Wei (período de primaveras y otoños)
三淸	Los Tres Puros
伊多文維基大典	Wikipedia en ido
雷峰塔	Pagoda Leifeng
西施	Xi Shi
辛棄疾	Xin Qiji
中國茉莉花革命	Protestas en China de 2011
周景王	Rey Jing de Zhou
近衛前久	Konoe Sakihisa
和字	Kokuji
六書	Clasificación de caracteres chinos
粵文維基大典	Wikipedia en cantonés
共形場論	Teoría conforme de campos
周幽王	Rey You de Zhou
黎太祖	Lê Lợi
零號元素	Neutronio
零零七島	Ko Tapu
九錫	Nueve Dignidades
長平之戰	Batalla de Changping
維基大典:大使館	Wikipedia:Embajadas
華嚴宗	Huayan
太鼓達人	Taiko no Tatsujin
四大文明古國	Cuna de la civilización
平將門	Taira no Masakado
叉燒包	Cha siu baau
國分寺	Kokubunji
分數	Número racional
王勃	Wang Bo
曾鞏	Zeng Gong
有司足下之函	Carta «Dear Boss»
劍	Jian
PSYCHO-PASS	Psycho-Pass
泰國日報	Thai Rath
梁末帝	Zhu Zhen
龜甲萬	Kikkoman
恆山	Monte Heng (Shanxi)
洞爺湖	Lago Tōya
古丁尼柏國家公園	Parque nacional Quttinirpaaq
漢服	Hanfu
泰王國股票交易所	Bolsa de Tailandia
乾燥氣候	Aridez
竹林七賢	Los siete sabios del bosque de bambú
富勞里友半島	Península de Fleurieu
內閣情報調查室	Naicho
野比大雄	Nobita Nobi
拾穗	Las espigadoras
秦孝文王	Xiaowen
尚泰王	Shō Tai
范蠡	Fan Li
動物莊園	Rebelión en la granja
藤原忠平	Fujiwara no Tadahira
Category:德國史	Categoría:Alemania
Category:俄羅斯聯邦書	Categoría:Rusia
Category:大韓民國書	Categoría:Corea del Sur
Category:羅馬帝國書	Categoría:Imperio romano
Category:鳥	Categoría:Aves
Category:植物	Categoría:Plantae
Category:物理	Categoría:Física
Category:自然科學	Categoría:Ciencias naturales
Category:化學	Categoría:Química
Category:史部	Categoría:Historia
Category:群	Categoría:Sociedad
Category:宗教	Categoría:Religión
Category:運動	Categoría:Deporte
Category:經部	Categoría:Ciencia
Category:聯合國	Categoría:Organización de las Naciones Unidas
Category:地球	Categoría:Tierra
盈不足術	Método de la regla falsa
道路連通	Conjunto conexo
平潭島	Isla Pingtan
眼鏡娘	Meganekko
韓	Estado Han
摩靈頓島	Isla Mornington (Australia)
昂船洲大橋	Puente Stonecutters
桿秤	Romana (instrumento)
一條兼良	Ichijō Kaneyoshi
桂宮宜仁親王	Príncipe Katsura
古羅馬	Antigua Roma
政令指定都市	Ciudades japonesas designadas por decreto gubernamental
甲骨蟾	Toad
宋卡湖	Lago Songkhla
克拉拉·奧斯瓦爾德	Clara Oswald
古今圖書集成	Gujin tushu jicheng
聖火降魔錄	Fire Emblem
清談	Qingtan
局部	Localmente
不寐	Insomnio
Category:釋義	Categoría:Wikipedia:Desambiguación
Category:哲學	Categoría:Filosofía
Category:心理	Categoría:Psicología
Category:佛教	Categoría:Budismo
Category:基督教	Categoría:Cristianismo
Category:回教	Categoría:Islam
Category:猶太教	Categoría:Judaísmo
洋油貓弔詭	Paradoja del gato y la mantequilla
華東師範大學	Universidad Normal del Este de China
泰國商業銀行	Banco Comercial de Siam
汝有二牯	Tú tienes dos vacas
藏文維基大典	Wikipedia en tibetano
吳 (釋義)	Wu
小豆島	Shōdoshima
彌敦道	Nathan Road
精緻拱門	Arco Delicado
大悲咒	Nilakantha dharani
陸機	Lu Ji
新挪威語維基大典	Wikipedia en nynorsk
阿拉伯文維基大典(埃及地區)	Wikipedia en árabe egipcio
淡水河	Río Tamsui
兒島明子	Akiko Kojima
吐蕃	Imperio tibetano
鄰域	Entorno (matemática)
羅馬共和官制	Constitución de la República Romana
梵文維基大典	Wikipedia en sánscrito
水筆仔	Kandelia obovata
華夏	Huaxia
準基	Subbase
丹羽長秀	Niwa Nagahide
燒賣	Shaomai
豆腐乳	Tofu encurtido
Category:維基事	Categoría:Administración de Wikipedia
Category:行星	Categoría:Planetas
Category:地質	Categoría:Geología
明治	Era Meiji
維基大典:陳年今誌	Wikipedia:Efemérides
正數	Número positivo
Help:凡例	Ayuda:Tutorial (edición)
Template:太陽系	Plantilla:Sistema Solar
霍英東	Henry Fok Ying-tung
蘇菲婭·杜慈	Sophea Duch
汲水門大橋	Puente Kap Shui Mun
香港濕地公園	Parque del humedal de Hong Kong
海南雞飯	Pollo con arroz de Hainan
陸定一	Lu Dingyi
井上多樂	Toro (personaje animado)
春運	Chunyun
門:子	Portal:Filosofía
卓文君	Zhuo Wenjun
國際語維基大典	Wikipedia en interlingua
門:集	Portal:Arte
Category:小行星帶天體	Categoría:Asteroides del cinturón principal
Category:美國列傳	Categoría:Estadounidenses
Template:Tl	Plantilla:Ep
Template:Userbox	Usuario:Userbox/Userbox
Category:網頁瀏覽器	Categoría:Navegadores web
Template:世事	Plantilla:Portada:Actualidad
Category:律法	Categoría:Derecho
Category:計學	Categoría:Economía
維基大典:有秩選舉	Wikipedia:Candidaturas a bibliotecario
Category:醫學	Categoría:Medicina
Category:政治	Categoría:Política
Category:教育	Categoría:Educación
Category:藝術	Categoría:Arte
會計	Contabilidad
密思兒	Egipto
Category:統計	Categoría:Estadística
Template:Bot	Plantilla:Bot
加拿大	Canadá
Category:卓著	Categoría:Wikipedia:Artículos destacados
維	Dimensión
Category:遊戲	Categoría:Juegos
門:經	Portal:Ciencias naturales y formales
Category:幫助文檔	Categoría:Ayuda
維基大典:世事	Portal:Actualidad
Template:Documentation	Plantilla:Documentación
Category:有秩	Categoría:Wikipedia:Bibliotecarios
維基大典:簿之權限	Wikipedia:Tipos de usuarios
Category:維基提案	Categoría:Wikipedia:Votaciones
維基大典:聯繫	Wikipedia:Contacto
維基大典:市集	Portal:Comunidad
Category:維基社群	Categoría:Wikipedia:Comunidad
Category:維基人	Categoría:Wikipedia:Wikipedistas por idioma
Category:維基人 (地方)	Categoría:Wikipedia:Wikipedistas por ubicación geográfica
維基大典:忽略規則	Wikipedia:Ignora las normas
維基大典:五柱	Wikipedia:Los cinco pilares
成在基	Sung Jae-ki
企業	Negocio
Template:Softredirect	Plantilla:Redirección suave
Template:刪	Plantilla:Destruir
Category:技術	Categoría:Tecnología
Category:語言	Categoría:Lenguas
Category:語法	Categoría:Gramática
Category:維基大典	Categoría:Wikipedia
Category:諸語維基大典	Categoría:Wikipedias
Category:未索之頁	Categoría:Wikipedia:Páginas no indexadas
Category:帶壞檔之頁	Categoría:Wikipedia:Páginas con enlaces rotos a archivos
門:卷首	Portal:Portada
Template:Navbox	Plantilla:Navegación
Template:捷徑	Plantilla:Atajos
Category:時區	Categoría:Zonas horarias
日曜無神	Kami-sama no Inai Nichiyōbi
Category:維基大典維護	Categoría:Wikipedia:Mantenimiento
門:美國史	Portal:Estados Unidos de América
Template:!	Plantilla:!
Template:Navbar	Plantilla:Navbar
Template:Unicode	Plantilla:Unicode
Category:格式模板	Categoría:Wikipedia:Plantillas de formato de texto
Template:Transclude	Plantilla:Transcluir
Template:Clear	Plantilla:Clear
Template:Nowrap	Plantilla:Nowrap
阮氏	Nguyễn
維基大典:當有之文	Wikipedia:Lista de artículos que toda Wikipedia debería tener
Category:數	Categoría:Números
Category:書籍	Categoría:Libros
Template:Wikisource	Plantilla:Wikisource
Template:Babel	Plantilla:Babel
Template:共享	Plantilla:Commons
Template:Link GA	Plantilla:Bueno
Template:Reflist	Plantilla:Listaref
維基大典:掃興警示	Wikipedia:Revelación de la trama
Template:芻文	Plantilla:Esbozo
Template:See also	Plantilla:VT
Category:香港大專院校	Categoría:Universidades de Hong Kong
Category:智利	Categoría:Chile
Category:廿一世紀	Categoría:Siglo XXI
Category:維護模板	Categoría:Wikipedia:Plantillas de mantenimiento
Category:User uk	Categoría:Wikipedia:Wikipedistas con conocimientos de ucraniano
Category:User uk-N	Categoría:Wikipedia:Wikipedistas con nivel nativo de ucraniano
Template:Esoteric	Plantilla:Plantilla compleja
Category:百科全書	Categoría:Enciclopedias
Category:User ms	Categoría:Wikipedia:Wikipedistas con conocimientos de malayo
Template:Edit	Plantilla:Editar
Category:連結模板	Categoría:Wikipedia:Plantillas de enlaces
Template:Userbox-2	Usuario:Userbox/Userbox-2
Category:User fr-1	Categoría:Wikipedia:Wikipedistas con nivel básico de francés
Template:Wikiquote	Plantilla:Wikiquote
Template:Image label	Plantilla:Etiqueta imagen
Template:Ja	Plantilla:Ja
Template:大修	Plantilla:En uso
Template:Ambox	Plantilla:Metaplantilla de avisos
Template:Disputed	Plantilla:Discutido
Template:Hide in print	Plantilla:Ocultar al imprimir
Category:美國史	Categoría:Historia de Estados Unidos
Template:國	Plantilla:Ficha de país
Template:Infobox software	Plantilla:Ficha de software
Template:Wide image	Plantilla:Panorama
Template:Military Conflict	Plantilla:Ficha de conflicto
Template:Audio	Plantilla:Audio
Template:電玩訊欄	Plantilla:Ficha de videojuego
Template:卓著	Plantilla:Artículo destacado
Category:User en-4	Categoría:Wikipedia:Wikipedistas con nivel experto de inglés
Category:User en	Categoría:Wikipedia:Wikipedistas con conocimientos de inglés
Category:User zh	Categoría:Wikipedia:Wikipedistas con conocimientos de chino
Category:User zh-N	Categoría:Wikipedia:Wikipedistas con nivel nativo de chino
Category:User en-2	Categoría:Wikipedia:Wikipedistas con nivel intermedio de inglés
Category:曲	Categoría:Composiciones musicales
Template:Infobox	Plantilla:Ficha
Template:Legend	Plantilla:Leyenda
Template:引網	Plantilla:Cita web
Category:食	Categoría:Comida y bebida
Template:未已之作	Plantilla:Evento futuro
Template:Coor URL	Plantilla:Coor URL
Category:史書	Categoría:Libros de historia
Template:維基爾雅	Plantilla:Wikcionario
Template:Languageicon	Plantilla:En idioma
Category:農業	Categoría:Agricultura
Category:User ms-N	Categoría:Wikipedia:Wikipedistas con nivel nativo de malayo
Category:二十世紀	Categoría:Siglo XX
Template:IPA	Plantilla:AFI
Template:釋義二	Plantilla:Otros usos
Category:東羅馬史	Categoría:Imperio bizantino
Template:LangWithName	Plantilla:LangWithName
Template:Navbox subgroup	Plantilla:Navegación/subgrupo
Template:Dyk	Plantilla:Sabías que
Template:Archive box	Plantilla:Caja de archivos
Template:Namespace detect	Plantilla:Detecta espacio de nombres
Template:KIA	Plantilla:MEC
Template:Copyvio	Plantilla:Posible copyvio
Template:天下觀	Plantilla:Globalizar
Template:Image label end	Plantilla:Etiqueta imagen fin
Template:Purge	Plantilla:Purgar
Template:敗興	Plantilla:Spoiler
Template:齋	Plantilla:Página usuario
Template:User	Plantilla:U
非標準實數	Número hiperreal
深衣	Shenyi
Template:User language-4	Plantilla:Babel4
Category:公司	Categoría:Empresas
Template:Move	Plantilla:Renombrar
Template:Th	Plantilla:Th
Template:Redirect	Plantilla:Redirige aquí
Category:日本地方志	Categoría:Organización territorial de Japón
Category:電腦	Categoría:Computadoras
Category:器	Categoría:Equipamiento
Template:非也	Plantilla:En contra
Template:SUL Box	Usuario:Userbox/SUL
Category:複分析	Categoría:Análisis complejo
Category:User ja-N	Categoría:Wikipedia:Wikipedistas con nivel nativo de japonés
Category:茶	Categoría:Té
Template:Browsebar	Plantilla:Portales de Wikipedia
Template:釋義	Plantilla:Desambiguación
Category:攝影	Categoría:Fotografía
Category:天皇本紀	Categoría:Emperadores de Japón
Category:德意志第三帝國書	Categoría:Alemania nazi
Category:朝鮮史	Categoría:Historia de Corea
Category:礦冶	Categoría:Minería
Template:Lang-en	Plantilla:Lang-en
Category:廣州	Categoría:Cantón (ciudad)
Category:建築	Categoría:Arquitectura
Template:Period end	Plantilla:Period end
Category:生物	Categoría:Organismos
Template:De	Plantilla:De
Template:Infobox person	Plantilla:Ficha de persona
Category:鐵路	Categoría:Ferrocarriles
Template:InterWiki	Plantilla:InterWiki
Template:MainPageInterwikis	Plantilla:Portada:Interwikis
Category:金蘭之模	Categoría:Wikipedia:Plantillas de enlace entre proyectos
Category:User yue	Categoría:Wikipedia:Wikipedistas con conocimientos de Cantonese
Category:User zh-wuu	Categoría:Wikipedia:Wikipedistas con conocimientos de Wu
Category:User sk	Categoría:Wikipedia:Wikipedistas con conocimientos de eslovaco
Category:User fr	Categoría:Wikipedia:Wikipedistas con conocimientos de francés
Category:User id	Categoría:Wikipedia:Wikipedistas con conocimientos de indonesio
Category:User ja	Categoría:Wikipedia:Wikipedistas con conocimientos de japonés
Category:User la	Categoría:Wikipedia:Wikipedistas con conocimientos de latín
Category:User th	Categoría:Wikipedia:Wikipedistas con conocimientos de tailandés
Category:User fr-3	Categoría:Wikipedia:Wikipedistas con nivel avanzado de francés
Category:User fr-2	Categoría:Wikipedia:Wikipedistas con nivel intermedio de francés
Category:User ja-2	Categoría:Wikipedia:Wikipedistas con nivel intermedio de japonés
Category:User wuu-N	Categoría:Wikipedia:Wikipedistas con nivel nativo de Wu
Category:User ko-N	Categoría:Wikipedia:Wikipedistas con nivel nativo de coreano
Category:User fr-N	Categoría:Wikipedia:Wikipedistas con nivel nativo de francés
Category:User ru-N	Categoría:Wikipedia:Wikipedistas con nivel nativo de ruso
Category:娛樂	Categoría:Entretenimiento
Category:文字	Categoría:Sistemas de escritura
Category:輕小說	Categoría:Novelas ligeras
Category:道教	Categoría:Taoísmo
Category:User sk-N	Categoría:Wikipedia:Wikipedistas con nivel nativo de eslovaco
Category:User de	Categoría:Wikipedia:Wikipedistas con conocimientos de alemán
Category:User de-2	Categoría:Wikipedia:Wikipedistas con nivel intermedio de alemán
Category:User de-N	Categoría:Wikipedia:Wikipedistas con nivel nativo de alemán
Category:User en-3	Categoría:Wikipedia:Wikipedistas con nivel avanzado de inglés
Category:User en-N	Categoría:Wikipedia:Wikipedistas con nivel nativo de inglés
Category:User es	Categoría:Wikipedia:Wikipedistas con conocimientos de español
Category:User es-1	Categoría:Wikipedia:Wikipedistas con nivel básico de español
Category:韓語	Categoría:Idioma coreano
Category:幾何	Categoría:Geometría
Category:User ja-1	Categoría:Wikipedia:Wikipedistas con nivel básico de japonés
Category:User ko	Categoría:Wikipedia:Wikipedistas con conocimientos de coreano
Category:斯巴達書	Categoría:Esparta
Template:Translating	Plantilla:Traducción
Template:辨	Plantilla:Distinguir
Category:User ru-1	Categoría:Wikipedia:Wikipedistas con nivel básico de ruso
維基大典:巴别	Wikipedia:Babel
Category:化合物	Categoría:Compuestos químicos
Category:大洋洲史	Categoría:Historia de Oceanía
維多利亞後世之浩劫	Los holocaustos del fin de la era victoriana
長安	Chang'an
Category:以嗜好類之維基人	Wikipedia:Wikipedistas por temas de interés
Category:花	Categoría:Flores
Category:慶尚北道	Categoría:Gyeongsang del Norte
Category:廣東省	Categoría:Provincia de Cantón
Category:四川省	Categoría:Sichuan
Category:遼寧省	Categoría:Liaoning
Category:陝西省	Categoría:Shaanxi
Category:安徽省	Categoría:Anhui
Category:江西省	Categoría:Jiangxi
Category:江蘇省	Categoría:Jiangsu
Category:吉林省	Categoría:Jilin
Category:福建省	Categoría:Fujian
Category:海南省	Categoría:Hainan
Category:河北省	Categoría:Hebei
Category:黑龍江省	Categoría:Heilongjiang
Category:湖北省	Categoría:Hubei
Category:地理	Categoría:Geografía física
Category:水	Categoría:Agua
Category:美洲史	Categoría:Historia de América
Template:提案	Plantilla:Propuesta
Category:社會科學	Categoría:Ciencias sociales
Template:Zh	Plantilla:Zh icon
Category:江戶書	Categoría:Período Edo
Category:室町書	Categoría:Período Muromachi
Category:飛鳥書	Categoría:Período Asuka
Category:戰國書	Categoría:Período Sengoku
Category:User ru	Categoría:Wikipedia:Wikipedistas con conocimientos de ruso
Category:User ru-2	Categoría:Wikipedia:Wikipedistas con nivel intermedio de ruso
Template:En	Plantilla:En
Category:山東省	Categoría:Shandong
Category:雲南省	Categoría:Yunnan
Category:浙江省	Categoría:Zhejiang
Category:青海省	Categoría:Qinghai
Category:河南省	Categoría:Henan
Category:湖南省	Categoría:Hunan
Template:Lang	Plantilla:Lang
Category:日本文學	Categoría:Literatura de Japón
Category:群學	Categoría:Sociología
Category:三世紀	Categoría:Siglo III
Category:十七世紀	Categoría:Siglo XVII
Category:七世紀	Categoría:Siglo VII
Category:人	Categoría:Humanos
Category:東羅馬本紀	Categoría:Emperadores bizantinos
Category:門	Categoría:Wikipedia:Portales
Template:Ko	Plantilla:Ko
Template:Main	Plantilla:AP
Template:Fossil range/marker	Plantilla:Rango fósil/marcador
Category:風	Categoría:Vientos
Category:中華地方志	Categoría:Organización territorial de China
Category:羅馬共和書	Categoría:República romana
Category:希臘史	Categoría:Historia de Grecia
Category:澳大利亞史	Categoría:Historia de Australia
Category:北韓紀事	Categoría:Historia de Corea del Norte
Category:民國紀事	Categoría:Historia de la República de China
Category:加拿大史	Categoría:Historia de Canadá
Category:東南亞史	Categoría:Historia del Sudeste Asiático
Category:中華民國行政區	Categoría:Organización territorial de la República de China
Category:俄羅斯史	Categoría:Historia de Rusia
Category:中華人民共和國紀事	Categoría:Historia de la República Popular China
Category:中華自治區	Categoría:Regiones autónomas de China
Category:羅馬皇帝本紀	Categoría:Emperadores romanos
維基大典:維基聊齋	Wikipedia:Artículos peculiares
Category:戲劇	Categoría:Teatro
Category:釋義模板	Categoría:Wikipedia:Plantillas de desambiguaciones y redirecciones
維基大典:每日圖繪	Wikipedia:Recurso del día
Template:中立	Plantilla:Neutral
Category:中東史	Categoría:Historia de Oriente Medio
Category:User zh-1	Categoría:Wikipedia:Wikipedistas con nivel básico de chino
Category:刑法	Categoría:Derecho penal
Category:酸	Categoría:Ácidos
Category:民國總統世家	Categoría:Presidentes de la República de China
Category:算法	Categoría:Algoritmos
Category:一世紀	Categoría:Siglo I
Category:十四世紀	Categoría:Siglo XIV
Category:二世紀	Categoría:Siglo II
Category:四世紀	Categoría:Siglo IV
Category:十八世紀	Categoría:Siglo XVIII
Category:八世紀	Categoría:Siglo VIII
Category:整數	Categoría:Números enteros
Category:香港列傳	Categoría:Hongkoneses
粵語	Chino cantonés
Category:藤原氏	Categoría:Clan Fujiwara
Category:印歐語系	Categoría:Lenguas indoeuropeas
Category:量子場論	Categoría:Teoría cuántica de campos
Category:泰國銀行	Categoría:Bancos de Tailandia
Category:化學元素	Categoría:Elementos químicos
Category:日本小說	Categoría:Novelas de Japón
Category:姓氏	Categoría:Apellidos
Category:朝鮮民主主義人民共和國書	Categoría:Corea del Norte
Category:中華人民共和國教育	Categoría:Educación en la República Popular China
Category:英國史	Categoría:Historia de Reino Unido
Category:中華史	Categoría:Historia de China
Category:新聞學	Categoría:Periodismo
Category:前二世紀	Categoría:Siglo II a. C.
Category:前三世紀	Categoría:Siglo III a. C.
Category:越南地理志	Categoría:Geografía de Vietnam
Category:渤海書	Categoría:Balhae
Category:蘇聯書	Categoría:Unión Soviética
Category:古羅馬史	Categoría:Antigua Roma
Category:滿洲國志	Categoría:Manchukuo
Category:前一世紀	Categoría:Siglo I a. C.
Category:江戶列傳	Categoría:Personajes del Período Edo
Category:反物質	Categoría:Antimateria
Category:美國總統世家	Categoría:Presidentes de Estados Unidos
Category:歐洲史	Categoría:Historia de Europa
Category:魚	Categoría:Peces
Category:北京市	Categoría:Pekín
Category:果	Categoría:Frutas
Category:天候學	Categoría:Climatología
Category:亞洲地理志	Categoría:Geografía de Asia
Category:人類學	Categoría:Antropología
Category:作業系統	Categoría:Sistemas operativos
Category:金書	Categoría:Dinastía Jin (1115-1234)
Category:清書	Categoría:Dinastía Qing
Category:宋書	Categoría:Dinastía Song
Category:明書	Categoría:Dinastía Ming
Category:元書	Categoría:Dinastía Yuan
Category:隋書	Categoría:Dinastía Sui
Category:遼書	Categoría:Dinastía Liao
Category:南北朝書	Categoría:Dinastías Meridionales y Septentrionales
Category:周書	Categoría:Dinastía Zhou
Category:阮氏大南書	Categoría:Dinastía Nguyen
Category:天演	Categoría:Evolución
Category:動物	Categoría:Animales
Category:俄羅斯加盟共和國	Categoría:Repúblicas de Rusia
Category:三國書	Categoría:Tres Reinos
Category:涼宮春日	Categoría:Suzumiya Haruhi no Yūutsu
Category:兵器	Categoría:Armas
Category:紀年	Categoría:Cronología
Category:弦論	Categoría:Teoría de cuerdas
Category:數學分析	Categoría:Análisis matemático
Category:樂器	Categoría:Instrumentos musicales
Category:漢字	Categoría:Escritura china
Category:氣象	Categoría:Meteorología
Category:實驗儀器	Categoría:Equipamiento de laboratorio
Category:香港	Categoría:Hong Kong
Category:PS2遊戲	Categoría:Videojuegos para PlayStation 2
Category:高雄市	Categoría:Kaohsiung
Category:鹽	Categoría:Sales
Category:廣西壯族自治區	Categoría:Guangxi
Category:衣	Categoría:Indumentaria
Category:上海市	Categoría:Shanghái
Category:龜	Categoría:Testudines
Category:節日	Categoría:Festivales
Category:臺北市	Categoría:Taipéi
Category:書體	Categoría:Familias tipográficas
Category:古希臘史	Categoría:Antigua Grecia
Category:周本紀	Categoría:Reyes de la dinastía Zhou
Category:交通	Categoría:Transporte
Category:刑	Categoría:Penas
Category:玩	Categoría:Juguetes
Category:數趣	Categoría:Matemática recreativa
Category:群論	Categoría:Teoría de grupos
Category:數論	Categoría:Teoría de números
Category:拓撲學	Categoría:Topología
Category:疇人	Categoría:Matemáticos
Category:雕塑	Categoría:Escultura
Category:大韓民國大統領世家	Categoría:Presidentes de Corea del Sur
Category:漢語	Categoría:Idioma chino
Category:澳門	Categoría:Macao
Category:日本文	Categoría:Escritura japonesa
Category:雅樂	Categoría:Gagaku
Category:日本漢字	Categoría:Kanji
Category:塔	Categoría:Torres
便利店	Tienda de conveniencia
Category:中華人民共和國書	Categoría:República Popular China
Category:數理物理	Categoría:Física matemática
Category:數學史	Categoría:Historia de la matemática
Category:目錄學	Categoría:Bibliografía
Category:日本世家	Categoría:Clanes japoneses
夏至	Solsticio de verano
Template:依余之見	Plantilla:Comentario
Category:正典	Categoría:Wikipedia:Artículos buenos en la Wikipedia en chino clásico
中國 (釋義)	China (desambiguación)
Category:戰國列傳	Categoría:Personajes del Período Sengoku
門:數學	Portal:Matemática
Category:共形場論	Categoría:Teoría de campos conformes
Category:北韓本紀	Categoría:Gobernantes de Corea del Norte
Category:武漢市	Categoría:Wuhan
Category:美國維基人	Categoría:Wikipedia:Wikipedistas de Estados Unidos
Category:臺灣維基人	Categoría:Wikipedia:Wikipedistas de Taiwán
Category:代數	Categoría:Álgebra
Category:雅典列傳	Categoría:Antiguos atenienses
Category:雅典書	Categoría:Atenas (Edad Antigua)
Category:鹼	Categoría:Bases
Category:橋	Categoría:Puentes
Category:矮行星	Categoría:Planetas enanos
Category:地震	Categoría:Terremotos
Category:東正教會	Categoría:Cristianismo ortodoxo
Category:香港教育	Categoría:Educación en Hong Kong
Category:電極	Categoría:Electrodos
Category:版權	Categoría:Derecho de autor
Category:世界語	Categoría:Esperanto
Template:Lang-zh	Plantilla:Lang-zh
Category:語法格	Categoría:Casos gramaticales
Category:杭州市	Categoría:Hangzhou
Category:內蒙古自治區	Categoría:Mongolia Interior
Category:日本年號	Categoría:Eras japonesas
Category:蘇州市	Categoría:Suzhou
Category:律史	Categoría:Historia del Derecho
門:化學	Portal:Química
Category:秦書	Categoría:Dinastía Qin
Category:軍事	Categoría:Ciencia militar
Category:萌	Categoría:Moé
Category:中華直轄市	Categoría:Municipios de China
Category:中華民國書	Categoría:República de China
Category:南投縣	Categoría:Condado de Nantou
Category:有機化學	Categoría:Química orgánica
Category:琉球群島	Categoría:Islas Ryūkyū
Category:船舶	Categoría:Barcos
Category:中華特別行政區	Categoría:Regiones administrativas especiales de China
Category:衡器	Categoría:Instrumentos de medición
Category:唐書	Categoría:Dinastía Tang
Category:臺中市	Categoría:Taichung
Category:電話	Categoría:Telefonía
Category:音節文字	Categoría:Silabarios
Category:臺灣省大專院校	Categoría:Universidades de Taiwán
Category:德川將軍世家	Categoría:Shōgun Tokugawa
Category:應用科學	Categoría:Ciencias aplicadas
Category:中華當世諸省	Categoría:Provincias de China
Category:輿圖學	Categoría:Cartografía
Category:西安市	Categoría:Xi'an
Category:行星環	Categoría:Anillos planetarios
Template:Image label begin	Plantilla:Etiqueta imagen inicio
Category:儒家	Categoría:Confucianismo
Category:民法	Categoría:Derecho civil
Template:Babels	Wikipedia:Babel/Idiomas
Category:在修之文	Categoría:Wikipedia:Artículos en desarrollo
Category:User en-1	Categoría:Wikipedia:Wikipedistas con nivel básico de inglés
Category:User de-1	Categoría:Wikipedia:Wikipedistas con nivel básico de alemán
Category:語言標示模	Categoría:Wikipedia:Plantillas de lenguas de país
Category:非洲史	Categoría:Historia de África
Category:羅馬共和本紀	Categoría:Cónsules de la República romana
Category:國憲	Categoría:Derecho constitucional
埃博拉	Ebolavirus
Template:FZW-Intro	Wikipedia:Café/Portal
Help:校對	Wikipedia:Ediciones revisadas
雨冰	Lluvia engelante
維基大典:驛站	Wikipedia:TourBusStop
Template:Nobots	Plantilla:Nobots
維基大典:編輯次數	Wikipedia:Ranking de ediciones
Template:警告4	Plantilla:Aviso prueba4
潘多拉病毒	Pandoravirus
麗水市	Lishui
如釋冰	Let It Go (canción de Disney)
Module:Arguments	Módulo:Argumentos
Special:近易	Especial:CambiosRecientes
Module:HtmlBuilder	Módulo:HtmlBuilder
Module:String	Módulo:String
Module:Infobox	Módulo:Ficha
甲午昆明斫殺	Atentado en Kunming de 2014
洪憲	Hongxian
Category:龍	Categoría:Dragones chinos
雨傘運動	Protestas en Hong Kong de 2014
代言 (動漫)	Mascota (símbolo)
